"team_id","league_id","game_id","date","time","innings","runs","hits","team_abbr","team_name","home/away","win","loss","division","league_abbr","ttl_wins","ttl_losses","below.500","winloss","RA","ttl_ra","ttl_runs","ttl_hits","ttl_rs_sq","ttl_ra_sq","gp","wp","pythag_win","pythag_loss","pythag_record","Primary Color","Division Standing","League Standing","season"
1,100,1,2028-05-15,1905,9,0,4,"NYV","New York Voyagers","away",0,1,"Eastern Division","PBE",0,1,-1,"0 - 1",1,1,0,4,0,1,1,0,0,1,"0 - 1","#0E1540",2,4,"2028"
1,100,5,2028-05-16,1905,9,5,5,"NYV","New York Voyagers","away",1,0,"Eastern Division","PBE",1,1,0,"1 - 1",2,3,5,9,25,9,2,0.735294117647059,1,1,"1 - 1","#0E1540",2,4,"2028"
1,100,9,2028-05-17,1905,9,0,2,"NYV","New York Voyagers","away",0,1,"Eastern Division","PBE",1,2,-1,"1 - 2",3,6,5,11,25,36,3,0.409836065573771,1,2,"1 - 2","#0E1540",2,4,"2028"
1,100,18,2028-05-20,1905,9,2,5,"NYV","New York Voyagers","home",0,1,"Eastern Division","PBE",1,3,-2,"1 - 3",21,27,7,16,49,729,4,0.0629820051413882,0,4,"0 - 4","#0E1540",2,4,"2028"
1,100,22,2028-05-21,1905,12,9,14,"NYV","New York Voyagers","home",1,0,"Eastern Division","PBE",2,3,-1,"2 - 3",8,35,16,30,256,1225,5,0.172856178257934,1,4,"1 - 4","#0E1540",2,4,"2028"
1,100,26,2028-05-22,1905,9,0,5,"NYV","New York Voyagers","home",0,1,"Eastern Division","PBE",2,4,-2,"2 - 4",2,37,16,35,256,1369,6,0.157538461538462,1,5,"1 - 5","#0E1540",2,4,"2028"
1,100,29,2028-05-25,1905,9,5,10,"NYV","New York Voyagers","home",1,0,"Eastern Division","PBE",3,4,-1,"3 - 4",4,41,21,45,441,1681,7,0.207822808671065,1,6,"1 - 6","#0E1540",2,4,"2028"
1,100,32,2028-05-26,1905,9,2,4,"NYV","New York Voyagers","home",0,1,"Eastern Division","PBE",3,5,-2,"3 - 5",5,46,23,49,529,2116,8,0.2,2,6,"2 - 6","#0E1540",2,4,"2028"
1,100,36,2028-05-27,1905,9,3,7,"NYV","New York Voyagers","home",0,1,"Eastern Division","PBE",3,6,-3,"3 - 6",4,50,26,56,676,2500,9,0.212846347607053,2,7,"2 - 7","#0E1540",2,4,"2028"
1,100,43,2028-05-30,1905,9,8,9,"NYV","New York Voyagers","home",1,0,"Eastern Division","PBE",4,6,-2,"4 - 6",7,57,34,65,1156,3249,10,0.262429057888763,3,7,"3 - 7","#0E1540",2,4,"2028"
1,100,47,2028-05-31,1905,9,10,14,"NYV","New York Voyagers","home",1,0,"Eastern Division","PBE",5,6,-1,"5 - 6",5,62,44,79,1936,3844,11,0.334948096885813,4,7,"4 - 7","#0E1540",2,4,"2028"
1,100,51,2028-06-01,1905,9,6,8,"NYV","New York Voyagers","home",0,1,"Eastern Division","PBE",5,7,-2,"5 - 7",11,73,50,87,2500,5329,12,0.319325584365819,4,8,"4 - 8","#0E1540",2,4,"2028"
1,100,55,2028-06-04,1905,9,9,10,"NYV","New York Voyagers","away",1,0,"Eastern Division","PBE",6,7,-1,"6 - 7",4,77,59,97,3481,5929,13,0.369925611052072,5,8,"5 - 8","#0E1540",2,4,"2028"
1,100,59,2028-06-05,1905,9,3,6,"NYV","New York Voyagers","away",1,0,"Eastern Division","PBE",7,7,0,"7 - 7",0,77,62,103,3844,5929,14,0.393328558272792,6,8,"6 - 8","#0E1540",2,4,"2028"
1,100,63,2028-06-06,1905,12,6,17,"NYV","New York Voyagers","away",1,0,"Eastern Division","PBE",8,7,1,"8 - 7",5,82,68,120,4624,6724,15,0.407472682410998,6,9,"6 - 9","#0E1540",2,4,"2028"
1,100,68,2028-06-09,1905,9,7,10,"NYV","New York Voyagers","away",0,1,"Eastern Division","PBE",8,8,0,"8 - 8",8,90,75,130,5625,8100,16,0.409836065573771,7,9,"7 - 9","#0E1540",2,4,"2028"
1,100,72,2028-06-10,1905,9,4,7,"NYV","New York Voyagers","away",1,0,"Eastern Division","PBE",9,8,1,"9 - 8",2,92,79,137,6241,8464,17,0.424413464807888,7,10,"7 - 10","#0E1540",2,4,"2028"
1,100,76,2028-06-11,1905,9,5,7,"NYV","New York Voyagers","home",1,0,"Eastern Division","PBE",10,8,2,"10 - 8",3,95,84,144,7056,9025,18,0.438778682917729,8,10,"8 - 10","#0E1540",2,4,"2028"
1,100,80,2028-06-12,1905,9,1,6,"NYV","New York Voyagers","home",1,0,"Eastern Division","PBE",11,8,3,"11 - 8",0,95,85,150,7225,9025,19,0.444615384615385,8,11,"8 - 11","#0E1540",2,4,"2028"
1,100,83,2028-06-14,1905,9,4,6,"NYV","New York Voyagers","away",0,1,"Eastern Division","PBE",11,9,2,"11 - 9",5,100,89,156,7921,10000,20,0.44199542436248,9,11,"9 - 11","#0E1540",2,4,"2028"
1,100,87,2028-06-15,1905,9,3,7,"NYV","New York Voyagers","away",0,1,"Eastern Division","PBE",11,10,1,"11 - 10",6,106,92,163,8464,11236,21,0.429644670050761,9,12,"9 - 12","#0E1540",2,4,"2028"
1,100,91,2028-06-16,1905,9,10,12,"NYV","New York Voyagers","away",1,0,"Eastern Division","PBE",12,10,2,"12 - 10",2,108,102,175,10404,11664,22,0.471451876019576,10,12,"10 - 12","#0E1540",2,4,"2028"
1,100,95,2028-06-19,1905,9,3,6,"NYV","New York Voyagers","away",0,1,"Eastern Division","PBE",12,11,1,"12 - 11",16,124,105,181,11025,15376,23,0.41759781826446,10,13,"10 - 13","#0E1540",2,4,"2028"
1,100,99,2028-06-20,1905,9,3,3,"NYV","New York Voyagers","away",0,1,"Eastern Division","PBE",12,12,0,"12 - 12",7,131,108,184,11664,17161,24,0.404648742411101,10,14,"10 - 14","#0E1540",2,4,"2028"
1,100,103,2028-06-21,1905,9,9,15,"NYV","New York Voyagers","home",1,0,"Eastern Division","PBE",13,12,1,"13 - 12",4,135,117,199,13689,18225,25,0.428934010152284,11,14,"11 - 14","#0E1540",2,4,"2028"
1,100,107,2028-06-22,1905,11,8,15,"NYV","New York Voyagers","home",1,0,"Eastern Division","PBE",14,12,2,"14 - 12",7,142,125,214,15625,20164,26,0.436586660705803,11,15,"11 - 15","#0E1540",2,4,"2028"
1,100,108,2028-06-24,1905,9,3,5,"NYV","New York Voyagers","away",0,1,"Eastern Division","PBE",14,13,1,"14 - 13",7,149,128,219,16384,22201,27,0.424620966696903,11,16,"11 - 16","#0E1540",2,4,"2028"
1,100,112,2028-06-25,1905,9,5,8,"NYV","New York Voyagers","away",1,0,"Eastern Division","PBE",15,13,2,"15 - 13",2,151,133,227,17689,22801,28,0.436873302049889,12,16,"12 - 16","#0E1540",2,4,"2028"
1,100,116,2028-06-26,1905,9,4,9,"NYV","New York Voyagers","away",1,0,"Eastern Division","PBE",16,13,3,"16 - 13",2,153,137,236,18769,23409,29,0.444995021101048,13,16,"13 - 16","#0E1540",2,4,"2028"
1,100,120,2028-06-27,1905,9,5,8,"NYV","New York Voyagers","away",1,0,"Eastern Division","PBE",17,13,4,"17 - 13",1,154,142,244,20164,23716,30,0.459525979945305,14,16,"14 - 16","#0E1540",2,4,"2028"
1,100,128,2028-06-30,1905,9,5,11,"NYV","New York Voyagers","away",0,1,"Eastern Division","PBE",17,14,3,"17 - 14",6,160,147,255,21609,25600,31,0.457730517486073,14,17,"14 - 17","#0E1540",2,4,"2028"
1,100,132,2028-07-01,1905,9,3,9,"NYV","New York Voyagers","away",0,1,"Eastern Division","PBE",17,15,2,"17 - 15",6,166,150,264,22500,27556,32,0.44949656384849,14,18,"14 - 18","#0E1540",2,4,"2028"
1,100,134,2028-07-02,1905,9,6,9,"NYV","New York Voyagers","away",1,0,"Eastern Division","PBE",18,15,3,"18 - 15",1,167,156,273,24336,27889,33,0.465983724269986,15,18,"15 - 18","#0E1540",2,4,"2028"
1,100,135,2028-07-04,1905,9,3,7,"NYV","New York Voyagers","home",1,0,"Eastern Division","PBE",19,15,4,"19 - 15",1,168,159,280,25281,28224,34,0.472497897392767,16,18,"16 - 18","#0E1540",2,4,"2028"
1,100,139,2028-07-05,1905,9,3,8,"NYV","New York Voyagers","home",0,1,"Eastern Division","PBE",19,16,3,"19 - 16",6,174,162,288,26244,30276,35,0.464331210191083,16,19,"16 - 19","#0E1540",2,4,"2028"
1,100,143,2028-07-06,1905,9,8,15,"NYV","New York Voyagers","home",1,0,"Eastern Division","PBE",20,16,4,"20 - 16",4,178,170,303,28900,31684,36,0.477023636603724,17,19,"17 - 19","#0E1540",2,4,"2028"
1,100,148,2028-07-09,1905,9,1,5,"NYV","New York Voyagers","home",0,1,"Eastern Division","PBE",20,17,3,"20 - 17",9,187,171,308,29241,34969,37,0.455396355707834,17,20,"17 - 20","#0E1540",2,4,"2028"
1,100,152,2028-07-10,1905,9,7,10,"NYV","New York Voyagers","home",1,0,"Eastern Division","PBE",21,17,4,"21 - 17",6,193,178,318,31684,37249,38,0.459634717769428,17,21,"17 - 21","#0E1540",2,4,"2028"
1,100,156,2028-07-11,1905,9,4,10,"NYV","New York Voyagers","away",1,0,"Eastern Division","PBE",22,17,5,"22 - 17",2,195,182,328,33124,38025,39,0.465558194774347,18,21,"18 - 21","#0E1540",2,4,"2028"
1,100,160,2028-07-12,1905,9,6,7,"NYV","New York Voyagers","away",1,0,"Eastern Division","PBE",23,17,6,"23 - 17",5,200,188,335,35344,40000,40,0.469101720110427,19,21,"19 - 21","#0E1540",2,4,"2028"
1,100,168,2028-07-15,1905,9,15,18,"NYV","New York Voyagers","away",1,0,"Eastern Division","PBE",24,17,7,"24 - 17",1,201,203,353,41209,40401,41,0.50495037372871,21,20,"21 - 20","#0E1540",2,4,"2028"
1,100,172,2028-07-16,1905,9,2,7,"NYV","New York Voyagers","away",1,0,"Eastern Division","PBE",25,17,8,"25 - 17",1,202,205,360,42025,40804,42,0.507370606913038,21,21,"21 - 21","#0E1540",2,4,"2028"
1,100,174,2028-07-17,1905,9,5,11,"NYV","New York Voyagers","away",1,0,"Eastern Division","PBE",26,17,9,"26 - 17",2,204,210,371,44100,41616,43,0.514489710205796,22,21,"22 - 21","#0E1540",2,4,"2028"
1,100,177,2028-07-19,1905,9,4,12,"NYV","New York Voyagers","home",0,1,"Eastern Division","PBE",26,18,8,"26 - 18",11,215,214,383,45796,46225,44,0.497669010334598,22,22,"22 - 22","#0E1540",2,4,"2028"
1,100,181,2028-07-20,1905,9,4,12,"NYV","New York Voyagers","home",0,1,"Eastern Division","PBE",26,19,7,"26 - 19",7,222,218,395,47524,49284,45,0.490909842161805,22,23,"22 - 23","#0E1540",2,4,"2028"
1,100,185,2028-07-21,1905,9,4,8,"NYV","New York Voyagers","home",1,0,"Eastern Division","PBE",27,19,8,"27 - 19",2,224,222,403,49284,50176,46,0.495515785240298,23,23,"23 - 23","#0E1540",2,4,"2028"
1,100,190,2028-07-24,1905,11,1,7,"NYV","New York Voyagers","home",0,1,"Eastern Division","PBE",27,20,7,"27 - 20",4,228,223,410,49729,51984,47,0.488914887969089,23,24,"23 - 24","#0E1540",2,4,"2028"
1,100,193,2028-07-25,1905,9,5,7,"NYV","New York Voyagers","home",1,0,"Eastern Division","PBE",28,20,8,"28 - 20",3,231,228,417,51984,53361,48,0.493464331482273,24,24,"24 - 24","#0E1540",2,4,"2028"
1,100,197,2028-07-26,1905,9,4,6,"NYV","New York Voyagers","home",0,1,"Eastern Division","PBE",28,21,7,"28 - 21",6,237,232,423,53824,56169,49,0.489340230741956,24,25,"24 - 25","#0E1540",2,4,"2028"
1,100,205,2028-08-11,1905,9,7,10,"NYV","New York Voyagers","home",0,1,"Eastern Division","PBE",28,22,6,"28 - 22",10,247,239,433,57121,61009,50,0.483543553712012,24,26,"24 - 26","#0E1540",2,4,"2028"
1,100,209,2028-08-12,1905,9,6,9,"NYV","New York Voyagers","home",0,1,"Eastern Division","PBE",28,23,5,"28 - 23",10,257,245,442,60025,66049,51,0.476109269159383,24,27,"24 - 27","#0E1540",2,4,"2028"
1,100,213,2028-08-13,1905,9,3,6,"NYV","New York Voyagers","away",0,1,"Eastern Division","PBE",28,24,4,"28 - 24",7,264,248,448,61504,69696,52,0.468780487804878,24,28,"24 - 28","#0E1540",2,4,"2028"
1,100,216,2028-08-14,1905,9,3,5,"NYV","New York Voyagers","away",1,0,"Eastern Division","PBE",29,24,5,"29 - 24",2,266,251,453,63001,70756,53,0.471010862982872,25,28,"25 - 28","#0E1540",2,4,"2028"
1,100,217,2028-08-16,1905,9,7,14,"NYV","New York Voyagers","away",0,1,"Eastern Division","PBE",29,25,4,"29 - 25",8,274,258,467,66564,75076,54,0.469951990963005,25,29,"25 - 29","#0E1540",2,4,"2028"
1,100,220,2028-08-17,1905,9,22,19,"NYV","New York Voyagers","away",1,0,"Eastern Division","PBE",30,25,5,"30 - 25",7,281,280,486,78400,78961,55,0.498217474469532,27,28,"27 - 28","#0E1540",2,4,"2028"
1,100,224,2028-08-18,1905,9,13,16,"NYV","New York Voyagers","away",1,0,"Eastern Division","PBE",31,25,6,"31 - 25",3,284,293,502,85849,80656,56,0.515594126302513,29,27,"29 - 27","#0E1540",2,4,"2028"
1,100,228,2028-08-19,1905,9,8,11,"NYV","New York Voyagers","away",1,0,"Eastern Division","PBE",32,25,7,"32 - 25",4,288,301,513,90601,82944,57,0.5220605606615,30,27,"30 - 27","#0E1540",2,4,"2028"
2,100,2,2028-05-15,1905,9,0,2,"OBX","Outer Banks Aviators","away",0,1,"Eastern Division","PBE",0,1,-1,"0 - 1",10,10,0,2,0,100,1,0,0,1,"0 - 1","#FF6700",3,5,"2028"
2,100,6,2028-05-16,1905,9,2,3,"OBX","Outer Banks Aviators","away",1,0,"Eastern Division","PBE",1,1,0,"1 - 1",1,11,2,5,4,121,2,0.032,0,2,"0 - 2","#FF6700",3,5,"2028"
2,100,10,2028-05-17,1905,9,10,16,"OBX","Outer Banks Aviators","away",1,0,"Eastern Division","PBE",2,1,1,"2 - 1",3,14,12,21,144,196,3,0.423529411764706,1,2,"1 - 2","#FF6700",3,5,"2028"
2,100,13,2028-05-18,1905,9,4,13,"OBX","Outer Banks Aviators","away",1,0,"Eastern Division","PBE",3,1,2,"3 - 1",3,17,16,34,256,289,4,0.469724770642202,2,2,"2 - 2","#FF6700",3,5,"2028"
2,100,15,2028-05-20,1905,9,2,8,"OBX","Outer Banks Aviators","away",0,1,"Eastern Division","PBE",3,2,1,"3 - 2",4,21,18,42,324,441,5,0.423529411764706,2,3,"2 - 3","#FF6700",3,5,"2028"
2,100,19,2028-05-21,1905,9,3,8,"OBX","Outer Banks Aviators","away",1,0,"Eastern Division","PBE",4,2,2,"4 - 2",1,22,21,50,441,484,6,0.476756756756757,3,3,"3 - 3","#FF6700",3,5,"2028"
2,100,23,2028-05-22,1905,9,0,6,"OBX","Outer Banks Aviators","home",0,1,"Eastern Division","PBE",4,3,1,"4 - 3",6,28,21,56,441,784,7,0.36,3,4,"3 - 4","#FF6700",3,5,"2028"
2,100,27,2028-05-23,1905,9,3,7,"OBX","Outer Banks Aviators","home",0,1,"Eastern Division","PBE",4,4,0,"4 - 4",7,35,24,63,576,1225,8,0.319822320932815,3,5,"3 - 5","#FF6700",3,5,"2028"
2,100,30,2028-05-25,1905,9,10,15,"OBX","Outer Banks Aviators","home",1,0,"Eastern Division","PBE",5,4,1,"5 - 4",2,37,34,78,1156,1369,9,0.457821782178218,4,5,"4 - 5","#FF6700",3,5,"2028"
2,100,33,2028-05-26,1905,13,4,9,"OBX","Outer Banks Aviators","home",1,0,"Eastern Division","PBE",6,4,2,"6 - 4",3,40,38,87,1444,1600,10,0.474375821287779,5,5,"5 - 5","#FF6700",3,5,"2028"
2,100,37,2028-05-27,1905,9,5,10,"OBX","Outer Banks Aviators","home",0,1,"Eastern Division","PBE",6,5,1,"6 - 5",9,49,43,97,1849,2401,11,0.435058823529412,5,6,"5 - 6","#FF6700",3,5,"2028"
2,100,44,2028-05-30,1905,9,3,13,"OBX","Outer Banks Aviators","away",0,1,"Eastern Division","PBE",6,6,0,"6 - 6",4,53,46,110,2116,2809,12,0.429644670050761,5,7,"5 - 7","#FF6700",3,5,"2028"
2,100,48,2028-05-31,1905,9,3,5,"OBX","Outer Banks Aviators","away",0,1,"Eastern Division","PBE",6,7,-1,"6 - 7",6,59,49,115,2401,3481,13,0.4081944916695,5,8,"5 - 8","#FF6700",3,5,"2028"
2,100,52,2028-06-01,1905,9,7,11,"OBX","Outer Banks Aviators","away",1,0,"Eastern Division","PBE",7,7,0,"7 - 7",4,63,56,126,3136,3969,14,0.441379310344828,6,8,"6 - 8","#FF6700",3,5,"2028"
2,100,56,2028-06-04,1905,11,5,10,"OBX","Outer Banks Aviators","away",1,0,"Eastern Division","PBE",8,7,1,"8 - 7",4,67,61,136,3721,4489,15,0.453227771010962,7,8,"7 - 8","#FF6700",3,5,"2028"
2,100,60,2028-06-05,1905,9,5,11,"OBX","Outer Banks Aviators","away",0,1,"Eastern Division","PBE",8,8,0,"8 - 8",7,74,66,147,4356,5476,16,0.443043124491456,7,9,"7 - 9","#FF6700",3,5,"2028"
2,100,64,2028-06-06,1905,9,3,4,"OBX","Outer Banks Aviators","away",0,1,"Eastern Division","PBE",8,9,-1,"8 - 9",6,80,69,151,4761,6400,17,0.4265746796882,7,10,"7 - 10","#FF6700",3,5,"2028"
2,100,69,2028-06-09,1905,9,0,3,"OBX","Outer Banks Aviators","away",0,1,"Eastern Division","PBE",8,10,-2,"8 - 10",13,93,69,154,4761,8649,18,0.35503355704698,6,12,"6 - 12","#FF6700",3,5,"2028"
2,100,73,2028-06-10,1905,9,0,2,"OBX","Outer Banks Aviators","away",0,1,"Eastern Division","PBE",8,11,-3,"8 - 11",3,96,69,156,4761,9216,19,0.340631036703155,6,13,"6 - 13","#FF6700",3,5,"2028"
2,100,77,2028-06-11,1905,9,5,8,"OBX","Outer Banks Aviators","away",1,0,"Eastern Division","PBE",9,11,-2,"9 - 11",1,97,74,164,5476,9409,20,0.367887134699362,7,13,"7 - 13","#FF6700",3,5,"2028"
2,100,83,2028-06-14,1905,9,5,10,"OBX","Outer Banks Aviators","home",1,0,"Eastern Division","PBE",10,11,-1,"10 - 11",4,101,79,174,6241,10201,21,0.379576693832867,8,13,"8 - 13","#FF6700",3,5,"2028"
2,100,87,2028-06-15,1905,9,6,10,"OBX","Outer Banks Aviators","home",1,0,"Eastern Division","PBE",11,11,0,"11 - 11",3,104,85,184,7225,10816,22,0.40047669197938,9,13,"9 - 13","#FF6700",3,5,"2028"
2,100,91,2028-06-16,1905,9,2,6,"OBX","Outer Banks Aviators","home",0,1,"Eastern Division","PBE",11,12,-1,"11 - 12",10,114,87,190,7569,12996,23,0.368052516411379,8,15,"8 - 15","#FF6700",3,5,"2028"
2,100,97,2028-06-19,1905,9,8,9,"OBX","Outer Banks Aviators","away",1,0,"Eastern Division","PBE",12,12,0,"12 - 12",3,117,95,199,9025,13689,24,0.397332041912477,10,14,"10 - 14","#FF6700",3,5,"2028"
2,100,101,2028-06-20,1905,9,7,11,"OBX","Outer Banks Aviators","away",1,0,"Eastern Division","PBE",13,12,1,"13 - 12",4,121,102,210,10404,14641,25,0.415412257935716,10,15,"10 - 15","#FF6700",3,5,"2028"
2,100,105,2028-06-21,1905,9,4,9,"OBX","Outer Banks Aviators","away",1,0,"Eastern Division","PBE",14,12,2,"14 - 12",2,123,106,219,11236,15129,26,0.42617106011758,11,15,"11 - 15","#FF6700",3,5,"2028"
2,100,109,2028-06-24,1905,9,11,11,"OBX","Outer Banks Aviators","home",1,0,"Eastern Division","PBE",15,12,3,"15 - 12",5,128,117,230,13689,16384,27,0.455192365244572,12,15,"12 - 15","#FF6700",3,5,"2028"
2,100,113,2028-06-25,1905,9,4,10,"OBX","Outer Banks Aviators","home",1,0,"Eastern Division","PBE",16,12,4,"16 - 12",2,130,121,240,14641,16900,28,0.464189467676992,13,15,"13 - 15","#FF6700",3,5,"2028"
2,100,117,2028-06-26,1905,9,3,9,"OBX","Outer Banks Aviators","home",1,0,"Eastern Division","PBE",17,12,5,"17 - 12",1,131,124,249,15376,17161,29,0.472569689891508,14,15,"14 - 15","#FF6700",3,5,"2028"
2,100,123,2028-06-29,1905,9,1,7,"OBX","Outer Banks Aviators","away",0,1,"Eastern Division","PBE",17,13,4,"17 - 13",2,133,125,256,15625,17689,30,0.469022032779012,14,16,"14 - 16","#FF6700",3,5,"2028"
2,100,126,2028-06-30,1905,9,3,8,"OBX","Outer Banks Aviators","away",0,1,"Eastern Division","PBE",17,14,3,"17 - 14",5,138,128,264,16384,19044,31,0.462459071920515,14,17,"14 - 17","#FF6700",3,5,"2028"
2,100,130,2028-07-01,1905,9,2,6,"OBX","Outer Banks Aviators","away",0,1,"Eastern Division","PBE",17,15,2,"17 - 15",5,143,130,270,16900,20449,32,0.452488687782805,14,18,"14 - 18","#FF6700",3,5,"2028"
2,100,136,2028-07-04,1905,9,4,4,"OBX","Outer Banks Aviators","home",0,1,"Eastern Division","PBE",17,16,1,"17 - 16",6,149,134,274,17956,22201,33,0.447144956047514,15,18,"15 - 18","#FF6700",3,5,"2028"
2,100,140,2028-07-05,1905,9,10,13,"OBX","Outer Banks Aviators","home",1,0,"Eastern Division","PBE",18,16,2,"18 - 16",5,154,144,287,20736,23716,34,0.466480698281292,16,18,"16 - 18","#FF6700",3,5,"2028"
2,100,144,2028-07-06,1905,9,1,5,"OBX","Outer Banks Aviators","home",0,1,"Eastern Division","PBE",18,17,1,"18 - 17",5,159,145,292,21025,25281,35,0.45404483220317,16,19,"16 - 19","#FF6700",3,5,"2028"
2,100,150,2028-07-09,1905,9,3,6,"OBX","Outer Banks Aviators","home",0,1,"Eastern Division","PBE",18,18,0,"18 - 18",7,166,148,298,21904,27556,36,0.442862919530934,16,20,"16 - 20","#FF6700",3,5,"2028"
2,100,154,2028-07-10,1905,9,6,8,"OBX","Outer Banks Aviators","home",1,0,"Eastern Division","PBE",19,18,1,"19 - 18",2,168,154,306,23716,28224,37,0.456603773584906,17,20,"17 - 20","#FF6700",3,5,"2028"
2,100,158,2028-07-11,1905,9,4,8,"OBX","Outer Banks Aviators","home",1,0,"Eastern Division","PBE",20,18,2,"20 - 18",3,171,158,314,24964,29241,38,0.460547919933585,18,20,"18 - 20","#FF6700",3,5,"2028"
2,100,164,2028-07-14,1905,9,5,9,"OBX","Outer Banks Aviators","home",1,0,"Eastern Division","PBE",21,18,3,"21 - 18",0,171,163,323,26569,29241,39,0.476061637699337,19,20,"19 - 20","#FF6700",3,5,"2028"
2,100,167,2028-07-15,1905,9,0,2,"OBX","Outer Banks Aviators","home",0,1,"Eastern Division","PBE",21,19,2,"21 - 19",7,178,163,325,26569,31684,40,0.456096681715963,18,22,"18 - 22","#FF6700",3,5,"2028"
2,100,171,2028-07-16,1905,9,6,10,"OBX","Outer Banks Aviators","home",1,0,"Eastern Division","PBE",22,19,3,"22 - 19",3,181,169,335,28561,32761,41,0.465754541600078,19,22,"19 - 22","#FF6700",3,5,"2028"
2,100,173,2028-07-17,1905,9,1,8,"OBX","Outer Banks Aviators","home",0,1,"Eastern Division","PBE",22,20,2,"22 - 20",6,187,170,343,28900,34969,42,0.452488687782805,19,23,"19 - 23","#FF6700",3,5,"2028"
2,100,175,2028-07-19,1905,9,7,12,"OBX","Outer Banks Aviators","home",0,1,"Eastern Division","PBE",22,21,1,"22 - 21",11,198,177,355,31329,39204,43,0.44417506698992,19,24,"19 - 24","#FF6700",3,5,"2028"
2,100,179,2028-07-20,1905,9,9,13,"OBX","Outer Banks Aviators","home",1,0,"Eastern Division","PBE",23,21,2,"23 - 21",2,200,186,368,34596,40000,44,0.463778218671242,20,24,"20 - 24","#FF6700",3,5,"2028"
2,100,183,2028-07-21,1905,9,3,8,"OBX","Outer Banks Aviators","away",1,0,"Eastern Division","PBE",24,21,3,"24 - 21",2,202,189,376,35721,40804,45,0.466788631166286,21,24,"21 - 24","#FF6700",3,5,"2028"
2,100,187,2028-07-22,1905,9,6,9,"OBX","Outer Banks Aviators","away",1,0,"Eastern Division","PBE",25,21,4,"25 - 21",5,207,195,385,38025,42849,46,0.470175829067438,22,24,"22 - 24","#FF6700",3,5,"2028"
2,100,190,2028-07-24,1905,11,4,10,"OBX","Outer Banks Aviators","away",1,0,"Eastern Division","PBE",26,21,5,"26 - 21",1,208,199,395,39601,43264,47,0.477897785554818,22,25,"22 - 25","#FF6700",3,5,"2028"
2,100,193,2028-07-25,1905,9,3,6,"OBX","Outer Banks Aviators","away",0,1,"Eastern Division","PBE",26,22,4,"26 - 22",5,213,202,401,40804,45369,48,0.47351258514848,23,25,"23 - 25","#FF6700",3,5,"2028"
2,100,197,2028-07-26,1905,9,6,7,"OBX","Outer Banks Aviators","away",1,0,"Eastern Division","PBE",27,22,5,"27 - 22",4,217,208,408,43264,47089,49,0.478833021593085,23,26,"23 - 26","#FF6700",3,5,"2028"
2,100,202,2028-08-11,1905,9,3,4,"OBX","Outer Banks Aviators","home",1,0,"Eastern Division","PBE",28,22,6,"28 - 22",2,219,211,412,44521,47961,50,0.481401786293549,24,26,"24 - 26","#FF6700",3,5,"2028"
2,100,206,2028-08-12,1905,14,6,17,"OBX","Outer Banks Aviators","home",0,1,"Eastern Division","PBE",28,23,5,"28 - 23",10,229,217,429,47089,52441,51,0.473113634080177,24,27,"24 - 27","#FF6700",3,5,"2028"
2,100,210,2028-08-13,1905,9,10,15,"OBX","Outer Banks Aviators","away",1,0,"Eastern Division","PBE",29,23,6,"29 - 23",6,235,227,444,51529,55225,52,0.48268917323941,25,27,"25 - 27","#FF6700",3,5,"2028"
2,100,214,2028-08-14,1905,9,3,7,"OBX","Outer Banks Aviators","away",1,0,"Eastern Division","PBE",30,23,7,"30 - 23",1,236,230,451,52900,55696,53,0.487126597664739,26,27,"26 - 27","#FF6700",3,5,"2028"
2,100,217,2028-08-16,1905,9,8,11,"OBX","Outer Banks Aviators","home",1,0,"Eastern Division","PBE",31,23,8,"31 - 23",7,243,238,462,56644,59049,54,0.489606112729379,26,28,"26 - 28","#FF6700",3,5,"2028"
2,100,220,2028-08-17,1905,9,7,10,"OBX","Outer Banks Aviators","home",0,1,"Eastern Division","PBE",31,24,7,"31 - 24",22,265,245,472,60025,70225,55,0.46084452975048,25,30,"25 - 30","#FF6700",3,5,"2028"
2,100,224,2028-08-18,1905,9,3,6,"OBX","Outer Banks Aviators","home",0,1,"Eastern Division","PBE",31,25,6,"31 - 25",13,278,248,478,61504,77284,56,0.443150704671874,25,31,"25 - 31","#FF6700",3,5,"2028"
2,100,228,2028-08-19,1905,9,4,8,"OBX","Outer Banks Aviators","home",0,1,"Eastern Division","PBE",31,26,5,"31 - 26",8,286,252,486,63504,81796,57,0.43705437026841,25,32,"25 - 32","#FF6700",3,5,"2028"
3,100,2,2028-05-15,1905,9,10,12,"PRO","Providence Crabs","home",1,0,"Eastern Division","PBE",1,0,1,"1 - 0",0,0,10,12,100,0,1,1,1,0,"1 - 0","#005CAD",4,7,"2028"
3,100,6,2028-05-16,1905,9,1,5,"PRO","Providence Crabs","home",0,1,"Eastern Division","PBE",1,1,0,"1 - 1",2,2,11,17,121,4,2,0.968,2,0,"2 - 0","#005CAD",4,7,"2028"
3,100,10,2028-05-17,1905,9,3,12,"PRO","Providence Crabs","home",0,1,"Eastern Division","PBE",1,2,-1,"1 - 2",10,12,14,29,196,144,3,0.576470588235294,2,1,"2 - 1","#005CAD",4,7,"2028"
3,100,13,2028-05-18,1905,9,3,6,"PRO","Providence Crabs","home",0,1,"Eastern Division","PBE",1,3,-2,"1 - 3",4,16,17,35,289,256,4,0.530275229357798,2,2,"2 - 2","#005CAD",4,7,"2028"
3,100,16,2028-05-20,1905,9,0,6,"PRO","Providence Crabs","home",0,1,"Eastern Division","PBE",1,4,-3,"1 - 4",8,24,17,41,289,576,5,0.334104046242775,2,3,"2 - 3","#005CAD",4,7,"2028"
3,100,20,2028-05-21,1905,9,6,10,"PRO","Providence Crabs","home",1,0,"Eastern Division","PBE",2,4,-2,"2 - 4",1,25,23,51,529,625,6,0.45840554592721,3,3,"3 - 3","#005CAD",4,7,"2028"
3,100,24,2028-05-22,1905,9,2,6,"PRO","Providence Crabs","home",1,0,"Eastern Division","PBE",3,4,-1,"3 - 4",1,26,25,57,625,676,7,0.480399692544197,3,4,"3 - 4","#005CAD",4,7,"2028"
3,100,30,2028-05-25,1905,9,2,3,"PRO","Providence Crabs","away",0,1,"Eastern Division","PBE",3,5,-2,"3 - 5",10,36,27,60,729,1296,8,0.36,3,5,"3 - 5","#005CAD",4,7,"2028"
3,100,33,2028-05-26,1905,13,3,10,"PRO","Providence Crabs","away",0,1,"Eastern Division","PBE",3,6,-3,"3 - 6",4,40,30,70,900,1600,9,0.36,3,6,"3 - 6","#005CAD",4,7,"2028"
3,100,37,2028-05-27,1905,9,9,14,"PRO","Providence Crabs","away",1,0,"Eastern Division","PBE",4,6,-2,"4 - 6",5,45,39,84,1521,2025,10,0.428934010152284,4,6,"4 - 6","#005CAD",4,7,"2028"
3,100,42,2028-05-30,1905,10,6,10,"PRO","Providence Crabs","away",0,1,"Eastern Division","PBE",4,7,-3,"4 - 7",8,53,45,94,2025,2809,11,0.418907736863881,5,6,"5 - 6","#005CAD",4,7,"2028"
3,100,46,2028-05-31,1905,9,2,6,"PRO","Providence Crabs","away",0,1,"Eastern Division","PBE",4,8,-4,"4 - 8",10,63,47,100,2209,3969,12,0.357559080608611,4,8,"4 - 8","#005CAD",4,7,"2028"
3,100,50,2028-06-01,1905,9,2,6,"PRO","Providence Crabs","home",0,1,"Eastern Division","PBE",4,9,-5,"4 - 9",9,72,49,106,2401,5184,13,0.31654581410679,4,9,"4 - 9","#005CAD",4,7,"2028"
3,100,54,2028-06-02,1905,9,4,5,"PRO","Providence Crabs","home",1,0,"Eastern Division","PBE",5,9,-4,"5 - 9",2,74,53,111,2809,5476,14,0.339046469523235,5,9,"5 - 9","#005CAD",4,7,"2028"
3,100,55,2028-06-04,1905,9,4,7,"PRO","Providence Crabs","home",0,1,"Eastern Division","PBE",5,10,-5,"5 - 10",9,83,57,118,3249,6889,15,0.320477411718288,5,10,"5 - 10","#005CAD",4,7,"2028"
3,100,59,2028-06-05,1905,9,0,4,"PRO","Providence Crabs","home",0,1,"Eastern Division","PBE",5,11,-6,"5 - 11",3,86,57,122,3249,7396,16,0.305213715359324,5,11,"5 - 11","#005CAD",4,7,"2028"
3,100,63,2028-06-06,1905,12,5,10,"PRO","Providence Crabs","home",0,1,"Eastern Division","PBE",5,12,-7,"5 - 12",6,92,62,132,3844,8464,17,0.312317192070198,5,12,"5 - 12","#005CAD",4,7,"2028"
3,100,71,2028-06-09,1905,9,2,6,"PRO","Providence Crabs","home",0,1,"Eastern Division","PBE",5,13,-8,"5 - 13",4,96,64,138,4096,9216,18,0.307692307692308,6,12,"6 - 12","#005CAD",4,7,"2028"
3,100,75,2028-06-10,1905,9,3,9,"PRO","Providence Crabs","home",0,1,"Eastern Division","PBE",5,14,-9,"5 - 14",9,105,67,147,4489,11025,19,0.289351553435607,5,14,"5 - 14","#005CAD",4,7,"2028"
3,100,79,2028-06-11,1905,9,4,8,"PRO","Providence Crabs","away",0,1,"Eastern Division","PBE",5,15,-10,"5 - 15",10,115,71,155,5041,13225,20,0.275977225446184,6,14,"6 - 14","#005CAD",4,7,"2028"
3,100,81,2028-06-12,1905,9,6,10,"PRO","Providence Crabs","away",0,1,"Eastern Division","PBE",5,16,-11,"5 - 16",11,126,77,165,5929,15876,21,0.271910112359551,6,15,"6 - 15","#005CAD",4,7,"2028"
3,100,84,2028-06-14,1905,9,4,9,"PRO","Providence Crabs","away",0,1,"Eastern Division","PBE",5,17,-12,"5 - 17",7,133,81,174,6561,17689,22,0.270556701030928,6,16,"6 - 16","#005CAD",4,7,"2028"
3,100,88,2028-06-15,1905,9,1,4,"PRO","Providence Crabs","away",0,1,"Eastern Division","PBE",5,18,-13,"5 - 18",5,138,82,178,6724,19044,23,0.260943806271344,6,17,"6 - 17","#005CAD",4,7,"2028"
3,100,92,2028-06-16,1905,9,4,5,"PRO","Providence Crabs","away",0,1,"Eastern Division","PBE",5,19,-14,"5 - 19",5,143,86,183,7396,20449,24,0.265613216017238,6,18,"6 - 18","#005CAD",4,7,"2028"
3,100,96,2028-06-19,1905,9,2,6,"PRO","Providence Crabs","away",0,1,"Eastern Division","PBE",5,20,-15,"5 - 20",11,154,88,189,7744,23716,25,0.246153846153846,6,19,"6 - 19","#005CAD",4,7,"2028"
3,100,100,2028-06-20,1905,9,0,5,"PRO","Providence Crabs","away",0,1,"Eastern Division","PBE",5,21,-16,"5 - 21",9,163,88,194,7744,26569,26,0.225687057383499,6,20,"6 - 20","#005CAD",4,7,"2028"
3,100,104,2028-06-21,1905,9,1,4,"PRO","Providence Crabs","away",0,1,"Eastern Division","PBE",5,22,-17,"5 - 22",4,167,89,198,7921,27889,27,0.221195196872382,6,21,"6 - 21","#005CAD",4,7,"2028"
3,100,109,2028-06-24,1905,9,5,12,"PRO","Providence Crabs","away",0,1,"Eastern Division","PBE",5,23,-18,"5 - 23",11,178,94,210,8836,31684,28,0.218065153010859,6,22,"6 - 22","#005CAD",4,7,"2028"
3,100,113,2028-06-25,1905,9,2,7,"PRO","Providence Crabs","away",0,1,"Eastern Division","PBE",5,24,-19,"5 - 24",4,182,96,217,9216,33124,29,0.217666509211148,6,23,"6 - 23","#005CAD",4,7,"2028"
3,100,117,2028-06-26,1905,9,1,5,"PRO","Providence Crabs","away",0,1,"Eastern Division","PBE",5,25,-20,"5 - 25",3,185,97,222,9409,34225,30,0.215634596873997,6,24,"6 - 24","#005CAD",4,7,"2028"
3,100,124,2028-06-29,1905,9,7,9,"PRO","Providence Crabs","home",0,1,"Eastern Division","PBE",5,26,-21,"5 - 26",8,193,104,231,10816,37249,31,0.225028607094559,7,24,"7 - 24","#005CAD",4,7,"2028"
3,100,127,2028-06-30,1905,9,3,5,"PRO","Providence Crabs","home",1,0,"Eastern Division","PBE",6,26,-20,"6 - 26",1,194,107,236,11449,37636,32,0.233248446572273,7,25,"7 - 25","#005CAD",4,7,"2028"
3,100,131,2028-07-01,1905,9,4,9,"PRO","Providence Crabs","home",1,0,"Eastern Division","PBE",7,26,-19,"7 - 26",2,196,111,245,12321,38416,33,0.242840530579262,8,25,"8 - 25","#005CAD",4,7,"2028"
3,100,135,2028-07-04,1905,9,1,7,"PRO","Providence Crabs","away",0,1,"Eastern Division","PBE",7,27,-20,"7 - 27",3,199,112,252,12544,39601,34,0.240559976987247,8,26,"8 - 26","#005CAD",4,7,"2028"
3,100,139,2028-07-05,1905,9,6,14,"PRO","Providence Crabs","away",1,0,"Eastern Division","PBE",8,27,-19,"8 - 27",3,202,118,266,13924,40804,35,0.254421868147932,9,26,"9 - 26","#005CAD",4,7,"2028"
3,100,143,2028-07-06,1905,9,4,7,"PRO","Providence Crabs","away",0,1,"Eastern Division","PBE",8,28,-20,"8 - 28",8,210,122,273,14884,44100,36,0.252339617523396,9,27,"9 - 27","#005CAD",4,7,"2028"
3,100,149,2028-07-09,1905,9,6,12,"PRO","Providence Crabs","home",1,0,"Eastern Division","PBE",9,28,-19,"9 - 28",5,215,128,285,16384,46225,37,0.261687616796307,10,27,"10 - 27","#005CAD",4,7,"2028"
3,100,153,2028-07-10,1905,9,6,11,"PRO","Providence Crabs","home",0,1,"Eastern Division","PBE",9,29,-20,"9 - 29",8,223,134,296,17956,49729,38,0.26528772992539,10,28,"10 - 28","#005CAD",4,7,"2028"
3,100,157,2028-07-11,1905,9,4,12,"PRO","Providence Crabs","away",0,1,"Eastern Division","PBE",9,30,-21,"9 - 30",8,231,138,308,19044,53361,39,0.263020509633313,10,29,"10 - 29","#005CAD",4,7,"2028"
3,100,161,2028-07-12,1905,9,7,14,"PRO","Providence Crabs","away",1,0,"Eastern Division","PBE",10,30,-20,"10 - 30",5,236,145,322,21025,55696,40,0.274044915994317,11,29,"11 - 29","#005CAD",4,7,"2028"
3,100,168,2028-07-15,1905,9,1,6,"PRO","Providence Crabs","home",0,1,"Eastern Division","PBE",10,31,-21,"10 - 31",15,251,146,328,21316,63001,41,0.252807856066985,10,31,"10 - 31","#005CAD",4,7,"2028"
3,100,172,2028-07-16,1905,9,1,8,"PRO","Providence Crabs","home",0,1,"Eastern Division","PBE",10,32,-22,"10 - 32",2,253,147,336,21609,64009,42,0.25238851643346,11,31,"11 - 31","#005CAD",4,7,"2028"
3,100,174,2028-07-17,1905,9,2,7,"PRO","Providence Crabs","home",0,1,"Eastern Division","PBE",10,33,-23,"10 - 33",5,258,149,343,22201,66564,43,0.250109840590323,11,32,"11 - 32","#005CAD",4,7,"2028"
3,100,176,2028-07-19,1905,9,4,7,"PRO","Providence Crabs","away",0,1,"Eastern Division","PBE",10,34,-24,"10 - 34",8,266,153,350,23409,70756,44,0.248595550363723,11,33,"11 - 33","#005CAD",4,7,"2028"
3,100,180,2028-07-20,1905,9,2,5,"PRO","Providence Crabs","away",0,1,"Eastern Division","PBE",10,35,-25,"10 - 35",7,273,155,355,24025,74529,45,0.243774986301926,11,34,"11 - 34","#005CAD",4,7,"2028"
3,100,184,2028-07-21,1905,9,4,8,"PRO","Providence Crabs","home",1,0,"Eastern Division","PBE",11,35,-24,"11 - 35",3,276,159,363,25281,76176,46,0.249179455335758,11,35,"11 - 35","#005CAD",4,7,"2028"
3,100,188,2028-07-22,1905,9,2,4,"PRO","Providence Crabs","home",1,0,"Eastern Division","PBE",12,35,-23,"12 - 35",0,276,161,367,25921,76176,47,0.253886010362694,12,35,"12 - 35","#005CAD",4,7,"2028"
3,100,189,2028-07-24,1905,9,0,5,"PRO","Providence Crabs","away",0,1,"Eastern Division","PBE",12,36,-24,"12 - 36",7,283,161,372,25921,80089,48,0.244514668427507,12,36,"12 - 36","#005CAD",4,7,"2028"
3,100,192,2028-07-25,1905,9,4,8,"PRO","Providence Crabs","away",0,1,"Eastern Division","PBE",12,37,-25,"12 - 37",8,291,165,380,27225,84681,49,0.243284542383786,12,37,"12 - 37","#005CAD",4,7,"2028"
3,100,196,2028-07-26,1905,9,1,8,"PRO","Providence Crabs","away",0,1,"Eastern Division","PBE",12,38,-26,"12 - 38",2,293,166,388,27556,85849,50,0.242987522596005,12,38,"12 - 38","#005CAD",4,7,"2028"
3,100,200,2028-07-27,1905,9,6,14,"PRO","Providence Crabs","away",1,0,"Eastern Division","PBE",13,38,-25,"13 - 38",2,295,172,402,29584,87025,51,0.253702544400518,13,38,"13 - 38","#005CAD",4,7,"2028"
3,100,204,2028-08-11,1905,9,0,4,"PRO","Providence Crabs","away",0,1,"Eastern Division","PBE",13,39,-26,"13 - 39",4,299,172,406,29584,89401,52,0.24863638273732,13,39,"13 - 39","#005CAD",4,7,"2028"
3,100,208,2028-08-12,1905,9,6,10,"PRO","Providence Crabs","away",0,1,"Eastern Division","PBE",13,40,-27,"13 - 40",13,312,178,416,31684,97344,53,0.245559103450414,13,40,"13 - 40","#005CAD",4,7,"2028"
3,100,212,2028-08-13,1905,9,6,8,"PRO","Providence Crabs","away",1,0,"Eastern Division","PBE",14,40,-26,"14 - 40",0,312,184,424,33856,97344,54,0.258048780487805,14,40,"14 - 40","#005CAD",4,7,"2028"
3,100,218,2028-08-16,1905,9,3,7,"PRO","Providence Crabs","home",0,1,"Eastern Division","PBE",14,41,-27,"14 - 41",5,317,187,431,34969,100489,55,0.258153818895894,14,41,"14 - 41","#005CAD",4,7,"2028"
3,100,221,2028-08-17,1905,10,5,12,"PRO","Providence Crabs","home",0,1,"Eastern Division","PBE",14,42,-28,"14 - 42",6,323,192,443,36864,104329,56,0.261089430779146,15,41,"15 - 41","#005CAD",4,7,"2028"
3,100,225,2028-08-18,1905,9,3,7,"PRO","Providence Crabs","home",0,1,"Eastern Division","PBE",14,43,-29,"14 - 43",14,337,195,450,38025,113569,57,0.250834465744027,14,43,"14 - 43","#005CAD",4,7,"2028"
9,100,4,2028-05-15,1905,9,5,10,"SAS","San Antonio Sloths","home",1,0,"Western Division","PBE",1,0,1,"1 - 0",4,4,5,10,25,16,1,0.609756097560976,1,0,"1 - 0","#87795E",2,3,"2028"
9,100,8,2028-05-16,1905,9,8,13,"SAS","San Antonio Sloths","home",1,0,"Western Division","PBE",2,0,2,"2 - 0",3,7,13,23,169,49,2,0.775229357798165,2,0,"2 - 0","#87795E",2,3,"2028"
9,100,12,2028-05-17,1905,9,4,6,"SAS","San Antonio Sloths","home",1,0,"Western Division","PBE",3,0,3,"3 - 0",1,8,17,29,289,64,3,0.818696883852691,2,1,"2 - 1","#87795E",2,3,"2028"
9,100,14,2028-05-18,1905,9,9,12,"SAS","San Antonio Sloths","home",1,0,"Western Division","PBE",4,0,4,"4 - 0",4,12,26,41,676,144,4,0.824390243902439,3,1,"3 - 1","#87795E",2,3,"2028"
9,100,18,2028-05-20,1905,9,21,20,"SAS","San Antonio Sloths","away",1,0,"Western Division","PBE",5,0,5,"5 - 0",2,14,47,61,2209,196,5,0.918503118503118,5,0,"5 - 0","#87795E",2,3,"2028"
9,100,22,2028-05-21,1905,12,8,16,"SAS","San Antonio Sloths","away",0,1,"Western Division","PBE",5,1,4,"5 - 1",9,23,55,77,3025,529,6,0.851153629712999,5,1,"5 - 1","#87795E",2,3,"2028"
9,100,26,2028-05-22,1905,9,2,5,"SAS","San Antonio Sloths","away",1,0,"Western Division","PBE",6,1,5,"6 - 1",0,23,57,82,3249,529,7,0.859978824775013,6,1,"6 - 1","#87795E",2,3,"2028"
9,100,31,2028-05-25,1905,9,3,6,"SAS","San Antonio Sloths","away",0,1,"Western Division","PBE",6,2,4,"6 - 2",5,28,60,88,3600,784,8,0.821167883211679,7,1,"7 - 1","#87795E",2,3,"2028"
9,100,35,2028-05-26,1905,9,12,17,"SAS","San Antonio Sloths","away",1,0,"Western Division","PBE",7,2,5,"7 - 2",2,30,72,105,5184,900,9,0.85207100591716,8,1,"8 - 1","#87795E",2,3,"2028"
9,100,39,2028-05-27,1905,9,6,6,"SAS","San Antonio Sloths","away",0,1,"Western Division","PBE",7,3,4,"7 - 3",7,37,78,111,6084,1369,10,0.81631557761975,8,2,"8 - 2","#87795E",2,3,"2028"
9,100,41,2028-05-28,1905,9,11,11,"SAS","San Antonio Sloths","away",1,0,"Western Division","PBE",8,3,5,"8 - 3",4,41,89,122,7921,1681,11,0.824932305769631,9,2,"9 - 2","#87795E",2,3,"2028"
9,100,44,2028-05-30,1905,9,4,9,"SAS","San Antonio Sloths","home",1,0,"Western Division","PBE",9,3,6,"9 - 3",3,44,93,131,8649,1936,12,0.81709966934341,10,2,"10 - 2","#87795E",2,3,"2028"
9,100,48,2028-05-31,1905,9,6,12,"SAS","San Antonio Sloths","home",1,0,"Western Division","PBE",10,3,7,"10 - 3",3,47,99,143,9801,2209,13,0.816069941715237,11,2,"11 - 2","#87795E",2,3,"2028"
9,100,52,2028-06-01,1905,9,4,8,"SAS","San Antonio Sloths","home",0,1,"Western Division","PBE",10,4,6,"10 - 4",7,54,103,151,10609,2916,14,0.784399260628466,11,3,"11 - 3","#87795E",2,3,"2028"
9,100,57,2028-06-04,1905,9,10,13,"SAS","San Antonio Sloths","home",1,0,"Western Division","PBE",11,4,7,"11 - 4",8,62,113,164,12769,3844,15,0.768614940107145,12,3,"12 - 3","#87795E",2,3,"2028"
9,100,61,2028-06-05,1905,9,4,9,"SAS","San Antonio Sloths","home",0,1,"Western Division","PBE",11,5,6,"11 - 5",7,69,117,173,13689,4761,16,0.741951219512195,12,4,"12 - 4","#87795E",2,3,"2028"
9,100,65,2028-06-06,1905,9,5,11,"SAS","San Antonio Sloths","home",0,1,"Western Division","PBE",11,6,5,"11 - 6",11,80,122,184,14884,6400,17,0.699304641984589,12,5,"12 - 5","#87795E",2,3,"2028"
9,100,67,2028-06-07,1905,9,8,13,"SAS","San Antonio Sloths","home",1,0,"Western Division","PBE",12,6,6,"12 - 6",7,87,130,197,16900,7569,18,0.690669827128203,12,6,"12 - 6","#87795E",2,3,"2028"
9,100,71,2028-06-09,1905,9,4,10,"SAS","San Antonio Sloths","away",1,0,"Western Division","PBE",13,6,7,"13 - 6",2,89,134,207,17956,7921,19,0.693898056188894,13,6,"13 - 6","#87795E",2,3,"2028"
9,100,75,2028-06-10,1905,9,9,15,"SAS","San Antonio Sloths","away",1,0,"Western Division","PBE",14,6,8,"14 - 6",3,92,143,222,20449,8464,20,0.707259710164978,14,6,"14 - 6","#87795E",2,3,"2028"
9,100,79,2028-06-11,1905,9,10,14,"SAS","San Antonio Sloths","home",1,0,"Western Division","PBE",15,6,9,"15 - 6",4,96,153,236,23409,9216,21,0.71751724137931,15,6,"15 - 6","#87795E",2,3,"2028"
9,100,81,2028-06-12,1905,9,11,14,"SAS","San Antonio Sloths","home",1,0,"Western Division","PBE",16,6,10,"16 - 6",6,102,164,250,26896,10404,22,0.721072386058981,16,6,"16 - 6","#87795E",2,3,"2028"
9,100,86,2028-06-15,1905,9,4,9,"SAS","San Antonio Sloths","home",0,1,"Western Division","PBE",16,7,9,"16 - 7",8,110,168,259,28224,12100,23,0.699930562444202,16,7,"16 - 7","#87795E",2,3,"2028"
9,100,90,2028-06-16,1905,9,5,11,"SAS","San Antonio Sloths","home",1,0,"Western Division","PBE",17,7,10,"17 - 7",0,110,173,270,29929,12100,24,0.712103547550501,17,7,"17 - 7","#87795E",2,3,"2028"
9,100,94,2028-06-17,1905,9,10,15,"SAS","San Antonio Sloths","home",1,0,"Western Division","PBE",18,7,11,"18 - 7",6,116,183,285,33489,13456,25,0.713366705719459,18,7,"18 - 7","#87795E",2,3,"2028"
9,100,95,2028-06-19,1905,9,16,16,"SAS","San Antonio Sloths","home",1,0,"Western Division","PBE",19,7,12,"19 - 7",3,119,199,301,39601,14161,26,0.736598340835534,19,7,"19 - 7","#87795E",2,3,"2028"
9,100,99,2028-06-20,1905,9,7,10,"SAS","San Antonio Sloths","home",1,0,"Western Division","PBE",20,7,13,"20 - 7",3,122,206,311,42436,14884,27,0.740334961618981,20,7,"20 - 7","#87795E",2,3,"2028"
9,100,103,2028-06-21,1905,9,4,9,"SAS","San Antonio Sloths","away",0,1,"Western Division","PBE",20,8,12,"20 - 8",9,131,210,320,44100,17161,28,0.719870717095705,20,8,"20 - 8","#87795E",2,3,"2028"
9,100,107,2028-06-22,1905,11,7,15,"SAS","San Antonio Sloths","away",0,1,"Western Division","PBE",20,9,11,"20 - 9",8,139,217,335,47089,19321,29,0.709064899864478,21,8,"21 - 8","#87795E",2,3,"2028"
9,100,110,2028-06-24,1905,9,1,5,"SAS","San Antonio Sloths","home",0,1,"Western Division","PBE",20,10,10,"20 - 10",4,143,218,340,47524,20449,30,0.69915996057258,21,9,"21 - 9","#87795E",2,3,"2028"
9,100,114,2028-06-25,1905,9,14,15,"SAS","San Antonio Sloths","home",1,0,"Western Division","PBE",21,10,11,"21 - 10",11,154,232,355,53824,23716,31,0.694144957441321,22,9,"22 - 9","#87795E",2,3,"2028"
9,100,118,2028-06-26,1905,9,4,9,"SAS","San Antonio Sloths","home",0,1,"Western Division","PBE",21,11,10,"21 - 11",5,159,236,364,55696,25281,32,0.6878002395742,22,10,"22 - 10","#87795E",2,3,"2028"
9,100,121,2028-06-27,1905,9,1,6,"SAS","San Antonio Sloths","home",0,1,"Western Division","PBE",21,12,9,"21 - 12",7,166,237,370,56169,27556,33,0.670874888026276,22,11,"22 - 11","#87795E",2,3,"2028"
9,100,124,2028-06-29,1905,9,8,10,"SAS","San Antonio Sloths","away",1,0,"Western Division","PBE",22,12,10,"22 - 12",7,173,245,380,60025,29929,34,0.667285501478533,23,11,"23 - 11","#87795E",2,3,"2028"
9,100,127,2028-06-30,1905,9,1,3,"SAS","San Antonio Sloths","away",0,1,"Western Division","PBE",22,13,9,"22 - 13",3,176,246,383,60516,30976,35,0.661434879552311,23,12,"23 - 12","#87795E",2,3,"2028"
9,100,131,2028-07-01,1905,9,2,8,"SAS","San Antonio Sloths","away",0,1,"Western Division","PBE",22,14,8,"22 - 14",4,180,248,391,61504,32400,36,0.654966774578293,24,12,"24 - 12","#87795E",2,3,"2028"
9,100,138,2028-07-04,1905,9,3,8,"SAS","San Antonio Sloths","away",0,1,"Western Division","PBE",22,15,7,"22 - 15",9,189,251,399,63001,35721,37,0.638165758392253,24,13,"24 - 13","#87795E",2,3,"2028"
9,100,142,2028-07-05,1905,9,12,18,"SAS","San Antonio Sloths","away",1,0,"Western Division","PBE",23,15,8,"23 - 15",7,196,263,417,69169,38416,38,0.642924199470186,24,14,"24 - 14","#87795E",2,3,"2028"
9,100,146,2028-07-06,1905,9,0,4,"SAS","San Antonio Sloths","away",0,1,"Western Division","PBE",23,16,7,"23 - 16",1,197,263,421,69169,38809,39,0.640584193076367,25,14,"25 - 14","#87795E",2,3,"2028"
9,100,150,2028-07-09,1905,9,7,8,"SAS","San Antonio Sloths","away",1,0,"Western Division","PBE",24,16,8,"24 - 16",3,200,270,429,72900,40000,40,0.645704162976085,26,14,"26 - 14","#87795E",2,3,"2028"
9,100,154,2028-07-10,1905,9,2,7,"SAS","San Antonio Sloths","away",0,1,"Western Division","PBE",24,17,7,"24 - 17",6,206,272,436,73984,42436,41,0.63549218347363,26,15,"26 - 15","#87795E",2,3,"2028"
9,100,158,2028-07-11,1905,9,3,7,"SAS","San Antonio Sloths","away",0,1,"Western Division","PBE",24,18,6,"24 - 18",4,210,275,443,75625,44100,42,0.631655878053873,27,15,"27 - 15","#87795E",2,3,"2028"
9,100,162,2028-07-14,1905,9,7,14,"SAS","San Antonio Sloths","home",1,0,"Western Division","PBE",25,18,7,"25 - 18",6,216,282,457,79524,46656,43,0.630242510699001,27,16,"27 - 16","#87795E",2,3,"2028"
9,100,165,2028-07-15,1905,9,6,7,"SAS","San Antonio Sloths","home",1,0,"Western Division","PBE",26,18,8,"26 - 18",1,217,288,464,82944,47089,44,0.637868848676874,28,16,"28 - 16","#87795E",2,3,"2028"
9,100,169,2028-07-16,1905,9,4,6,"SAS","San Antonio Sloths","home",1,0,"Western Division","PBE",27,18,9,"27 - 18",1,218,292,470,85264,47524,45,0.642106214416965,29,16,"29 - 16","#87795E",2,3,"2028"
9,100,175,2028-07-19,1905,9,11,13,"SAS","San Antonio Sloths","away",1,0,"Western Division","PBE",28,18,10,"28 - 18",7,225,303,483,91809,50625,46,0.644572222924302,30,16,"30 - 16","#87795E",2,3,"2028"
9,100,179,2028-07-20,1905,9,2,5,"SAS","San Antonio Sloths","away",0,1,"Western Division","PBE",28,19,9,"28 - 19",9,234,305,488,93025,54756,47,0.629478755726379,30,17,"30 - 17","#87795E",2,3,"2028"
9,100,183,2028-07-21,1905,9,2,8,"SAS","San Antonio Sloths","home",0,1,"Western Division","PBE",28,20,8,"28 - 20",3,237,307,496,94249,56169,48,0.626580595407465,30,18,"30 - 18","#87795E",2,3,"2028"
9,100,187,2028-07-22,1905,9,5,10,"SAS","San Antonio Sloths","home",0,1,"Western Division","PBE",28,21,7,"28 - 21",6,243,312,506,97344,59049,49,0.622431950279105,30,19,"30 - 19","#87795E",2,3,"2028"
9,100,195,2028-07-25,1905,9,9,11,"SAS","San Antonio Sloths","home",1,0,"Western Division","PBE",29,21,8,"29 - 21",4,247,321,517,103041,61009,50,0.628107284364523,31,19,"31 - 19","#87795E",2,3,"2028"
9,100,199,2028-07-26,1905,9,8,9,"SAS","San Antonio Sloths","home",1,0,"Western Division","PBE",30,21,9,"30 - 21",7,254,329,526,108241,64516,51,0.626550588398733,32,19,"32 - 19","#87795E",2,3,"2028"
9,100,201,2028-07-27,1905,9,5,6,"SAS","San Antonio Sloths","home",0,1,"Western Division","PBE",30,22,8,"30 - 22",6,260,334,532,111556,67600,52,0.622675210431133,32,20,"32 - 20","#87795E",2,3,"2028"
9,100,203,2028-08-11,1905,9,10,17,"SAS","San Antonio Sloths","home",0,1,"Western Division","PBE",30,23,7,"30 - 23",11,271,344,549,118336,73441,53,0.617050011210938,33,20,"33 - 20","#87795E",2,3,"2028"
9,100,207,2028-08-12,1905,9,14,17,"SAS","San Antonio Sloths","home",1,0,"Western Division","PBE",31,23,8,"31 - 23",10,281,358,566,128164,78961,54,0.618776101388051,33,21,"33 - 21","#87795E",2,3,"2028"
9,100,211,2028-08-13,1905,9,3,2,"SAS","San Antonio Sloths","away",1,0,"Western Division","PBE",32,23,9,"32 - 23",1,282,361,568,130321,79524,55,0.621034573137316,34,21,"34 - 21","#87795E",2,3,"2028"
9,100,215,2028-08-14,1905,9,1,5,"SAS","San Antonio Sloths","away",0,1,"Western Division","PBE",32,24,8,"32 - 24",7,289,362,573,131044,83521,56,0.610742665392771,34,22,"34 - 22","#87795E",2,3,"2028"
9,100,223,2028-08-17,1905,9,8,15,"SAS","San Antonio Sloths","home",1,0,"Western Division","PBE",33,24,9,"33 - 24",2,291,370,588,136900,84681,57,0.617832756418646,35,22,"35 - 22","#87795E",2,3,"2028"
9,100,227,2028-08-18,1905,9,10,8,"SAS","San Antonio Sloths","home",1,0,"Western Division","PBE",34,24,10,"34 - 24",2,293,380,596,144400,85849,58,0.627147132017946,36,22,"36 - 22","#87795E",2,3,"2028"
9,100,229,2028-08-19,1905,9,8,11,"SAS","San Antonio Sloths","home",0,1,"Western Division","PBE",34,25,9,"34 - 25",10,303,388,607,150544,91809,59,0.621176548258119,37,22,"37 - 22","#87795E",2,3,"2028"
10,100,3,2028-05-15,1905,9,7,8,"DV","Death Valley Scorpions","away",1,0,"Western Division","PBE",1,0,1,"1 - 0",3,3,7,8,49,9,1,0.844827586206897,1,0,"1 - 0","#97162B",1,2,"2028"
10,100,7,2028-05-16,1905,12,10,15,"DV","Death Valley Scorpions","away",1,0,"Western Division","PBE",2,0,2,"2 - 0",8,11,17,23,289,121,2,0.704878048780488,1,1,"1 - 1","#97162B",1,2,"2028"
10,100,11,2028-05-17,1905,9,3,5,"DV","Death Valley Scorpions","away",1,0,"Western Division","PBE",3,0,3,"3 - 0",2,13,20,28,400,169,3,0.70298769771529,2,1,"2 - 1","#97162B",1,2,"2028"
10,100,15,2028-05-20,1905,9,4,8,"DV","Death Valley Scorpions","home",1,0,"Western Division","PBE",4,0,4,"4 - 0",2,15,24,36,576,225,4,0.719101123595506,3,1,"3 - 1","#97162B",1,2,"2028"
10,100,19,2028-05-21,1905,9,1,8,"DV","Death Valley Scorpions","home",0,1,"Western Division","PBE",4,1,3,"4 - 1",3,18,25,44,625,324,5,0.658587987355111,3,2,"3 - 2","#97162B",1,2,"2028"
10,100,23,2028-05-22,1905,9,6,9,"DV","Death Valley Scorpions","away",1,0,"Western Division","PBE",5,1,4,"5 - 1",0,18,31,53,961,324,6,0.747859922178988,4,2,"4 - 2","#97162B",1,2,"2028"
10,100,27,2028-05-23,1905,9,7,9,"DV","Death Valley Scorpions","away",1,0,"Western Division","PBE",6,1,5,"6 - 1",3,21,38,62,1444,441,7,0.76604774535809,5,2,"5 - 2","#97162B",1,2,"2028"
10,100,34,2028-05-26,1905,9,6,9,"DV","Death Valley Scorpions","home",1,0,"Western Division","PBE",7,1,6,"7 - 1",1,22,44,71,1936,484,8,0.8,6,2,"6 - 2","#97162B",1,2,"2028"
10,100,38,2028-05-27,1905,9,7,14,"DV","Death Valley Scorpions","home",1,0,"Western Division","PBE",8,1,7,"8 - 1",0,22,51,85,2601,484,9,0.843111831442463,8,1,"8 - 1","#97162B",1,2,"2028"
10,100,40,2028-05-28,1905,9,11,11,"DV","Death Valley Scorpions","home",1,0,"Western Division","PBE",9,1,8,"9 - 1",6,28,62,96,3844,784,10,0.830596369922213,8,2,"8 - 2","#97162B",1,2,"2028"
10,100,43,2028-05-30,1905,9,7,12,"DV","Death Valley Scorpions","away",0,1,"Western Division","PBE",9,2,7,"9 - 2",8,36,69,108,4761,1296,11,0.786032689450223,9,2,"9 - 2","#97162B",1,2,"2028"
10,100,47,2028-05-31,1905,9,5,10,"DV","Death Valley Scorpions","away",0,1,"Western Division","PBE",9,3,6,"9 - 3",10,46,74,118,5476,2116,12,0.721285563751317,9,3,"9 - 3","#97162B",1,2,"2028"
10,100,51,2028-06-01,1905,9,11,14,"DV","Death Valley Scorpions","away",1,0,"Western Division","PBE",10,3,7,"10 - 3",6,52,85,132,7225,2704,13,0.72766643166482,9,4,"9 - 4","#97162B",1,2,"2028"
10,100,58,2028-06-04,1905,9,8,16,"DV","Death Valley Scorpions","away",1,0,"Western Division","PBE",11,3,8,"11 - 3",2,54,93,148,8649,2916,14,0.747859922178988,10,4,"10 - 4","#97162B",1,2,"2028"
10,100,62,2028-06-05,1905,9,2,5,"DV","Death Valley Scorpions","away",1,0,"Western Division","PBE",12,3,9,"12 - 3",1,55,95,153,9025,3025,15,0.74896265560166,11,4,"11 - 4","#97162B",1,2,"2028"
10,100,66,2028-06-06,1905,9,9,11,"DV","Death Valley Scorpions","away",0,1,"Western Division","PBE",12,4,8,"12 - 4",13,68,104,164,10816,4624,16,0.700518134715026,11,5,"11 - 5","#97162B",1,2,"2028"
10,100,69,2028-06-09,1905,9,13,17,"DV","Death Valley Scorpions","home",1,0,"Western Division","PBE",13,4,9,"13 - 4",0,68,117,181,13689,4624,17,0.747501774695571,13,4,"13 - 4","#97162B",1,2,"2028"
10,100,73,2028-06-10,1905,9,3,5,"DV","Death Valley Scorpions","home",1,0,"Western Division","PBE",14,4,10,"14 - 4",0,68,120,186,14400,4624,18,0.756938603868797,14,4,"14 - 4","#97162B",1,2,"2028"
10,100,77,2028-06-11,1905,9,1,4,"DV","Death Valley Scorpions","home",0,1,"Western Division","PBE",14,5,9,"14 - 5",5,73,121,190,14641,5329,19,0.73314972458688,14,5,"14 - 5","#97162B",1,2,"2028"
10,100,82,2028-06-14,1905,9,1,7,"DV","Death Valley Scorpions","away",0,1,"Western Division","PBE",14,6,8,"14 - 6",3,76,122,197,14884,5776,20,0.720425943852856,14,6,"14 - 6","#97162B",1,2,"2028"
10,100,85,2028-06-15,1905,9,6,10,"DV","Death Valley Scorpions","away",0,1,"Western Division","PBE",14,7,7,"14 - 7",8,84,128,207,16384,7056,21,0.698976109215017,15,6,"15 - 6","#97162B",1,2,"2028"
10,100,89,2028-06-16,1905,9,9,11,"DV","Death Valley Scorpions","away",1,0,"Western Division","PBE",15,7,8,"15 - 7",1,85,137,218,18769,7225,22,0.722051242594445,16,6,"16 - 6","#97162B",1,2,"2028"
10,100,93,2028-06-17,1905,9,9,14,"DV","Death Valley Scorpions","away",1,0,"Western Division","PBE",16,7,9,"16 - 7",0,85,146,232,21316,7225,23,0.746855401002067,17,6,"17 - 6","#97162B",1,2,"2028"
10,100,96,2028-06-19,1905,9,11,13,"DV","Death Valley Scorpions","home",1,0,"Western Division","PBE",17,7,10,"17 - 7",2,87,157,245,24649,7569,24,0.76506921596623,18,6,"18 - 6","#97162B",1,2,"2028"
10,100,100,2028-06-20,1905,9,9,14,"DV","Death Valley Scorpions","home",1,0,"Western Division","PBE",18,7,11,"18 - 7",0,87,166,259,27556,7569,25,0.784512455516014,20,5,"20 - 5","#97162B",1,2,"2028"
10,100,104,2028-06-21,1905,9,4,10,"DV","Death Valley Scorpions","home",1,0,"Western Division","PBE",19,7,12,"19 - 7",1,88,170,269,28900,7744,26,0.788669359240258,21,5,"21 - 5","#97162B",1,2,"2028"
10,100,110,2028-06-24,1905,9,4,9,"DV","Death Valley Scorpions","away",1,0,"Western Division","PBE",20,7,13,"20 - 7",1,89,174,278,30276,7921,27,0.792627693274341,21,6,"21 - 6","#97162B",1,2,"2028"
10,100,114,2028-06-25,1905,9,11,13,"DV","Death Valley Scorpions","away",0,1,"Western Division","PBE",20,8,12,"20 - 8",14,103,185,291,34225,10609,28,0.763371548378463,21,7,"21 - 7","#97162B",1,2,"2028"
10,100,118,2028-06-26,1905,9,5,9,"DV","Death Valley Scorpions","away",1,0,"Western Division","PBE",21,8,13,"21 - 8",4,107,190,300,36100,11449,29,0.759216807924457,22,7,"22 - 7","#97162B",1,2,"2028"
10,100,121,2028-06-27,1905,9,7,8,"DV","Death Valley Scorpions","away",1,0,"Western Division","PBE",22,8,14,"22 - 8",1,108,197,308,38809,11664,30,0.76890614784142,23,7,"23 - 7","#97162B",1,2,"2028"
10,100,128,2028-06-30,1905,9,6,8,"DV","Death Valley Scorpions","home",1,0,"Western Division","PBE",23,8,15,"23 - 8",5,113,203,316,41209,12769,31,0.763440661010041,24,7,"24 - 7","#97162B",1,2,"2028"
10,100,132,2028-07-01,1905,9,6,7,"DV","Death Valley Scorpions","home",1,0,"Western Division","PBE",24,8,16,"24 - 8",3,116,209,323,43681,13456,32,0.764495860825735,24,8,"24 - 8","#97162B",1,2,"2028"
10,100,134,2028-07-02,1905,9,1,7,"DV","Death Valley Scorpions","home",0,1,"Western Division","PBE",24,9,15,"24 - 9",6,122,210,330,44100,14884,33,0.747660382476604,25,8,"25 - 8","#97162B",1,2,"2028"
10,100,137,2028-07-04,1905,9,8,10,"DV","Death Valley Scorpions","home",1,0,"Western Division","PBE",25,9,16,"25 - 9",0,122,218,340,47524,14884,34,0.76150493526471,26,8,"26 - 8","#97162B",1,2,"2028"
10,100,141,2028-07-05,1905,9,9,12,"DV","Death Valley Scorpions","home",1,0,"Western Division","PBE",26,9,17,"26 - 9",1,123,227,352,51529,15129,35,0.7730354946143,27,8,"27 - 8","#97162B",1,2,"2028"
10,100,145,2028-07-06,1905,9,0,5,"DV","Death Valley Scorpions","home",0,1,"Western Division","PBE",26,10,16,"26 - 10",3,126,227,357,51529,15876,36,0.764468511238039,28,8,"28 - 8","#97162B",1,2,"2028"
10,100,147,2028-07-07,1905,9,8,12,"DV","Death Valley Scorpions","home",1,0,"Western Division","PBE",27,10,17,"27 - 10",1,127,235,369,55225,16129,37,0.7739580121647,29,8,"29 - 8","#97162B",1,2,"2028"
10,100,151,2028-07-09,1905,9,5,10,"DV","Death Valley Scorpions","away",0,1,"Western Division","PBE",27,11,16,"27 - 11",7,134,240,379,57600,17956,38,0.762348456773784,29,9,"29 - 9","#97162B",1,2,"2028"
10,100,155,2028-07-10,1905,9,2,6,"DV","Death Valley Scorpions","away",1,0,"Western Division","PBE",28,11,17,"28 - 11",0,134,242,385,58564,17956,39,0.765342394145321,30,9,"30 - 9","#97162B",1,2,"2028"
10,100,159,2028-07-11,1905,9,12,16,"DV","Death Valley Scorpions","away",1,0,"Western Division","PBE",29,11,18,"29 - 11",6,140,254,401,64516,19600,40,0.766988444528984,31,9,"31 - 9","#97162B",1,2,"2028"
10,100,163,2028-07-14,1905,9,9,8,"DV","Death Valley Scorpions","home",1,0,"Western Division","PBE",30,11,19,"30 - 11",1,141,263,409,69169,19881,41,0.776743402582819,32,9,"32 - 9","#97162B",1,2,"2028"
10,100,166,2028-07-15,1905,9,1,4,"DV","Death Valley Scorpions","home",0,1,"Western Division","PBE",30,12,18,"30 - 12",2,143,264,413,69696,20449,42,0.773154362416107,32,10,"32 - 10","#97162B",1,2,"2028"
10,100,170,2028-07-16,1905,9,5,7,"DV","Death Valley Scorpions","home",1,0,"Western Division","PBE",31,12,19,"31 - 12",1,144,269,420,72361,20736,43,0.77726457350935,33,10,"33 - 10","#97162B",1,2,"2028"
10,100,176,2028-07-19,1905,9,8,15,"DV","Death Valley Scorpions","home",1,0,"Western Division","PBE",32,12,20,"32 - 12",4,148,277,435,76729,21904,44,0.777924224144049,34,10,"34 - 10","#97162B",1,2,"2028"
10,100,180,2028-07-20,1905,9,7,9,"DV","Death Valley Scorpions","home",1,0,"Western Division","PBE",33,12,21,"33 - 12",2,150,284,444,80656,22500,45,0.781883748885184,35,10,"35 - 10","#97162B",1,2,"2028"
10,100,184,2028-07-21,1905,9,3,4,"DV","Death Valley Scorpions","away",0,1,"Western Division","PBE",33,13,20,"33 - 13",4,154,287,448,82369,23716,46,0.776443418013857,36,10,"36 - 10","#97162B",1,2,"2028"
10,100,188,2028-07-22,1905,9,0,4,"DV","Death Valley Scorpions","away",0,1,"Western Division","PBE",33,14,19,"33 - 14",2,156,287,452,82369,24336,47,0.771931961951174,36,11,"36 - 11","#97162B",1,2,"2028"
10,100,195,2028-07-25,1905,9,4,6,"DV","Death Valley Scorpions","away",0,1,"Western Division","PBE",33,15,18,"33 - 15",9,165,291,458,84681,27225,48,0.756715457616214,36,12,"36 - 12","#97162B",1,2,"2028"
10,100,199,2028-07-26,1905,9,7,10,"DV","Death Valley Scorpions","away",0,1,"Western Division","PBE",33,16,17,"33 - 16",8,173,298,468,88804,29929,49,0.747930230011875,37,12,"37 - 12","#97162B",1,2,"2028"
10,100,201,2028-07-27,1905,9,6,7,"DV","Death Valley Scorpions","away",1,0,"Western Division","PBE",34,16,18,"34 - 16",5,178,304,475,92416,31684,50,0.744689766317486,37,13,"37 - 13","#97162B",1,2,"2028"
10,100,205,2028-08-11,1905,9,10,12,"DV","Death Valley Scorpions","away",1,0,"Western Division","PBE",35,16,19,"35 - 16",7,185,314,487,98596,34225,51,0.742322373721023,38,13,"38 - 13","#97162B",1,2,"2028"
10,100,209,2028-08-12,1905,9,10,15,"DV","Death Valley Scorpions","away",1,0,"Western Division","PBE",36,16,20,"36 - 16",6,191,324,502,104976,36481,52,0.742105374778201,39,13,"39 - 13","#97162B",1,2,"2028"
10,100,213,2028-08-13,1905,9,7,6,"DV","Death Valley Scorpions","home",1,0,"Western Division","PBE",37,16,21,"37 - 16",3,194,331,508,109561,37636,53,0.744315441211438,39,14,"39 - 14","#97162B",1,2,"2028"
10,100,216,2028-08-14,1905,9,2,4,"DV","Death Valley Scorpions","home",0,1,"Western Division","PBE",37,17,20,"37 - 17",3,197,333,512,110889,38809,54,0.740751379443947,40,14,"40 - 14","#97162B",1,2,"2028"
10,100,223,2028-08-17,1905,9,2,8,"DV","Death Valley Scorpions","away",0,1,"Western Division","PBE",37,18,19,"37 - 18",8,205,335,520,112225,42025,55,0.727552674230146,40,15,"40 - 15","#97162B",1,2,"2028"
10,100,227,2028-08-18,1905,9,2,10,"DV","Death Valley Scorpions","away",0,1,"Western Division","PBE",37,19,18,"37 - 19",10,215,337,530,113569,46225,56,0.710721303678486,40,16,"40 - 16","#97162B",1,2,"2028"
10,100,229,2028-08-19,1905,9,10,15,"DV","Death Valley Scorpions","away",1,0,"Western Division","PBE",38,19,19,"38 - 19",8,223,347,545,120409,49729,57,0.707713738259531,40,17,"40 - 17","#97162B",1,2,"2028"
11,100,3,2028-05-15,1905,9,3,8,"VAN","Vancouver Vandals","home",0,1,"Western Division","PBE",0,1,-1,"0 - 1",7,7,3,8,9,49,1,0.155172413793103,0,1,"0 - 1","#183013",3,6,"2028"
11,100,7,2028-05-16,1905,12,8,11,"VAN","Vancouver Vandals","home",0,1,"Western Division","PBE",0,2,-2,"0 - 2",10,17,11,19,121,289,2,0.295121951219512,1,1,"1 - 1","#183013",3,6,"2028"
11,100,11,2028-05-17,1905,9,2,6,"VAN","Vancouver Vandals","home",0,1,"Western Division","PBE",0,3,-3,"0 - 3",3,20,13,25,169,400,3,0.29701230228471,1,2,"1 - 2","#183013",3,6,"2028"
11,100,17,2028-05-20,1905,9,4,11,"VAN","Vancouver Vandals","away",0,1,"Western Division","PBE",0,4,-4,"0 - 4",6,26,17,36,289,676,4,0.299481865284974,1,3,"1 - 3","#183013",3,6,"2028"
11,100,21,2028-05-21,1905,9,0,2,"VAN","Vancouver Vandals","away",0,1,"Western Division","PBE",0,5,-5,"0 - 5",6,32,17,38,289,1024,5,0.22010662604722,1,4,"1 - 4","#183013",3,6,"2028"
11,100,25,2028-05-22,1905,9,1,7,"VAN","Vancouver Vandals","home",0,1,"Western Division","PBE",0,6,-6,"0 - 6",6,38,18,45,324,1444,6,0.183257918552036,1,5,"1 - 5","#183013",3,6,"2028"
11,100,28,2028-05-23,1905,9,3,7,"VAN","Vancouver Vandals","home",0,1,"Western Division","PBE",0,7,-7,"0 - 7",5,43,21,52,441,1849,7,0.192576419213974,1,6,"1 - 6","#183013",3,6,"2028"
11,100,34,2028-05-26,1905,9,1,6,"VAN","Vancouver Vandals","away",0,1,"Western Division","PBE",0,8,-8,"0 - 8",6,49,22,58,484,2401,8,0.167764298093588,1,7,"1 - 7","#183013",3,6,"2028"
11,100,38,2028-05-27,1905,9,0,2,"VAN","Vancouver Vandals","away",0,1,"Western Division","PBE",0,9,-9,"0 - 9",7,56,22,60,484,3136,9,0.133701657458564,1,8,"1 - 8","#183013",3,6,"2028"
11,100,40,2028-05-28,1905,9,6,8,"VAN","Vancouver Vandals","away",0,1,"Western Division","PBE",0,10,-10,"0 - 10",11,67,28,68,784,4489,10,0.148681964725962,1,9,"1 - 9","#183013",3,6,"2028"
11,100,42,2028-05-30,1905,10,8,12,"VAN","Vancouver Vandals","home",1,0,"Western Division","PBE",1,10,-9,"1 - 10",6,73,36,80,1296,5329,11,0.195622641509434,2,9,"2 - 9","#183013",3,6,"2028"
11,100,46,2028-05-31,1905,9,10,10,"VAN","Vancouver Vandals","home",1,0,"Western Division","PBE",2,10,-8,"2 - 10",2,75,46,90,2116,5625,12,0.273349696421651,3,9,"3 - 9","#183013",3,6,"2028"
11,100,50,2028-06-01,1905,9,9,12,"VAN","Vancouver Vandals","away",1,0,"Western Division","PBE",3,10,-7,"3 - 10",2,77,55,102,3025,5929,13,0.337837837837838,4,9,"4 - 9","#183013",3,6,"2028"
11,100,54,2028-06-02,1905,9,2,5,"VAN","Vancouver Vandals","away",0,1,"Western Division","PBE",3,11,-8,"3 - 11",4,81,57,107,3249,6561,14,0.331192660550459,5,9,"5 - 9","#183013",3,6,"2028"
11,100,57,2028-06-04,1905,9,8,12,"VAN","Vancouver Vandals","away",0,1,"Western Division","PBE",3,12,-9,"3 - 12",10,91,65,119,4225,8281,15,0.337837837837838,5,10,"5 - 10","#183013",3,6,"2028"
11,100,61,2028-06-05,1905,9,7,8,"VAN","Vancouver Vandals","away",1,0,"Western Division","PBE",4,12,-8,"4 - 12",4,95,72,127,5184,9025,16,0.364839186431135,6,10,"6 - 10","#183013",3,6,"2028"
11,100,65,2028-06-06,1905,9,11,12,"VAN","Vancouver Vandals","away",1,0,"Western Division","PBE",5,12,-7,"5 - 12",5,100,83,139,6889,10000,17,0.40789863224584,7,10,"7 - 10","#183013",3,6,"2028"
11,100,67,2028-06-07,1905,9,7,10,"VAN","Vancouver Vandals","away",0,1,"Western Division","PBE",5,13,-8,"5 - 13",8,108,90,149,8100,11664,18,0.409836065573771,7,11,"7 - 11","#183013",3,6,"2028"
11,100,70,2028-06-09,1905,9,2,6,"VAN","Vancouver Vandals","home",1,0,"Western Division","PBE",6,13,-7,"6 - 13",0,108,92,155,8464,11664,19,0.420508744038156,8,11,"8 - 11","#183013",3,6,"2028"
11,100,74,2028-06-10,1905,9,2,2,"VAN","Vancouver Vandals","home",1,0,"Western Division","PBE",7,13,-6,"7 - 13",1,109,94,157,8836,11881,20,0.426509629772651,9,11,"9 - 11","#183013",3,6,"2028"
11,100,78,2028-06-11,1905,9,9,9,"VAN","Vancouver Vandals","home",1,0,"Western Division","PBE",8,13,-5,"8 - 13",1,110,103,166,10609,12100,21,0.467171605971201,10,11,"10 - 11","#183013",3,6,"2028"
11,100,82,2028-06-14,1905,9,3,3,"VAN","Vancouver Vandals","home",1,0,"Western Division","PBE",9,13,-4,"9 - 13",1,111,106,169,11236,12321,22,0.476970751793522,10,12,"10 - 12","#183013",3,6,"2028"
11,100,85,2028-06-15,1905,9,8,15,"VAN","Vancouver Vandals","home",1,0,"Western Division","PBE",10,13,-3,"10 - 13",6,117,114,184,12996,13689,23,0.487015177065767,11,12,"11 - 12","#183013",3,6,"2028"
11,100,89,2028-06-16,1905,9,1,4,"VAN","Vancouver Vandals","home",0,1,"Western Division","PBE",10,14,-4,"10 - 14",9,126,115,188,13225,15876,24,0.45445173705371,11,13,"11 - 13","#183013",3,6,"2028"
11,100,93,2028-06-17,1905,9,0,6,"VAN","Vancouver Vandals","home",0,1,"Western Division","PBE",10,15,-5,"10 - 15",9,135,115,194,13225,18225,25,0.420508744038156,11,14,"11 - 14","#183013",3,6,"2028"
11,100,98,2028-06-19,1905,9,1,5,"VAN","Vancouver Vandals","away",0,1,"Western Division","PBE",10,16,-6,"10 - 16",2,137,116,199,13456,18769,26,0.417564003103181,11,15,"11 - 15","#183013",3,6,"2028"
11,100,102,2028-06-20,1905,9,0,3,"VAN","Vancouver Vandals","away",0,1,"Western Division","PBE",10,17,-7,"10 - 17",3,140,116,202,13456,19600,27,0.407066795740561,11,16,"11 - 16","#183013",3,6,"2028"
11,100,106,2028-06-21,1905,11,5,8,"VAN","Vancouver Vandals","away",0,1,"Western Division","PBE",10,18,-8,"10 - 18",8,148,121,210,14641,21904,28,0.400629361061705,11,17,"11 - 17","#183013",3,6,"2028"
11,100,111,2028-06-24,1905,9,2,4,"VAN","Vancouver Vandals","home",1,0,"Western Division","PBE",11,18,-7,"11 - 18",0,148,123,214,15129,21904,29,0.408527529500716,12,17,"12 - 17","#183013",3,6,"2028"
11,100,115,2028-06-25,1905,10,3,8,"VAN","Vancouver Vandals","home",1,0,"Western Division","PBE",12,18,-6,"12 - 18",2,150,126,222,15876,22500,30,0.413696060037523,12,18,"12 - 18","#183013",3,6,"2028"
11,100,119,2028-06-26,1905,9,1,3,"VAN","Vancouver Vandals","home",1,0,"Western Division","PBE",13,18,-5,"13 - 18",0,150,127,225,16129,22500,31,0.417536048046804,13,18,"13 - 18","#183013",3,6,"2028"
11,100,123,2028-06-29,1905,9,2,9,"VAN","Vancouver Vandals","home",1,0,"Western Division","PBE",14,18,-4,"14 - 18",1,151,129,234,16641,22801,32,0.421910653617971,14,18,"14 - 18","#183013",3,6,"2028"
11,100,126,2028-06-30,1905,9,5,6,"VAN","Vancouver Vandals","home",1,0,"Western Division","PBE",15,18,-3,"15 - 18",3,154,134,240,17956,23716,33,0.430888846227683,14,19,"14 - 19","#183013",3,6,"2028"
11,100,130,2028-07-01,1905,9,5,9,"VAN","Vancouver Vandals","home",1,0,"Western Division","PBE",16,18,-2,"16 - 18",2,156,139,249,19321,24336,34,0.442563620954257,15,19,"15 - 19","#183013",3,6,"2028"
11,100,138,2028-07-04,1905,9,9,13,"VAN","Vancouver Vandals","home",1,0,"Western Division","PBE",17,18,-1,"17 - 18",3,159,148,262,21904,25281,35,0.464215322666101,16,19,"16 - 19","#183013",3,6,"2028"
11,100,142,2028-07-05,1905,9,7,7,"VAN","Vancouver Vandals","home",0,1,"Western Division","PBE",17,19,-2,"17 - 19",12,171,155,269,24025,29241,36,0.451038185709458,16,20,"16 - 20","#183013",3,6,"2028"
11,100,146,2028-07-06,1905,9,1,2,"VAN","Vancouver Vandals","home",1,0,"Western Division","PBE",18,19,-1,"18 - 19",0,171,156,271,24336,29241,37,0.454224760624895,17,20,"17 - 20","#183013",3,6,"2028"
11,100,148,2028-07-09,1905,9,9,14,"VAN","Vancouver Vandals","away",1,0,"Western Division","PBE",19,19,0,"19 - 19",1,172,165,285,27225,29584,38,0.479237444771075,18,20,"18 - 20","#183013",3,6,"2028"
11,100,152,2028-07-10,1905,9,6,11,"VAN","Vancouver Vandals","away",0,1,"Western Division","PBE",19,20,-1,"19 - 20",7,179,171,296,29241,32041,39,0.477154792598153,19,20,"19 - 20","#183013",3,6,"2028"
11,100,156,2028-07-11,1905,9,2,7,"VAN","Vancouver Vandals","home",0,1,"Western Division","PBE",19,21,-2,"19 - 21",4,183,173,303,29929,33489,40,0.4719322589801,19,21,"19 - 21","#183013",3,6,"2028"
11,100,160,2028-07-12,1905,9,5,10,"VAN","Vancouver Vandals","home",0,1,"Western Division","PBE",19,22,-3,"19 - 22",6,189,178,313,31684,35721,41,0.470054150285587,19,22,"19 - 22","#183013",3,6,"2028"
11,100,163,2028-07-14,1905,9,1,8,"VAN","Vancouver Vandals","away",0,1,"Western Division","PBE",19,23,-4,"19 - 23",9,198,179,321,32041,39204,42,0.449729805600393,19,23,"19 - 23","#183013",3,6,"2028"
11,100,166,2028-07-15,1905,9,2,8,"VAN","Vancouver Vandals","away",1,0,"Western Division","PBE",20,23,-3,"20 - 23",1,199,181,329,32761,39601,43,0.452737624720157,19,24,"19 - 24","#183013",3,6,"2028"
11,100,170,2028-07-16,1905,9,1,6,"VAN","Vancouver Vandals","away",0,1,"Western Division","PBE",20,24,-4,"20 - 24",5,204,182,335,33124,41616,44,0.443189724377843,20,24,"20 - 24","#183013",3,6,"2028"
11,100,177,2028-07-19,1905,9,11,11,"VAN","Vancouver Vandals","away",1,0,"Western Division","PBE",21,24,-3,"21 - 24",4,208,193,346,37249,43264,45,0.462645783910673,21,24,"21 - 24","#183013",3,6,"2028"
11,100,181,2028-07-20,1905,9,7,11,"VAN","Vancouver Vandals","away",1,0,"Western Division","PBE",22,24,-2,"22 - 24",4,212,200,357,40000,44944,46,0.470898474288943,22,24,"22 - 24","#183013",3,6,"2028"
11,100,185,2028-07-21,1905,9,2,7,"VAN","Vancouver Vandals","away",0,1,"Western Division","PBE",22,25,-3,"22 - 25",4,216,202,364,40804,46656,47,0.466544706151383,22,25,"22 - 25","#183013",3,6,"2028"
11,100,191,2028-07-24,1905,9,7,13,"VAN","Vancouver Vandals","away",1,0,"Western Division","PBE",23,25,-2,"23 - 25",0,216,209,377,43681,46656,48,0.483533878698651,23,25,"23 - 25","#183013",3,6,"2028"
11,100,194,2028-07-25,1905,9,11,16,"VAN","Vancouver Vandals","away",1,0,"Western Division","PBE",24,25,-1,"24 - 25",0,216,220,393,48400,46656,49,0.509173539808113,25,24,"25 - 24","#183013",3,6,"2028"
11,100,198,2028-07-26,1905,9,3,8,"VAN","Vancouver Vandals","away",0,1,"Western Division","PBE",24,26,-2,"24 - 26",5,221,223,401,49729,48841,50,0.504504413107436,25,25,"25 - 25","#183013",3,6,"2028"
11,100,204,2028-08-11,1905,9,4,7,"VAN","Vancouver Vandals","home",1,0,"Western Division","PBE",25,26,-1,"25 - 26",0,221,227,408,51529,48841,51,0.513390455315333,26,25,"26 - 25","#183013",3,6,"2028"
11,100,208,2028-08-12,1905,9,13,16,"VAN","Vancouver Vandals","home",1,0,"Western Division","PBE",26,26,0,"26 - 26",6,227,240,424,57600,51529,52,0.527815704349898,27,25,"27 - 25","#183013",3,6,"2028"
11,100,212,2028-08-13,1905,9,0,6,"VAN","Vancouver Vandals","home",0,1,"Western Division","PBE",26,27,-1,"26 - 27",6,233,240,430,57600,54289,53,0.514795913807434,27,26,"27 - 26","#183013",3,6,"2028"
11,100,219,2028-08-16,1905,20,6,14,"VAN","Vancouver Vandals","home",1,0,"Western Division","PBE",27,27,0,"27 - 27",5,238,246,444,60516,56644,54,0.516524411061796,28,26,"28 - 26","#183013",3,6,"2028"
11,100,222,2028-08-17,1905,9,10,12,"VAN","Vancouver Vandals","home",1,0,"Western Division","PBE",28,27,1,"28 - 27",5,243,256,456,65536,59049,55,0.526034434321949,29,26,"29 - 26","#183013",3,6,"2028"
11,100,226,2028-08-18,1905,9,3,9,"VAN","Vancouver Vandals","home",0,1,"Western Division","PBE",28,28,0,"28 - 28",5,248,259,465,67081,61504,56,0.521686044250885,29,27,"29 - 27","#183013",3,6,"2028"
16,101,302,2028-05-16,1905,9,3,6,"ANC","Anchorage Wheelers","home",1,0,"West Division","MiLPBE",1,0,1,"1 - 0",0,0,3,6,9,0,1,1,1,0,"1 - 0","#007EF3",1,2,"2028"
16,101,304,2028-05-17,1905,9,5,10,"ANC","Anchorage Wheelers","home",1,0,"West Division","MiLPBE",2,0,2,"2 - 0",3,3,8,16,64,9,2,0.876712328767123,2,0,"2 - 0","#007EF3",1,2,"2028"
16,101,306,2028-05-18,1905,13,5,15,"ANC","Anchorage Wheelers","home",1,0,"West Division","MiLPBE",3,0,3,"3 - 0",4,7,13,31,169,49,3,0.775229357798165,2,1,"2 - 1","#007EF3",1,2,"2028"
16,101,308,2028-05-19,1905,9,3,11,"ANC","Anchorage Wheelers","home",0,1,"West Division","MiLPBE",3,1,2,"3 - 1",14,21,16,42,256,441,4,0.367288378766141,1,3,"1 - 3","#007EF3",1,2,"2028"
16,101,311,2028-05-22,1905,9,12,15,"ANC","Anchorage Wheelers","home",1,0,"West Division","MiLPBE",4,1,3,"4 - 1",7,28,28,57,784,784,5,0.5,2,3,"2 - 3","#007EF3",1,2,"2028"
16,101,313,2028-05-23,1905,9,9,9,"ANC","Anchorage Wheelers","home",1,0,"West Division","MiLPBE",5,1,4,"5 - 1",2,30,37,66,1369,900,6,0.603349493168797,4,2,"4 - 2","#007EF3",1,2,"2028"
16,101,315,2028-05-24,1905,9,2,9,"ANC","Anchorage Wheelers","home",1,0,"West Division","MiLPBE",6,1,5,"6 - 1",0,30,39,75,1521,900,7,0.628252788104089,4,3,"4 - 3","#007EF3",1,2,"2028"
16,101,317,2028-05-26,1905,9,4,11,"ANC","Anchorage Wheelers","away",0,1,"West Division","MiLPBE",6,2,4,"6 - 2",14,44,43,86,1849,1936,8,0.488507265521797,4,4,"4 - 4","#007EF3",1,2,"2028"
16,101,318,2028-05-27,1905,9,6,13,"ANC","Anchorage Wheelers","away",1,0,"West Division","MiLPBE",7,2,5,"7 - 2",5,49,49,99,2401,2401,9,0.5,4,5,"4 - 5","#007EF3",1,2,"2028"
16,101,320,2028-05-28,1905,10,5,13,"ANC","Anchorage Wheelers","away",1,0,"West Division","MiLPBE",8,2,6,"8 - 2",4,53,54,112,2916,2809,10,0.509344978165939,5,5,"5 - 5","#007EF3",1,2,"2028"
16,101,323,2028-05-31,1905,9,3,8,"ANC","Anchorage Wheelers","away",0,1,"West Division","MiLPBE",8,3,5,"8 - 3",4,57,57,120,3249,3249,11,0.5,6,5,"6 - 5","#007EF3",1,2,"2028"
16,101,325,2028-06-01,1905,9,10,9,"ANC","Anchorage Wheelers","away",1,0,"West Division","MiLPBE",9,3,6,"9 - 3",6,63,67,129,4489,3969,12,0.530740127689761,6,6,"6 - 6","#007EF3",1,2,"2028"
16,101,327,2028-06-02,1905,9,1,8,"ANC","Anchorage Wheelers","away",0,1,"West Division","MiLPBE",9,4,5,"9 - 4",4,67,68,137,4624,4489,13,0.5074070009876,7,6,"7 - 6","#007EF3",1,2,"2028"
16,101,329,2028-06-03,1905,11,4,10,"ANC","Anchorage Wheelers","away",1,0,"West Division","MiLPBE",10,4,6,"10 - 4",3,70,72,147,5184,4900,14,0.514081713605712,7,7,"7 - 7","#007EF3",1,2,"2028"
16,101,331,2028-06-05,1905,9,0,2,"ANC","Anchorage Wheelers","away",0,1,"West Division","MiLPBE",10,5,5,"10 - 5",5,75,72,149,5184,5625,15,0.479600333055787,7,8,"7 - 8","#007EF3",1,2,"2028"
16,101,333,2028-06-06,1905,9,5,10,"ANC","Anchorage Wheelers","away",0,1,"West Division","MiLPBE",10,6,4,"10 - 6",7,82,77,159,5929,6724,16,0.468584525408994,7,9,"7 - 9","#007EF3",1,2,"2028"
16,101,335,2028-06-07,1905,9,11,13,"ANC","Anchorage Wheelers","away",1,0,"West Division","MiLPBE",11,6,5,"11 - 6",6,88,88,172,7744,7744,17,0.5,8,9,"8 - 9","#007EF3",1,2,"2028"
16,101,337,2028-06-08,1905,9,4,10,"ANC","Anchorage Wheelers","away",1,0,"West Division","MiLPBE",12,6,6,"12 - 6",3,91,92,182,8464,8281,18,0.505464317706778,9,9,"9 - 9","#007EF3",1,2,"2028"
16,101,339,2028-06-11,1905,9,5,11,"ANC","Anchorage Wheelers","home",1,0,"West Division","MiLPBE",13,6,7,"13 - 6",4,95,97,193,9409,9025,19,0.510415536508625,10,9,"10 - 9","#007EF3",1,2,"2028"
16,101,341,2028-06-12,1905,9,5,8,"ANC","Anchorage Wheelers","home",1,0,"West Division","MiLPBE",14,6,8,"14 - 6",4,99,102,201,10404,9801,20,0.514922048997773,10,10,"10 - 10","#007EF3",1,2,"2028"
16,101,343,2028-06-13,1905,9,1,2,"ANC","Anchorage Wheelers","home",0,1,"West Division","MiLPBE",14,7,7,"14 - 7",11,110,103,203,10609,12100,21,0.467171605971201,10,11,"10 - 11","#007EF3",1,2,"2028"
16,101,344,2028-06-16,1905,9,1,3,"ANC","Anchorage Wheelers","home",0,1,"West Division","MiLPBE",14,8,6,"14 - 8",9,119,104,206,10816,14161,22,0.433038395323698,10,12,"10 - 12","#007EF3",1,2,"2028"
16,101,346,2028-06-17,1905,9,7,13,"ANC","Anchorage Wheelers","home",1,0,"West Division","MiLPBE",15,8,7,"15 - 8",1,120,111,219,12321,14400,23,0.461098012798922,11,12,"11 - 12","#007EF3",1,2,"2028"
16,101,348,2028-06-18,1905,9,7,11,"ANC","Anchorage Wheelers","home",0,1,"West Division","MiLPBE",15,9,6,"15 - 9",12,132,118,230,13924,17424,24,0.44417506698992,11,13,"11 - 13","#007EF3",1,2,"2028"
16,101,350,2028-06-20,1905,11,3,11,"ANC","Anchorage Wheelers","away",1,0,"West Division","MiLPBE",16,9,7,"16 - 9",2,134,121,241,14641,17956,25,0.449151762432126,11,14,"11 - 14","#007EF3",1,2,"2028"
16,101,352,2028-06-21,1905,9,3,8,"ANC","Anchorage Wheelers","away",0,1,"West Division","MiLPBE",16,10,6,"16 - 10",7,141,124,249,15376,19881,26,0.436111977763281,11,15,"11 - 15","#007EF3",1,2,"2028"
16,101,354,2028-06-22,1905,9,9,12,"ANC","Anchorage Wheelers","away",1,0,"West Division","MiLPBE",17,10,7,"17 - 10",2,143,133,261,17689,20449,27,0.463815616969951,13,14,"13 - 14","#007EF3",1,2,"2028"
16,101,356,2028-06-23,1905,9,4,8,"ANC","Anchorage Wheelers","away",1,0,"West Division","MiLPBE",18,10,8,"18 - 10",1,144,137,269,18769,20736,28,0.475104417162384,13,15,"13 - 15","#007EF3",1,2,"2028"
16,101,358,2028-06-26,1905,9,2,8,"ANC","Anchorage Wheelers","away",0,1,"West Division","MiLPBE",18,11,7,"18 - 11",6,150,139,277,19321,22500,29,0.461992778747519,13,16,"13 - 16","#007EF3",1,2,"2028"
16,101,360,2028-06-27,1905,9,5,9,"ANC","Anchorage Wheelers","away",1,0,"West Division","MiLPBE",19,11,8,"19 - 11",4,154,144,286,20736,23716,30,0.466480698281292,14,16,"14 - 16","#007EF3",1,2,"2028"
16,101,362,2028-06-28,1905,9,8,15,"ANC","Anchorage Wheelers","away",1,0,"West Division","MiLPBE",20,11,9,"20 - 11",2,156,152,301,23104,24336,31,0.487015177065767,15,16,"15 - 16","#007EF3",1,2,"2028"
16,101,363,2028-06-30,1905,9,10,13,"ANC","Anchorage Wheelers","home",1,0,"West Division","MiLPBE",21,11,10,"21 - 11",2,158,162,314,26244,24964,32,0.512498047180128,16,16,"16 - 16","#007EF3",1,2,"2028"
16,101,364,2028-07-01,1905,9,2,12,"ANC","Anchorage Wheelers","home",1,0,"West Division","MiLPBE",22,11,11,"22 - 11",1,159,164,326,26896,25281,33,0.51547616766008,17,16,"17 - 16","#007EF3",1,2,"2028"
16,101,366,2028-07-02,1905,9,9,13,"ANC","Anchorage Wheelers","home",1,0,"West Division","MiLPBE",23,11,12,"23 - 11",4,163,173,339,29929,26569,34,0.529735565860738,18,16,"18 - 16","#007EF3",1,2,"2028"
16,101,368,2028-07-03,1905,9,1,2,"ANC","Anchorage Wheelers","home",0,1,"West Division","MiLPBE",23,12,11,"23 - 12",7,170,174,341,30276,28900,35,0.511626335000676,18,17,"18 - 17","#007EF3",1,2,"2028"
16,101,370,2028-07-05,1905,9,1,7,"ANC","Anchorage Wheelers","home",0,1,"West Division","MiLPBE",23,13,10,"23 - 13",9,179,175,348,30625,32041,36,0.488702007468165,18,18,"18 - 18","#007EF3",1,2,"2028"
16,101,371,2028-07-06,1905,9,9,13,"ANC","Anchorage Wheelers","home",1,0,"West Division","MiLPBE",24,13,11,"24 - 13",4,183,184,361,33856,33489,37,0.502724775410201,19,18,"19 - 18","#007EF3",1,2,"2028"
16,101,373,2028-07-07,1905,9,5,5,"ANC","Anchorage Wheelers","home",1,0,"West Division","MiLPBE",25,13,12,"25 - 13",3,186,189,366,35721,34596,38,0.507999488032766,19,19,"19 - 19","#007EF3",1,2,"2028"
16,101,375,2028-07-08,1905,9,6,6,"ANC","Anchorage Wheelers","home",0,1,"West Division","MiLPBE",25,14,11,"25 - 14",9,195,195,372,38025,38025,39,0.5,20,19,"20 - 19","#007EF3",1,2,"2028"
16,101,379,2028-07-11,1905,9,2,7,"ANC","Anchorage Wheelers","away",0,1,"West Division","MiLPBE",25,15,10,"25 - 15",3,198,197,379,38809,39204,40,0.497468370656173,20,20,"20 - 20","#007EF3",1,2,"2028"
16,101,381,2028-07-12,1905,9,2,6,"ANC","Anchorage Wheelers","away",0,1,"West Division","MiLPBE",25,16,9,"25 - 16",6,204,199,385,39601,41616,41,0.487594961645961,20,21,"20 - 21","#007EF3",1,2,"2028"
16,101,509,2028-07-13,1905,9,6,9,"ANC","Anchorage Wheelers","away",1,0,"West Division","MiLPBE",26,16,10,"26 - 16",5,209,205,394,42025,43681,42,0.490339066109724,21,21,"21 - 21","#007EF3",1,2,"2028"
16,101,511,2028-07-17,1905,9,0,2,"ANC","Anchorage Wheelers","home",0,1,"West Division","MiLPBE",26,17,9,"26 - 17",2,211,205,396,42025,44521,43,0.485579922815613,21,22,"21 - 22","#007EF3",1,2,"2028"
16,101,513,2028-07-18,1905,13,2,10,"ANC","Anchorage Wheelers","home",1,0,"West Division","MiLPBE",27,17,10,"27 - 17",1,212,207,406,42849,44944,44,0.488068524825442,21,23,"21 - 23","#007EF3",1,2,"2028"
16,101,515,2028-07-19,1905,9,8,11,"ANC","Anchorage Wheelers","home",1,0,"West Division","MiLPBE",28,17,11,"28 - 17",1,213,215,417,46225,45369,45,0.504672795161255,23,22,"23 - 22","#007EF3",1,2,"2028"
16,101,518,2028-07-22,1905,9,1,3,"ANC","Anchorage Wheelers","home",0,1,"West Division","MiLPBE",28,18,10,"28 - 18",5,218,216,420,46656,47524,46,0.495391802930559,23,23,"23 - 23","#007EF3",1,2,"2028"
16,101,520,2028-07-23,1905,9,4,11,"ANC","Anchorage Wheelers","home",0,1,"West Division","MiLPBE",28,19,9,"28 - 19",10,228,220,431,48400,51984,47,0.482148549569653,23,24,"23 - 24","#007EF3",1,2,"2028"
16,101,522,2028-07-24,1905,11,5,9,"ANC","Anchorage Wheelers","home",1,0,"West Division","MiLPBE",29,19,10,"29 - 19",4,232,225,440,50625,53824,48,0.484686306235579,23,25,"23 - 25","#007EF3",1,2,"2028"
16,101,524,2028-07-25,1905,9,2,10,"ANC","Anchorage Wheelers","home",0,1,"West Division","MiLPBE",29,20,9,"29 - 20",6,238,227,450,51529,56644,49,0.476357316520758,23,26,"23 - 26","#007EF3",1,2,"2028"
16,101,525,2028-08-13,1905,9,8,10,"ANC","Anchorage Wheelers","away",1,0,"West Division","MiLPBE",30,20,10,"30 - 20",1,239,235,460,55225,57121,50,0.491561782350952,25,25,"25 - 25","#007EF3",1,2,"2028"
16,101,527,2028-08-14,1905,9,3,7,"ANC","Anchorage Wheelers","away",0,1,"West Division","MiLPBE",30,21,9,"30 - 21",7,246,238,467,56644,60516,51,0.483475588938204,25,26,"25 - 26","#007EF3",1,2,"2028"
16,101,529,2028-08-15,1905,9,6,11,"ANC","Anchorage Wheelers","away",1,0,"West Division","MiLPBE",31,21,10,"31 - 21",2,248,244,478,59536,61504,52,0.491870456047588,26,26,"26 - 26","#007EF3",1,2,"2028"
16,101,531,2028-08-16,1905,9,1,3,"ANC","Anchorage Wheelers","away",0,1,"West Division","MiLPBE",31,22,9,"31 - 22",4,252,245,481,60025,63504,53,0.485918286394288,26,27,"26 - 27","#007EF3",1,2,"2028"
16,101,533,2028-08-18,1905,9,3,5,"ANC","Anchorage Wheelers","away",0,1,"West Division","MiLPBE",31,23,8,"31 - 23",15,267,248,486,61504,71289,54,0.463156943513589,25,29,"25 - 29","#007EF3",1,2,"2028"
16,101,535,2028-08-19,1905,10,7,18,"ANC","Anchorage Wheelers","away",1,0,"West Division","MiLPBE",32,23,9,"32 - 23",6,273,255,504,65025,74529,55,0.465948665032891,26,29,"26 - 29","#007EF3",1,2,"2028"
16,101,537,2028-08-20,1905,10,5,10,"ANC","Anchorage Wheelers","away",0,1,"West Division","MiLPBE",32,24,8,"32 - 24",6,279,260,514,67600,77841,56,0.464793283874561,26,30,"26 - 30","#007EF3",1,2,"2028"
17,101,303,2028-05-16,1905,9,7,11,"KGN","Kingston Mounties","away",1,0,"East Division","MiLPBE",1,0,1,"1 - 0",2,2,7,11,49,4,1,0.924528301886792,1,0,"1 - 0","#6C0000",1,1,"2028"
17,101,305,2028-05-17,1905,9,5,8,"KGN","Kingston Mounties","away",1,0,"East Division","MiLPBE",2,0,2,"2 - 0",2,4,12,19,144,16,2,0.9,2,0,"2 - 0","#6C0000",1,1,"2028"
17,101,307,2028-05-18,1905,9,3,10,"KGN","Kingston Mounties","away",0,1,"East Division","MiLPBE",2,1,1,"2 - 1",5,9,15,29,225,81,3,0.735294117647059,2,1,"2 - 1","#6C0000",1,1,"2028"
17,101,309,2028-05-19,1905,9,4,11,"KGN","Kingston Mounties","away",0,1,"East Division","MiLPBE",2,2,0,"2 - 2",6,15,19,40,361,225,4,0.616040955631399,2,2,"2 - 2","#6C0000",1,1,"2028"
17,101,311,2028-05-22,1905,9,7,16,"KGN","Kingston Mounties","away",0,1,"East Division","MiLPBE",2,3,-1,"2 - 3",12,27,26,56,676,729,5,0.481138790035587,2,3,"2 - 3","#6C0000",1,1,"2028"
17,101,313,2028-05-23,1905,9,2,4,"KGN","Kingston Mounties","away",0,1,"East Division","MiLPBE",2,4,-2,"2 - 4",9,36,28,60,784,1296,6,0.376923076923077,2,4,"2 - 4","#6C0000",1,1,"2028"
17,101,315,2028-05-24,1905,9,0,5,"KGN","Kingston Mounties","away",0,1,"East Division","MiLPBE",2,5,-3,"2 - 5",2,38,28,65,784,1444,7,0.351885098743268,2,5,"2 - 5","#6C0000",1,1,"2028"
17,101,319,2028-05-27,1905,9,8,13,"KGN","Kingston Mounties","home",1,0,"East Division","MiLPBE",3,5,-2,"3 - 5",6,44,36,78,1296,1936,8,0.400990099009901,3,5,"3 - 5","#6C0000",1,1,"2028"
17,101,321,2028-05-28,1905,9,2,13,"KGN","Kingston Mounties","home",0,1,"East Division","MiLPBE",3,6,-3,"3 - 6",4,48,38,91,1444,2304,9,0.385272145144077,3,6,"3 - 6","#6C0000",1,1,"2028"
17,101,322,2028-05-29,1905,9,6,14,"KGN","Kingston Mounties","home",1,0,"East Division","MiLPBE",4,6,-2,"4 - 6",1,49,44,105,1936,2401,10,0.446391514872031,4,6,"4 - 6","#6C0000",1,1,"2028"
17,101,324,2028-05-31,1905,9,4,10,"KGN","Kingston Mounties","home",1,0,"East Division","MiLPBE",5,6,-1,"5 - 6",2,51,48,115,2304,2601,11,0.469724770642202,5,6,"5 - 6","#6C0000",1,1,"2028"
17,101,326,2028-06-01,1905,9,3,7,"KGN","Kingston Mounties","home",1,0,"East Division","MiLPBE",6,6,0,"6 - 6",1,52,51,122,2601,2704,12,0.490292177191329,6,6,"6 - 6","#6C0000",1,1,"2028"
17,101,328,2028-06-02,1905,10,3,13,"KGN","Kingston Mounties","home",0,1,"East Division","MiLPBE",6,7,-1,"6 - 7",8,60,54,135,2916,3600,13,0.447513812154696,6,7,"6 - 7","#6C0000",1,1,"2028"
17,101,331,2028-06-05,1905,9,5,7,"KGN","Kingston Mounties","home",1,0,"East Division","MiLPBE",7,7,0,"7 - 7",0,60,59,142,3481,3600,14,0.491597232029374,7,7,"7 - 7","#6C0000",1,1,"2028"
17,101,333,2028-06-06,1905,9,7,9,"KGN","Kingston Mounties","home",1,0,"East Division","MiLPBE",8,7,1,"8 - 7",5,65,66,151,4356,4225,15,0.507633142990327,8,7,"8 - 7","#6C0000",1,1,"2028"
17,101,335,2028-06-07,1905,9,6,11,"KGN","Kingston Mounties","home",0,1,"East Division","MiLPBE",8,8,0,"8 - 8",11,76,72,162,5184,5776,16,0.472992700729927,8,8,"8 - 8","#6C0000",1,1,"2028"
17,101,337,2028-06-08,1905,9,3,12,"KGN","Kingston Mounties","home",0,1,"East Division","MiLPBE",8,9,-1,"8 - 9",4,80,75,174,5625,6400,17,0.467775467775468,8,9,"8 - 9","#6C0000",1,1,"2028"
17,101,338,2028-06-10,1905,9,1,7,"KGN","Kingston Mounties","away",1,0,"East Division","MiLPBE",9,9,0,"9 - 9",0,80,76,181,5776,6400,18,0.474375821287779,9,9,"9 - 9","#6C0000",1,1,"2028"
17,101,340,2028-06-11,1905,9,4,15,"KGN","Kingston Mounties","away",1,0,"East Division","MiLPBE",10,9,1,"10 - 9",3,83,80,196,6400,6889,19,0.481601324403642,9,10,"9 - 10","#6C0000",1,1,"2028"
17,101,342,2028-06-12,1905,9,9,16,"KGN","Kingston Mounties","away",1,0,"East Division","MiLPBE",11,9,2,"11 - 9",8,91,89,212,7921,8281,20,0.488890260461671,10,10,"10 - 10","#6C0000",1,1,"2028"
17,101,344,2028-06-16,1905,9,9,13,"KGN","Kingston Mounties","away",1,0,"East Division","MiLPBE",12,9,3,"12 - 9",1,92,98,225,9604,8464,21,0.531547487270312,11,10,"11 - 10","#6C0000",1,1,"2028"
17,101,346,2028-06-17,1905,9,1,4,"KGN","Kingston Mounties","away",0,1,"East Division","MiLPBE",12,10,2,"12 - 10",7,99,99,229,9801,9801,22,0.5,11,11,"11 - 11","#6C0000",1,1,"2028"
17,101,348,2028-06-18,1905,9,12,15,"KGN","Kingston Mounties","away",1,0,"East Division","MiLPBE",13,10,3,"13 - 10",7,106,111,244,12321,11236,23,0.523029248206478,12,11,"12 - 11","#6C0000",1,1,"2028"
17,101,350,2028-06-20,1905,11,2,8,"KGN","Kingston Mounties","home",0,1,"East Division","MiLPBE",13,11,2,"13 - 11",3,109,113,252,12769,11881,24,0.518012170385395,12,12,"12 - 12","#6C0000",1,1,"2028"
17,101,352,2028-06-21,1905,9,7,13,"KGN","Kingston Mounties","home",1,0,"East Division","MiLPBE",14,11,3,"14 - 11",3,112,120,265,14400,12544,25,0.534441805225653,13,12,"13 - 12","#6C0000",1,1,"2028"
17,101,354,2028-06-22,1905,9,2,8,"KGN","Kingston Mounties","home",0,1,"East Division","MiLPBE",14,12,2,"14 - 12",9,121,122,273,14884,14641,26,0.504115156646909,13,13,"13 - 13","#6C0000",1,1,"2028"
17,101,356,2028-06-23,1905,9,1,6,"KGN","Kingston Mounties","home",0,1,"East Division","MiLPBE",14,13,1,"14 - 13",4,125,123,279,15129,15625,27,0.49193600832412,13,14,"13 - 14","#6C0000",1,1,"2028"
17,101,357,2028-06-26,1905,9,5,9,"KGN","Kingston Mounties","away",0,1,"East Division","MiLPBE",14,14,0,"14 - 14",7,132,128,288,16384,17424,28,0.484619025082821,14,14,"14 - 14","#6C0000",1,1,"2028"
17,101,359,2028-06-27,1905,12,8,13,"KGN","Kingston Mounties","away",1,0,"East Division","MiLPBE",15,14,1,"15 - 14",4,136,136,301,18496,18496,29,0.5,14,15,"14 - 15","#6C0000",1,1,"2028"
17,101,361,2028-06-28,1905,9,9,14,"KGN","Kingston Mounties","away",1,0,"East Division","MiLPBE",16,14,2,"16 - 14",7,143,145,315,21025,20449,30,0.506944109562618,15,15,"15 - 15","#6C0000",1,1,"2028"
17,101,365,2028-07-01,1905,9,5,12,"KGN","Kingston Mounties","away",1,0,"East Division","MiLPBE",17,14,3,"17 - 14",2,145,150,327,22500,21025,31,0.516944284893739,16,15,"16 - 15","#6C0000",1,1,"2028"
17,101,367,2028-07-02,1905,14,4,11,"KGN","Kingston Mounties","away",0,1,"East Division","MiLPBE",17,15,2,"17 - 15",5,150,154,338,23716,22500,32,0.513155617102302,16,16,"16 - 16","#6C0000",1,1,"2028"
17,101,369,2028-07-03,1905,9,5,8,"KGN","Kingston Mounties","away",0,1,"East Division","MiLPBE",17,16,1,"17 - 16",8,158,159,346,25281,24964,33,0.503154542740571,17,16,"17 - 16","#6C0000",1,1,"2028"
17,101,372,2028-07-06,1905,9,6,11,"KGN","Kingston Mounties","home",1,0,"East Division","MiLPBE",18,16,2,"18 - 16",5,163,165,357,27225,26569,34,0.506097334275198,17,17,"17 - 17","#6C0000",1,1,"2028"
17,101,374,2028-07-07,1905,9,7,7,"KGN","Kingston Mounties","home",1,0,"East Division","MiLPBE",19,16,3,"19 - 16",2,165,172,364,29584,27225,35,0.520762555228925,18,17,"18 - 17","#6C0000",1,1,"2028"
17,101,376,2028-07-08,1905,9,7,13,"KGN","Kingston Mounties","home",1,0,"East Division","MiLPBE",20,16,4,"20 - 16",5,170,179,377,32041,28900,36,0.525770827521701,19,17,"19 - 17","#6C0000",1,1,"2028"
17,101,377,2028-07-09,1905,9,7,13,"KGN","Kingston Mounties","home",1,0,"East Division","MiLPBE",21,16,5,"21 - 16",6,176,186,390,34596,30976,37,0.527603245287623,20,17,"20 - 17","#6C0000",1,1,"2028"
17,101,379,2028-07-11,1905,9,3,7,"KGN","Kingston Mounties","home",1,0,"East Division","MiLPBE",22,16,6,"22 - 16",2,178,189,397,35721,31684,38,0.529945849714413,20,18,"20 - 18","#6C0000",1,1,"2028"
17,101,381,2028-07-12,1905,9,6,13,"KGN","Kingston Mounties","home",1,0,"East Division","MiLPBE",23,16,7,"23 - 16",2,180,195,410,38025,32400,39,0.539936102236422,21,18,"21 - 18","#6C0000",1,1,"2028"
17,101,509,2028-07-13,1905,9,5,11,"KGN","Kingston Mounties","home",0,1,"East Division","MiLPBE",23,17,6,"23 - 17",6,186,200,421,40000,34596,40,0.536221781328758,21,19,"21 - 19","#6C0000",1,1,"2028"
17,101,512,2028-07-17,1905,9,6,8,"KGN","Kingston Mounties","away",1,0,"East Division","MiLPBE",24,17,7,"24 - 17",2,188,206,429,42436,35344,41,0.5455901259964,22,19,"22 - 19","#6C0000",1,1,"2028"
17,101,514,2028-07-18,1905,9,9,11,"KGN","Kingston Mounties","away",1,0,"East Division","MiLPBE",25,17,8,"25 - 17",2,190,215,440,46225,36100,42,0.561494078348011,24,18,"24 - 18","#6C0000",1,1,"2028"
17,101,516,2028-07-19,1905,9,8,15,"KGN","Kingston Mounties","away",1,0,"East Division","MiLPBE",26,17,9,"26 - 17",3,193,223,455,49729,37249,43,0.571742279656925,25,18,"25 - 18","#6C0000",1,1,"2028"
17,101,517,2028-07-20,1905,9,7,13,"KGN","Kingston Mounties","away",1,0,"East Division","MiLPBE",27,17,10,"27 - 17",1,194,230,468,52900,37636,44,0.58429795882301,26,18,"26 - 18","#6C0000",1,1,"2028"
17,101,518,2028-07-22,1905,9,5,10,"KGN","Kingston Mounties","away",1,0,"East Division","MiLPBE",28,17,11,"28 - 17",1,195,235,478,55225,38025,45,0.592225201072386,27,18,"27 - 18","#6C0000",1,1,"2028"
17,101,520,2028-07-23,1905,9,10,13,"KGN","Kingston Mounties","away",1,0,"East Division","MiLPBE",29,17,12,"29 - 17",4,199,245,491,60025,39601,46,0.602503362576034,28,18,"28 - 18","#6C0000",1,1,"2028"
17,101,522,2028-07-24,1905,11,4,15,"KGN","Kingston Mounties","away",0,1,"East Division","MiLPBE",29,18,11,"29 - 18",5,204,249,506,62001,41616,47,0.598367063319726,28,19,"28 - 19","#6C0000",1,1,"2028"
17,101,524,2028-07-25,1905,9,6,10,"KGN","Kingston Mounties","away",1,0,"East Division","MiLPBE",30,18,12,"30 - 18",2,206,255,516,65025,42436,48,0.605103246759289,29,19,"29 - 19","#6C0000",1,1,"2028"
17,101,526,2028-08-13,1905,9,6,9,"KGN","Kingston Mounties","home",1,0,"East Division","MiLPBE",31,18,13,"31 - 18",5,211,261,525,68121,44521,49,0.604756662701301,30,19,"30 - 19","#6C0000",1,1,"2028"
17,101,528,2028-08-14,1905,9,2,8,"KGN","Kingston Mounties","home",1,0,"East Division","MiLPBE",32,18,14,"32 - 18",0,211,263,533,69169,44521,50,0.608400035183393,30,20,"30 - 20","#6C0000",1,1,"2028"
17,101,530,2028-08-15,1905,9,2,9,"KGN","Kingston Mounties","home",0,1,"East Division","MiLPBE",32,19,13,"32 - 19",7,218,265,542,70225,47524,51,0.596395723105929,30,21,"30 - 21","#6C0000",1,1,"2028"
17,101,533,2028-08-18,1905,9,15,15,"KGN","Kingston Mounties","home",1,0,"East Division","MiLPBE",33,19,14,"33 - 19",3,221,280,557,78400,48841,52,0.616153598289859,32,20,"32 - 20","#6C0000",1,1,"2028"
17,101,535,2028-08-19,1905,10,6,16,"KGN","Kingston Mounties","home",0,1,"East Division","MiLPBE",33,20,13,"33 - 20",7,228,286,573,81796,51984,53,0.611421737180445,32,21,"32 - 21","#6C0000",1,1,"2028"
17,101,537,2028-08-20,1905,10,6,15,"KGN","Kingston Mounties","home",1,0,"East Division","MiLPBE",34,20,14,"34 - 20",5,233,292,588,85264,54289,54,0.610979341182203,33,21,"33 - 21","#6C0000",1,1,"2028"
18,101,303,2028-05-16,1905,9,2,10,"SCSS","State College Swift Steeds ","home",0,1,"East Division","MiLPBE",0,1,-1,"0 - 1",7,7,2,10,4,49,1,0.0754716981132075,0,1,"0 - 1","#115376",2,3,"2028"
18,101,305,2028-05-17,1905,9,2,12,"SCSS","State College Swift Steeds ","home",0,1,"East Division","MiLPBE",0,2,-2,"0 - 2",5,12,4,22,16,144,2,0.1,0,2,"0 - 2","#115376",2,3,"2028"
18,101,307,2028-05-18,1905,9,5,14,"SCSS","State College Swift Steeds ","home",1,0,"East Division","MiLPBE",1,2,-1,"1 - 2",3,15,9,36,81,225,3,0.264705882352941,1,2,"1 - 2","#115376",2,3,"2028"
18,101,309,2028-05-19,1905,9,6,13,"SCSS","State College Swift Steeds ","home",1,0,"East Division","MiLPBE",2,2,0,"2 - 2",4,19,15,49,225,361,4,0.383959044368601,2,2,"2 - 2","#115376",2,3,"2028"
18,101,310,2028-05-21,1905,9,5,8,"SCSS","State College Swift Steeds ","home",0,1,"East Division","MiLPBE",2,3,-1,"2 - 3",19,38,20,57,400,1444,5,0.216919739696312,1,4,"1 - 4","#115376",2,3,"2028"
18,101,312,2028-05-22,1905,9,6,9,"SCSS","State College Swift Steeds ","home",0,1,"East Division","MiLPBE",2,4,-2,"2 - 4",7,45,26,66,676,2025,6,0.250277674935209,2,4,"2 - 4","#115376",2,3,"2028"
18,101,314,2028-05-23,1905,9,6,15,"SCSS","State College Swift Steeds ","home",1,0,"East Division","MiLPBE",3,4,-1,"3 - 4",5,50,32,81,1024,2500,7,0.290578887627696,2,5,"2 - 5","#115376",2,3,"2028"
18,101,316,2028-05-24,1905,9,8,16,"SCSS","State College Swift Steeds ","home",1,0,"East Division","MiLPBE",4,4,0,"4 - 4",6,56,40,97,1600,3136,8,0.337837837837838,3,5,"3 - 5","#115376",2,3,"2028"
18,101,319,2028-05-27,1905,9,6,16,"SCSS","State College Swift Steeds ","away",0,1,"East Division","MiLPBE",4,5,-1,"4 - 5",8,64,46,113,2116,4096,9,0.340631036703155,3,6,"3 - 6","#115376",2,3,"2028"
18,101,321,2028-05-28,1905,9,4,8,"SCSS","State College Swift Steeds ","away",1,0,"East Division","MiLPBE",5,5,0,"5 - 5",2,66,50,121,2500,4356,10,0.364644107351225,4,6,"4 - 6","#115376",2,3,"2028"
18,101,322,2028-05-29,1905,9,1,4,"SCSS","State College Swift Steeds ","away",0,1,"East Division","MiLPBE",5,6,-1,"5 - 6",6,72,51,125,2601,5184,11,0.334104046242775,4,7,"4 - 7","#115376",2,3,"2028"
18,101,323,2028-05-31,1905,9,4,9,"SCSS","State College Swift Steeds ","home",1,0,"East Division","MiLPBE",6,6,0,"6 - 6",3,75,55,134,3025,5625,12,0.34971098265896,4,8,"4 - 8","#115376",2,3,"2028"
18,101,325,2028-06-01,1905,9,6,11,"SCSS","State College Swift Steeds ","home",0,1,"East Division","MiLPBE",6,7,-1,"6 - 7",10,85,61,145,3721,7225,13,0.339941531152933,4,9,"4 - 9","#115376",2,3,"2028"
18,101,327,2028-06-02,1905,9,4,9,"SCSS","State College Swift Steeds ","home",1,0,"East Division","MiLPBE",7,7,0,"7 - 7",1,86,65,154,4225,7396,14,0.363565958179158,5,9,"5 - 9","#115376",2,3,"2028"
18,101,329,2028-06-03,1905,11,3,10,"SCSS","State College Swift Steeds ","home",0,1,"East Division","MiLPBE",7,8,-1,"7 - 8",4,90,68,164,4624,8100,15,0.363407733417164,5,10,"5 - 10","#115376",2,3,"2028"
18,101,330,2028-06-05,1905,9,1,5,"SCSS","State College Swift Steeds ","home",0,1,"East Division","MiLPBE",7,9,-2,"7 - 9",5,95,69,169,4761,9025,16,0.345350355433048,6,10,"6 - 10","#115376",2,3,"2028"
18,101,332,2028-06-06,1905,9,4,9,"SCSS","State College Swift Steeds ","home",1,0,"East Division","MiLPBE",8,9,-1,"8 - 9",2,97,73,178,5329,9409,17,0.361582304247523,6,11,"6 - 11","#115376",2,3,"2028"
18,101,334,2028-06-07,1905,9,3,8,"SCSS","State College Swift Steeds ","home",0,1,"East Division","MiLPBE",8,10,-2,"8 - 10",14,111,76,186,5776,12321,18,0.319168923025916,6,12,"6 - 12","#115376",2,3,"2028"
18,101,336,2028-06-08,1905,10,6,14,"SCSS","State College Swift Steeds ","home",0,1,"East Division","MiLPBE",8,11,-3,"8 - 11",7,118,82,200,6724,13924,19,0.325648973266176,6,13,"6 - 13","#115376",2,3,"2028"
18,101,339,2028-06-11,1905,9,4,12,"SCSS","State College Swift Steeds ","away",0,1,"East Division","MiLPBE",8,12,-4,"8 - 12",5,123,86,212,7396,15129,20,0.32834628190899,7,13,"7 - 13","#115376",2,3,"2028"
18,101,341,2028-06-12,1905,9,4,9,"SCSS","State College Swift Steeds ","away",0,1,"East Division","MiLPBE",8,13,-5,"8 - 13",5,128,90,221,8100,16384,21,0.33082829603006,7,14,"7 - 14","#115376",2,3,"2028"
18,101,343,2028-06-13,1905,9,11,19,"SCSS","State College Swift Steeds ","away",1,0,"East Division","MiLPBE",9,13,-4,"9 - 13",1,129,101,240,10201,16641,22,0.380038745249981,8,14,"8 - 14","#115376",2,3,"2028"
18,101,345,2028-06-16,1905,9,3,13,"SCSS","State College Swift Steeds ","away",1,0,"East Division","MiLPBE",10,13,-3,"10 - 13",1,130,104,253,10816,16900,23,0.390243902439024,9,14,"9 - 14","#115376",2,3,"2028"
18,101,347,2028-06-17,1905,9,4,8,"SCSS","State College Swift Steeds ","away",1,0,"East Division","MiLPBE",11,13,-2,"11 - 13",2,132,108,261,11664,17424,24,0.400990099009901,10,14,"10 - 14","#115376",2,3,"2028"
18,101,349,2028-06-18,1905,9,1,7,"SCSS","State College Swift Steeds ","away",0,1,"East Division","MiLPBE",11,14,-3,"11 - 14",3,135,109,268,11881,18225,25,0.394638942403508,10,15,"10 - 15","#115376",2,3,"2028"
18,101,351,2028-06-20,1905,9,3,6,"SCSS","State College Swift Steeds ","home",1,0,"East Division","MiLPBE",12,14,-2,"12 - 14",2,137,112,274,12544,18769,26,0.400600389614537,10,16,"10 - 16","#115376",2,3,"2028"
18,101,353,2028-06-21,1905,9,11,19,"SCSS","State College Swift Steeds ","home",1,0,"East Division","MiLPBE",13,14,-1,"13 - 14",8,145,123,293,15129,21025,27,0.418459921447143,11,16,"11 - 16","#115376",2,3,"2028"
18,101,355,2028-06-22,1905,9,3,13,"SCSS","State College Swift Steeds ","home",0,1,"East Division","MiLPBE",13,15,-2,"13 - 15",5,150,126,306,15876,22500,28,0.413696060037523,12,16,"12 - 16","#115376",2,3,"2028"
18,101,358,2028-06-26,1905,9,6,12,"SCSS","State College Swift Steeds ","home",1,0,"East Division","MiLPBE",14,15,-1,"14 - 15",2,152,132,318,17424,23104,29,0.42992499013028,12,17,"12 - 17","#115376",2,3,"2028"
18,101,360,2028-06-27,1905,9,4,12,"SCSS","State College Swift Steeds ","home",0,1,"East Division","MiLPBE",14,16,-2,"14 - 16",5,157,136,330,18496,24649,30,0.428693939042763,13,17,"13 - 17","#115376",2,3,"2028"
18,101,362,2028-06-28,1905,9,2,7,"SCSS","State College Swift Steeds ","home",0,1,"East Division","MiLPBE",14,17,-3,"14 - 17",8,165,138,337,19044,27225,31,0.411593075277183,13,18,"13 - 18","#115376",2,3,"2028"
18,101,365,2028-07-01,1905,9,2,12,"SCSS","State College Swift Steeds ","home",0,1,"East Division","MiLPBE",14,18,-4,"14 - 18",5,170,140,349,19600,28900,32,0.404123711340206,13,19,"13 - 19","#115376",2,3,"2028"
18,101,367,2028-07-02,1905,14,5,14,"SCSS","State College Swift Steeds ","home",1,0,"East Division","MiLPBE",15,18,-3,"15 - 18",4,174,145,363,21025,30276,33,0.409836065573771,14,19,"14 - 19","#115376",2,3,"2028"
18,101,369,2028-07-03,1905,9,8,11,"SCSS","State College Swift Steeds ","home",1,0,"East Division","MiLPBE",16,18,-2,"16 - 18",5,179,153,374,23409,32041,34,0.422164111812444,14,20,"14 - 20","#115376",2,3,"2028"
18,101,370,2028-07-05,1905,9,9,10,"SCSS","State College Swift Steeds ","away",1,0,"East Division","MiLPBE",17,18,-1,"17 - 18",1,180,162,384,26244,32400,35,0.447513812154696,16,19,"16 - 19","#115376",2,3,"2028"
18,101,371,2028-07-06,1905,9,4,10,"SCSS","State College Swift Steeds ","away",0,1,"East Division","MiLPBE",17,19,-2,"17 - 19",9,189,166,394,27556,35721,36,0.435482086698168,16,20,"16 - 20","#115376",2,3,"2028"
18,101,373,2028-07-07,1905,9,3,11,"SCSS","State College Swift Steeds ","away",0,1,"East Division","MiLPBE",17,20,-3,"17 - 20",5,194,169,405,28561,37636,37,0.431454597640376,16,21,"16 - 21","#115376",2,3,"2028"
18,101,375,2028-07-08,1905,9,9,12,"SCSS","State College Swift Steeds ","away",1,0,"East Division","MiLPBE",18,20,-2,"18 - 20",6,200,178,417,31684,40000,38,0.44199542436248,17,21,"17 - 21","#115376",2,3,"2028"
18,101,378,2028-07-11,1905,9,5,17,"SCSS","State College Swift Steeds ","away",1,0,"East Division","MiLPBE",19,20,-1,"19 - 20",2,202,183,434,33489,40804,39,0.450769251477259,18,21,"18 - 21","#115376",2,3,"2028"
18,101,380,2028-07-12,1905,9,0,7,"SCSS","State College Swift Steeds ","away",0,1,"East Division","MiLPBE",19,21,-2,"19 - 21",11,213,183,441,33489,45369,40,0.424674731796394,17,23,"17 - 23","#115376",2,3,"2028"
18,101,508,2028-07-13,1905,9,6,11,"SCSS","State College Swift Steeds ","away",0,1,"East Division","MiLPBE",19,22,-3,"19 - 22",10,223,189,452,35721,49729,41,0.418033937975424,17,24,"17 - 24","#115376",2,3,"2028"
18,101,510,2028-07-14,1905,9,6,10,"SCSS","State College Swift Steeds ","away",1,0,"East Division","MiLPBE",20,22,-2,"20 - 22",4,227,195,462,38025,51529,42,0.424604149451727,18,24,"18 - 24","#115376",2,3,"2028"
18,101,511,2028-07-17,1905,9,2,5,"SCSS","State College Swift Steeds ","away",1,0,"East Division","MiLPBE",21,22,-1,"21 - 22",0,227,197,467,38809,51529,43,0.429597732958445,18,25,"18 - 25","#115376",2,3,"2028"
18,101,513,2028-07-18,1905,13,1,8,"SCSS","State College Swift Steeds ","away",0,1,"East Division","MiLPBE",21,23,-2,"21 - 23",2,229,198,475,39204,52441,44,0.427781111899176,19,25,"19 - 25","#115376",2,3,"2028"
18,101,515,2028-07-19,1905,9,1,8,"SCSS","State College Swift Steeds ","away",0,1,"East Division","MiLPBE",21,24,-3,"21 - 24",8,237,199,483,39601,56169,45,0.413501096376736,19,26,"19 - 26","#115376",2,3,"2028"
18,101,519,2028-07-23,1905,10,7,9,"SCSS","State College Swift Steeds ","home",0,1,"East Division","MiLPBE",21,25,-4,"21 - 25",11,248,206,492,42436,61504,46,0.408274004233211,19,27,"19 - 27","#115376",2,3,"2028"
18,101,521,2028-07-24,1905,9,4,7,"SCSS","State College Swift Steeds ","home",0,1,"East Division","MiLPBE",21,26,-5,"21 - 26",6,254,210,499,44100,64516,47,0.406017529645724,19,28,"19 - 28","#115376",2,3,"2028"
18,101,523,2028-07-25,1905,9,4,9,"SCSS","State College Swift Steeds ","home",1,0,"East Division","MiLPBE",22,26,-4,"22 - 26",2,256,214,508,45796,65536,48,0.411346243667589,20,28,"20 - 28","#115376",2,3,"2028"
18,101,526,2028-08-13,1905,9,5,11,"SCSS","State College Swift Steeds ","away",0,1,"East Division","MiLPBE",22,27,-5,"22 - 27",6,262,219,519,47961,68644,49,0.411311693323614,20,29,"20 - 29","#115376",2,3,"2028"
18,101,528,2028-08-14,1905,9,0,3,"SCSS","State College Swift Steeds ","away",0,1,"East Division","MiLPBE",22,28,-6,"22 - 28",2,264,219,522,47961,69696,50,0.407634054922359,20,30,"20 - 30","#115376",2,3,"2028"
18,101,530,2028-08-15,1905,9,7,12,"SCSS","State College Swift Steeds ","away",1,0,"East Division","MiLPBE",23,28,-5,"23 - 28",2,266,226,534,51076,70756,51,0.419233042222076,21,30,"21 - 30","#115376",2,3,"2028"
18,101,532,2028-08-18,1905,9,5,11,"SCSS","State College Swift Steeds ","away",0,1,"East Division","MiLPBE",23,29,-6,"23 - 29",8,274,231,545,53361,75076,52,0.415464391102252,22,30,"22 - 30","#115376",2,3,"2028"
18,101,534,2028-08-19,1905,9,1,6,"SCSS","State College Swift Steeds ","away",0,1,"East Division","MiLPBE",23,30,-7,"23 - 30",5,279,232,551,53824,77841,53,0.408795048038583,22,31,"22 - 31","#115376",2,3,"2028"
18,101,536,2028-08-20,1905,9,2,7,"SCSS","State College Swift Steeds ","away",0,1,"East Division","MiLPBE",23,31,-8,"23 - 31",4,283,234,558,54756,80089,54,0.406066224183322,22,32,"22 - 32","#115376",2,3,"2028"
19,101,302,2028-05-16,1905,9,0,8,"ARM","Amarillo Armadillos","away",0,1,"West Division","MiLPBE",0,1,-1,"0 - 1",3,3,0,8,0,9,1,0,0,1,"0 - 1","#86572C",2,4,"2028"
19,101,304,2028-05-17,1905,9,3,11,"ARM","Amarillo Armadillos","away",0,1,"West Division","MiLPBE",0,2,-2,"0 - 2",5,8,3,19,9,64,2,0.123287671232877,0,2,"0 - 2","#86572C",2,4,"2028"
19,101,306,2028-05-18,1905,13,4,9,"ARM","Amarillo Armadillos","away",0,1,"West Division","MiLPBE",0,3,-3,"0 - 3",5,13,7,28,49,169,3,0.224770642201835,1,2,"1 - 2","#86572C",2,4,"2028"
19,101,308,2028-05-19,1905,9,14,16,"ARM","Amarillo Armadillos","away",1,0,"West Division","MiLPBE",1,3,-2,"1 - 3",3,16,21,44,441,256,4,0.632711621233859,3,1,"3 - 1","#86572C",2,4,"2028"
19,101,310,2028-05-21,1905,9,19,25,"ARM","Amarillo Armadillos","away",1,0,"West Division","MiLPBE",2,3,-1,"2 - 3",5,21,40,69,1600,441,5,0.783929446349829,4,1,"4 - 1","#86572C",2,4,"2028"
19,101,312,2028-05-22,1905,9,7,16,"ARM","Amarillo Armadillos","away",1,0,"West Division","MiLPBE",3,3,0,"3 - 3",6,27,47,85,2209,729,6,0.751872021783526,5,1,"5 - 1","#86572C",2,4,"2028"
19,101,314,2028-05-23,1905,9,5,15,"ARM","Amarillo Armadillos","away",0,1,"West Division","MiLPBE",3,4,-1,"3 - 4",6,33,52,100,2704,1089,7,0.712892169786449,5,2,"5 - 2","#86572C",2,4,"2028"
19,101,316,2028-05-24,1905,9,6,13,"ARM","Amarillo Armadillos","away",0,1,"West Division","MiLPBE",3,5,-2,"3 - 5",8,41,58,113,3364,1681,8,0.666798810703667,5,3,"5 - 3","#86572C",2,4,"2028"
19,101,317,2028-05-26,1905,9,14,16,"ARM","Amarillo Armadillos","home",1,0,"West Division","MiLPBE",4,5,-1,"4 - 5",4,45,72,129,5184,2025,9,0.719101123595506,6,3,"6 - 3","#86572C",2,4,"2028"
19,101,318,2028-05-27,1905,9,5,8,"ARM","Amarillo Armadillos","home",0,1,"West Division","MiLPBE",4,6,-2,"4 - 6",6,51,77,137,5929,2601,10,0.695076201641266,7,3,"7 - 3","#86572C",2,4,"2028"
19,101,320,2028-05-28,1905,10,4,8,"ARM","Amarillo Armadillos","home",0,1,"West Division","MiLPBE",4,7,-3,"4 - 7",5,56,81,145,6561,3136,11,0.676601010621842,7,4,"7 - 4","#86572C",2,4,"2028"
19,101,324,2028-05-31,1905,9,2,11,"ARM","Amarillo Armadillos","away",0,1,"West Division","MiLPBE",4,8,-4,"4 - 8",4,60,83,156,6889,3600,12,0.65678329678711,8,4,"8 - 4","#86572C",2,4,"2028"
19,101,326,2028-06-01,1905,9,1,11,"ARM","Amarillo Armadillos","away",0,1,"West Division","MiLPBE",4,9,-5,"4 - 9",3,63,84,167,7056,3969,13,0.64,8,5,"8 - 5","#86572C",2,4,"2028"
19,101,328,2028-06-02,1905,10,8,13,"ARM","Amarillo Armadillos","away",1,0,"West Division","MiLPBE",5,9,-4,"5 - 9",3,66,92,180,8464,4356,14,0.660218408736349,9,5,"9 - 5","#86572C",2,4,"2028"
19,101,330,2028-06-05,1905,9,5,11,"ARM","Amarillo Armadillos","away",1,0,"West Division","MiLPBE",6,9,-3,"6 - 9",1,67,97,191,9409,4489,15,0.677003885451144,10,5,"10 - 5","#86572C",2,4,"2028"
19,101,332,2028-06-06,1905,9,2,7,"ARM","Amarillo Armadillos","away",0,1,"West Division","MiLPBE",6,10,-4,"6 - 10",4,71,99,198,9801,5041,16,0.660355747203881,11,5,"11 - 5","#86572C",2,4,"2028"
19,101,334,2028-06-07,1905,9,14,18,"ARM","Amarillo Armadillos","away",1,0,"West Division","MiLPBE",7,10,-3,"7 - 10",3,74,113,216,12769,5476,17,0.699862976157851,12,5,"12 - 5","#86572C",2,4,"2028"
19,101,336,2028-06-08,1905,10,7,5,"ARM","Amarillo Armadillos","away",1,0,"West Division","MiLPBE",8,10,-2,"8 - 10",6,80,120,221,14400,6400,18,0.692307692307692,12,6,"12 - 6","#86572C",2,4,"2028"
19,101,338,2028-06-10,1905,9,0,7,"ARM","Amarillo Armadillos","home",0,1,"West Division","MiLPBE",8,11,-3,"8 - 11",1,81,120,228,14400,6561,19,0.68699012451696,13,6,"13 - 6","#86572C",2,4,"2028"
19,101,340,2028-06-11,1905,9,3,7,"ARM","Amarillo Armadillos","home",0,1,"West Division","MiLPBE",8,12,-4,"8 - 12",4,85,123,235,15129,7225,20,0.676791625659837,14,6,"14 - 6","#86572C",2,4,"2028"
19,101,342,2028-06-12,1905,9,8,13,"ARM","Amarillo Armadillos","home",0,1,"West Division","MiLPBE",8,13,-5,"8 - 13",9,94,131,248,17161,8836,21,0.660114628610994,14,7,"14 - 7","#86572C",2,4,"2028"
19,101,345,2028-06-16,1905,9,1,14,"ARM","Amarillo Armadillos","home",0,1,"West Division","MiLPBE",8,14,-6,"8 - 14",3,97,132,262,17424,9409,22,0.649349681362501,14,8,"14 - 8","#86572C",2,4,"2028"
19,101,347,2028-06-17,1905,9,2,4,"ARM","Amarillo Armadillos","home",0,1,"West Division","MiLPBE",8,15,-7,"8 - 15",4,101,134,266,17956,10201,23,0.637709983307881,15,8,"15 - 8","#86572C",2,4,"2028"
19,101,349,2028-06-18,1905,9,3,7,"ARM","Amarillo Armadillos","home",1,0,"West Division","MiLPBE",9,15,-6,"9 - 15",1,102,137,273,18769,10404,24,0.643368868474274,15,9,"15 - 9","#86572C",2,4,"2028"
19,101,351,2028-06-20,1905,9,2,12,"ARM","Amarillo Armadillos","away",0,1,"West Division","MiLPBE",9,16,-7,"9 - 16",3,105,139,285,19321,11025,25,0.636690173334212,16,9,"16 - 9","#86572C",2,4,"2028"
19,101,353,2028-06-21,1905,9,8,21,"ARM","Amarillo Armadillos","away",0,1,"West Division","MiLPBE",9,17,-8,"9 - 17",11,116,147,306,21609,13456,26,0.616255525452731,16,10,"16 - 10","#86572C",2,4,"2028"
19,101,355,2028-06-22,1905,9,5,12,"ARM","Amarillo Armadillos","away",1,0,"West Division","MiLPBE",10,17,-7,"10 - 17",3,119,152,318,23104,14161,27,0.619991949550517,17,10,"17 - 10","#86572C",2,4,"2028"
19,101,357,2028-06-26,1905,9,7,8,"ARM","Amarillo Armadillos","home",1,0,"West Division","MiLPBE",11,17,-6,"11 - 17",5,124,159,326,25281,15376,28,0.621811742135426,17,11,"17 - 11","#86572C",2,4,"2028"
19,101,359,2028-06-27,1905,12,4,16,"ARM","Amarillo Armadillos","home",0,1,"West Division","MiLPBE",11,18,-7,"11 - 18",8,132,163,342,26569,17424,29,0.603936989975678,18,11,"18 - 11","#86572C",2,4,"2028"
19,101,361,2028-06-28,1905,9,7,14,"ARM","Amarillo Armadillos","home",0,1,"West Division","MiLPBE",11,19,-8,"11 - 19",9,141,170,356,28900,19881,30,0.592443779340317,18,12,"18 - 12","#86572C",2,4,"2028"
19,101,363,2028-06-30,1905,9,2,10,"ARM","Amarillo Armadillos","away",0,1,"West Division","MiLPBE",11,20,-9,"11 - 20",10,151,172,366,29584,22801,31,0.564741815405173,18,13,"18 - 13","#86572C",2,4,"2028"
19,101,364,2028-07-01,1905,9,1,4,"ARM","Amarillo Armadillos","away",0,1,"West Division","MiLPBE",11,21,-10,"11 - 21",2,153,173,370,29929,23409,32,0.561119652030447,18,14,"18 - 14","#86572C",2,4,"2028"
19,101,366,2028-07-02,1905,9,4,10,"ARM","Amarillo Armadillos","away",0,1,"West Division","MiLPBE",11,22,-11,"11 - 22",9,162,177,380,31329,26244,33,0.544161325621385,18,15,"18 - 15","#86572C",2,4,"2028"
19,101,368,2028-07-03,1905,9,7,12,"ARM","Amarillo Armadillos","away",1,0,"West Division","MiLPBE",12,22,-10,"12 - 22",1,163,184,392,33856,26569,34,0.560297889946214,19,15,"19 - 15","#86572C",2,4,"2028"
19,101,372,2028-07-06,1905,9,5,9,"ARM","Amarillo Armadillos","away",0,1,"West Division","MiLPBE",12,23,-11,"12 - 23",6,169,189,401,35721,28561,35,0.555692106655051,19,16,"19 - 16","#86572C",2,4,"2028"
19,101,374,2028-07-07,1905,9,2,5,"ARM","Amarillo Armadillos","away",0,1,"West Division","MiLPBE",12,24,-12,"12 - 24",7,176,191,406,36481,30976,36,0.540803771291341,19,17,"19 - 17","#86572C",2,4,"2028"
19,101,376,2028-07-08,1905,9,5,14,"ARM","Amarillo Armadillos","away",0,1,"West Division","MiLPBE",12,25,-13,"12 - 25",7,183,196,420,38416,33489,37,0.534260482581184,20,17,"20 - 17","#86572C",2,4,"2028"
19,101,377,2028-07-09,1905,9,6,10,"ARM","Amarillo Armadillos","away",0,1,"West Division","MiLPBE",12,26,-14,"12 - 26",7,190,202,430,40804,36100,38,0.530583584729013,20,18,"20 - 18","#86572C",2,4,"2028"
19,101,378,2028-07-11,1905,9,2,7,"ARM","Amarillo Armadillos","home",0,1,"West Division","MiLPBE",12,27,-15,"12 - 27",5,195,204,437,41616,38025,39,0.522544920329981,20,19,"20 - 19","#86572C",2,4,"2028"
19,101,380,2028-07-12,1905,9,11,13,"ARM","Amarillo Armadillos","home",1,0,"West Division","MiLPBE",13,27,-14,"13 - 27",0,195,215,450,46225,38025,40,0.5486646884273,22,18,"22 - 18","#86572C",2,4,"2028"
19,101,508,2028-07-13,1905,9,10,12,"ARM","Amarillo Armadillos","home",1,0,"West Division","MiLPBE",14,27,-13,"14 - 27",6,201,225,462,50625,40401,41,0.556159778524817,23,18,"23 - 18","#86572C",2,4,"2028"
19,101,510,2028-07-14,1905,9,4,6,"ARM","Amarillo Armadillos","home",0,1,"West Division","MiLPBE",14,28,-14,"14 - 28",6,207,229,468,52441,42849,42,0.550330569839438,23,19,"23 - 19","#86572C",2,4,"2028"
19,101,512,2028-07-17,1905,9,2,8,"ARM","Amarillo Armadillos","home",0,1,"West Division","MiLPBE",14,29,-15,"14 - 29",6,213,231,476,53361,45369,43,0.540474020054695,23,20,"23 - 20","#86572C",2,4,"2028"
19,101,514,2028-07-18,1905,9,2,6,"ARM","Amarillo Armadillos","home",0,1,"West Division","MiLPBE",14,30,-16,"14 - 30",9,222,233,482,54289,49284,44,0.524161702374171,23,21,"23 - 21","#86572C",2,4,"2028"
19,101,516,2028-07-19,1905,9,3,7,"ARM","Amarillo Armadillos","home",0,1,"West Division","MiLPBE",14,31,-17,"14 - 31",8,230,236,489,55696,52900,45,0.512873402335261,23,22,"23 - 22","#86572C",2,4,"2028"
19,101,517,2028-07-20,1905,9,1,5,"ARM","Amarillo Armadillos","home",0,1,"West Division","MiLPBE",14,32,-18,"14 - 32",7,237,237,494,56169,56169,46,0.5,23,23,"23 - 23","#86572C",2,4,"2028"
19,101,519,2028-07-23,1905,10,11,13,"ARM","Amarillo Armadillos","away",1,0,"West Division","MiLPBE",15,32,-17,"15 - 32",7,244,248,507,61504,59536,47,0.508129543952412,24,23,"24 - 23","#86572C",2,4,"2028"
19,101,521,2028-07-24,1905,9,6,13,"ARM","Amarillo Armadillos","away",1,0,"West Division","MiLPBE",16,32,-16,"16 - 32",4,248,254,520,64516,61504,48,0.511950484050151,25,23,"25 - 23","#86572C",2,4,"2028"
19,101,523,2028-07-25,1905,9,2,7,"ARM","Amarillo Armadillos","away",0,1,"West Division","MiLPBE",16,33,-17,"16 - 33",4,252,256,527,65536,63504,49,0.507873527588345,25,24,"25 - 24","#86572C",2,4,"2028"
19,101,525,2028-08-13,1905,9,1,14,"ARM","Amarillo Armadillos","home",0,1,"West Division","MiLPBE",16,34,-18,"16 - 34",8,260,257,541,66049,67600,50,0.494197487448466,25,25,"25 - 25","#86572C",2,4,"2028"
19,101,527,2028-08-14,1905,9,7,11,"ARM","Amarillo Armadillos","home",1,0,"West Division","MiLPBE",17,34,-17,"17 - 34",3,263,264,552,69696,69169,51,0.501897526374536,26,25,"26 - 25","#86572C",2,4,"2028"
19,101,529,2028-08-15,1905,9,2,6,"ARM","Amarillo Armadillos","home",0,1,"West Division","MiLPBE",17,35,-18,"17 - 35",6,269,266,558,70756,72361,52,0.494392699679283,26,26,"26 - 26","#86572C",2,4,"2028"
19,101,531,2028-08-16,1905,9,4,9,"ARM","Amarillo Armadillos","home",1,0,"West Division","MiLPBE",18,35,-17,"18 - 35",1,270,270,567,72900,72900,53,0.5,26,27,"26 - 27","#86572C",2,4,"2028"
19,101,532,2028-08-18,1905,9,8,8,"ARM","Amarillo Armadillos","home",1,0,"West Division","MiLPBE",19,35,-16,"19 - 35",5,275,278,575,77284,75625,54,0.505424795139593,27,27,"27 - 27","#86572C",2,4,"2028"
19,101,534,2028-08-19,1905,9,5,13,"ARM","Amarillo Armadillos","home",1,0,"West Division","MiLPBE",20,35,-15,"20 - 35",1,276,283,588,80089,76176,55,0.512520398041788,28,27,"28 - 27","#86572C",2,4,"2028"
19,101,536,2028-08-20,1905,9,4,11,"ARM","Amarillo Armadillos","home",1,0,"West Division","MiLPBE",21,35,-14,"21 - 35",2,278,287,599,82369,77284,56,0.515925162696598,29,27,"29 - 27","#86572C",2,4,"2028"
24,100,1,2028-05-15,1905,9,1,3,"FL","Florida Space Rangers","home",1,0,"Eastern Division","PBE",1,0,1,"1 - 0",0,0,1,3,1,0,1,1,1,0,"1 - 0","#D0D02B",1,1,"2028"
24,100,5,2028-05-16,1905,9,2,7,"FL","Florida Space Rangers","home",0,1,"Eastern Division","PBE",1,1,0,"1 - 1",5,5,3,10,9,25,2,0.264705882352941,1,1,"1 - 1","#D0D02B",1,1,"2028"
24,100,9,2028-05-17,1905,9,3,6,"FL","Florida Space Rangers","home",1,0,"Eastern Division","PBE",2,1,1,"2 - 1",0,5,6,16,36,25,3,0.590163934426229,2,1,"2 - 1","#D0D02B",1,1,"2028"
24,100,17,2028-05-20,1905,9,6,13,"FL","Florida Space Rangers","home",1,0,"Eastern Division","PBE",3,1,2,"3 - 1",4,9,12,29,144,81,4,0.64,3,1,"3 - 1","#D0D02B",1,1,"2028"
24,100,21,2028-05-21,1905,9,6,12,"FL","Florida Space Rangers","home",1,0,"Eastern Division","PBE",4,1,3,"4 - 1",0,9,18,41,324,81,5,0.8,4,1,"4 - 1","#D0D02B",1,1,"2028"
24,100,25,2028-05-22,1905,9,6,11,"FL","Florida Space Rangers","away",1,0,"Eastern Division","PBE",5,1,4,"5 - 1",1,10,24,52,576,100,6,0.85207100591716,5,1,"5 - 1","#D0D02B",1,1,"2028"
24,100,28,2028-05-23,1905,9,5,9,"FL","Florida Space Rangers","away",1,0,"Eastern Division","PBE",6,1,5,"6 - 1",3,13,29,61,841,169,7,0.832673267326733,6,1,"6 - 1","#D0D02B",1,1,"2028"
24,100,29,2028-05-25,1905,9,4,6,"FL","Florida Space Rangers","away",0,1,"Eastern Division","PBE",6,2,4,"6 - 2",5,18,33,67,1089,324,8,0.770700636942675,6,2,"6 - 2","#D0D02B",1,1,"2028"
24,100,32,2028-05-26,1905,9,5,7,"FL","Florida Space Rangers","away",1,0,"Eastern Division","PBE",7,2,5,"7 - 2",2,20,38,74,1444,400,9,0.783080260303688,7,2,"7 - 2","#D0D02B",1,1,"2028"
24,100,36,2028-05-27,1905,9,4,12,"FL","Florida Space Rangers","away",1,0,"Eastern Division","PBE",8,2,6,"8 - 2",3,23,42,86,1764,529,10,0.769297863061492,8,2,"8 - 2","#D0D02B",1,1,"2028"
24,100,45,2028-05-30,1905,9,4,10,"FL","Florida Space Rangers","home",1,0,"Eastern Division","PBE",9,2,7,"9 - 2",2,25,46,96,2116,625,11,0.771981028821598,8,3,"8 - 3","#D0D02B",1,1,"2028"
24,100,49,2028-05-31,1905,9,8,12,"FL","Florida Space Rangers","home",1,0,"Eastern Division","PBE",10,2,8,"10 - 2",2,27,54,108,2916,729,12,0.8,10,2,"10 - 2","#D0D02B",1,1,"2028"
24,100,53,2028-06-01,1905,9,2,6,"FL","Florida Space Rangers","home",1,0,"Eastern Division","PBE",11,2,9,"11 - 2",1,28,56,114,3136,784,13,0.8,10,3,"10 - 3","#D0D02B",1,1,"2028"
24,100,56,2028-06-04,1905,11,4,9,"FL","Florida Space Rangers","home",0,1,"Eastern Division","PBE",11,3,8,"11 - 3",5,33,60,123,3600,1089,14,0.767754318618042,11,3,"11 - 3","#D0D02B",1,1,"2028"
24,100,60,2028-06-05,1905,9,7,10,"FL","Florida Space Rangers","home",1,0,"Eastern Division","PBE",12,3,9,"12 - 3",5,38,67,133,4489,1444,15,0.756615540198888,11,4,"11 - 4","#D0D02B",1,1,"2028"
24,100,64,2028-06-06,1905,9,6,12,"FL","Florida Space Rangers","home",1,0,"Eastern Division","PBE",13,3,10,"13 - 3",3,41,73,145,5329,1681,16,0.760199714693295,12,4,"12 - 4","#D0D02B",1,1,"2028"
24,100,70,2028-06-09,1905,9,0,7,"FL","Florida Space Rangers","away",0,1,"Eastern Division","PBE",13,4,9,"13 - 4",2,43,73,152,5329,1849,17,0.742407355809418,13,4,"13 - 4","#D0D02B",1,1,"2028"
24,100,74,2028-06-10,1905,9,1,6,"FL","Florida Space Rangers","away",0,1,"Eastern Division","PBE",13,5,8,"13 - 5",2,45,74,158,5476,2025,18,0.73003599520064,13,5,"13 - 5","#D0D02B",1,1,"2028"
24,100,78,2028-06-11,1905,9,1,3,"FL","Florida Space Rangers","away",0,1,"Eastern Division","PBE",13,6,7,"13 - 6",9,54,75,161,5625,2916,19,0.658587987355111,13,6,"13 - 6","#D0D02B",1,1,"2028"
24,100,84,2028-06-14,1905,9,7,9,"FL","Florida Space Rangers","home",1,0,"Eastern Division","PBE",14,6,8,"14 - 6",4,58,82,170,6724,3364,20,0.666534496431404,13,7,"13 - 7","#D0D02B",1,1,"2028"
24,100,88,2028-06-15,1905,9,5,8,"FL","Florida Space Rangers","home",1,0,"Eastern Division","PBE",15,6,9,"15 - 6",1,59,87,178,7569,3481,21,0.684977375565611,14,7,"14 - 7","#D0D02B",1,1,"2028"
24,100,92,2028-06-16,1905,9,5,11,"FL","Florida Space Rangers","home",1,0,"Eastern Division","PBE",16,6,10,"16 - 6",4,63,92,189,8464,3969,22,0.680768921418805,15,7,"15 - 7","#D0D02B",1,1,"2028"
24,100,98,2028-06-19,1905,9,2,7,"FL","Florida Space Rangers","home",1,0,"Eastern Division","PBE",17,6,11,"17 - 6",1,64,94,196,8836,4096,23,0.683266316115063,16,7,"16 - 7","#D0D02B",1,1,"2028"
24,100,102,2028-06-20,1905,9,3,7,"FL","Florida Space Rangers","home",1,0,"Eastern Division","PBE",18,6,12,"18 - 6",0,64,97,203,9409,4096,24,0.696704924102184,17,7,"17 - 7","#D0D02B",1,1,"2028"
24,100,106,2028-06-21,1905,11,8,11,"FL","Florida Space Rangers","home",1,0,"Eastern Division","PBE",19,6,13,"19 - 6",5,69,105,214,11025,4761,25,0.698403648802737,17,8,"17 - 8","#D0D02B",1,1,"2028"
24,100,108,2028-06-24,1905,9,7,12,"FL","Florida Space Rangers","home",1,0,"Eastern Division","PBE",20,6,14,"20 - 6",3,72,112,226,12544,5184,26,0.707581227436823,18,8,"18 - 8","#D0D02B",1,1,"2028"
24,100,112,2028-06-25,1905,9,2,7,"FL","Florida Space Rangers","home",0,1,"Eastern Division","PBE",20,7,13,"20 - 7",5,77,114,233,12996,5929,27,0.6867107001321,19,8,"19 - 8","#D0D02B",1,1,"2028"
24,100,116,2028-06-26,1905,9,2,7,"FL","Florida Space Rangers","home",0,1,"Eastern Division","PBE",20,8,12,"20 - 8",4,81,116,240,13456,6561,28,0.672228605685168,19,9,"19 - 9","#D0D02B",1,1,"2028"
24,100,120,2028-06-27,1905,9,1,2,"FL","Florida Space Rangers","home",0,1,"Eastern Division","PBE",20,9,11,"20 - 9",5,86,117,242,13689,7396,29,0.649229309935973,19,10,"19 - 10","#D0D02B",1,1,"2028"
24,100,122,2028-06-29,1905,9,5,15,"FL","Florida Space Rangers","away",1,0,"Eastern Division","PBE",21,9,12,"21 - 9",4,90,122,257,14884,8100,30,0.647580925861469,19,11,"19 - 11","#D0D02B",1,1,"2028"
24,100,125,2028-06-30,1905,10,5,13,"FL","Florida Space Rangers","away",0,1,"Eastern Division","PBE",21,10,11,"21 - 10",7,97,127,270,16129,9409,31,0.631568642806798,20,11,"20 - 11","#D0D02B",1,1,"2028"
24,100,129,2028-07-01,1905,9,1,6,"FL","Florida Space Rangers","home",1,0,"Eastern Division","PBE",22,10,12,"22 - 10",0,97,128,276,16384,9409,32,0.635211103787849,20,12,"20 - 12","#D0D02B",1,1,"2028"
24,100,133,2028-07-02,1905,9,5,9,"FL","Florida Space Rangers","home",1,0,"Eastern Division","PBE",23,10,13,"23 - 10",2,99,133,285,17689,9801,33,0.643470352855584,21,12,"21 - 12","#D0D02B",1,1,"2028"
24,100,136,2028-07-04,1905,9,6,9,"FL","Florida Space Rangers","away",1,0,"Eastern Division","PBE",24,10,14,"24 - 10",4,103,139,294,19321,10609,34,0.645539592382225,22,12,"22 - 12","#D0D02B",1,1,"2028"
24,100,140,2028-07-05,1905,9,5,11,"FL","Florida Space Rangers","away",0,1,"Eastern Division","PBE",24,11,13,"24 - 11",10,113,144,305,20736,12769,35,0.618892702581704,22,13,"22 - 13","#D0D02B",1,1,"2028"
24,100,144,2028-07-06,1905,9,5,8,"FL","Florida Space Rangers","away",1,0,"Eastern Division","PBE",25,11,14,"25 - 11",1,114,149,313,22201,12996,36,0.630763985566952,23,13,"23 - 13","#D0D02B",1,1,"2028"
24,100,151,2028-07-09,1905,9,7,11,"FL","Florida Space Rangers","home",1,0,"Eastern Division","PBE",26,11,15,"26 - 11",5,119,156,324,24336,14161,37,0.632153154791282,23,14,"23 - 14","#D0D02B",1,1,"2028"
24,100,155,2028-07-10,1905,9,0,3,"FL","Florida Space Rangers","home",0,1,"Eastern Division","PBE",26,12,14,"26 - 12",2,121,156,327,24336,14641,38,0.624368217153706,24,14,"24 - 14","#D0D02B",1,1,"2028"
24,100,159,2028-07-11,1905,9,6,8,"FL","Florida Space Rangers","home",0,1,"Eastern Division","PBE",26,13,13,"26 - 13",12,133,162,335,26244,17689,39,0.597364168165161,23,16,"23 - 16","#D0D02B",1,1,"2028"
24,100,164,2028-07-14,1905,9,0,4,"FL","Florida Space Rangers","away",0,1,"Eastern Division","PBE",26,14,12,"26 - 14",5,138,162,339,26244,19044,40,0.579491255961844,23,17,"23 - 17","#D0D02B",1,1,"2028"
24,100,167,2028-07-15,1905,9,7,11,"FL","Florida Space Rangers","away",1,0,"Eastern Division","PBE",27,14,13,"27 - 14",0,138,169,350,28561,19044,41,0.599957987606344,25,16,"25 - 16","#D0D02B",1,1,"2028"
24,100,171,2028-07-16,1905,9,3,9,"FL","Florida Space Rangers","away",0,1,"Eastern Division","PBE",27,15,12,"27 - 15",6,144,172,359,29584,20736,42,0.5879173290938,25,17,"25 - 17","#D0D02B",1,1,"2028"
24,100,173,2028-07-17,1905,9,6,8,"FL","Florida Space Rangers","away",1,0,"Eastern Division","PBE",28,15,13,"28 - 15",1,145,178,367,31684,21025,43,0.601111764594282,26,17,"26 - 17","#D0D02B",1,1,"2028"
24,100,178,2028-07-19,1905,9,5,10,"FL","Florida Space Rangers","away",1,0,"Eastern Division","PBE",29,15,14,"29 - 15",1,146,183,377,33489,21316,44,0.611057385275066,27,17,"27 - 17","#D0D02B",1,1,"2028"
24,100,182,2028-07-20,1905,9,7,16,"FL","Florida Space Rangers","away",1,0,"Eastern Division","PBE",30,15,15,"30 - 15",2,148,190,393,36100,21904,45,0.622370870974416,28,17,"28 - 17","#D0D02B",1,1,"2028"
24,100,186,2028-07-21,1905,15,6,18,"FL","Florida Space Rangers","away",1,0,"Eastern Division","PBE",31,15,16,"31 - 15",5,153,196,411,38416,23409,46,0.621366761019005,29,17,"29 - 17","#D0D02B",1,1,"2028"
24,100,189,2028-07-24,1905,9,7,9,"FL","Florida Space Rangers","home",1,0,"Eastern Division","PBE",32,15,17,"32 - 15",0,153,203,420,41209,23409,47,0.637732520350367,30,17,"30 - 17","#D0D02B",1,1,"2028"
24,100,192,2028-07-25,1905,9,8,9,"FL","Florida Space Rangers","home",1,0,"Eastern Division","PBE",33,15,18,"33 - 15",4,157,211,429,44521,24649,48,0.643646089345092,31,17,"31 - 17","#D0D02B",1,1,"2028"
24,100,196,2028-07-26,1905,9,2,10,"FL","Florida Space Rangers","home",1,0,"Eastern Division","PBE",34,15,19,"34 - 15",1,158,213,439,45369,24964,49,0.645059929193977,32,17,"32 - 17","#D0D02B",1,1,"2028"
24,100,200,2028-07-27,1905,9,2,8,"FL","Florida Space Rangers","home",0,1,"Eastern Division","PBE",34,16,18,"34 - 16",6,164,215,447,46225,26896,50,0.632171332448955,32,18,"32 - 18","#D0D02B",1,1,"2028"
24,100,203,2028-08-11,1905,9,11,15,"FL","Florida Space Rangers","away",1,0,"Eastern Division","PBE",35,16,19,"35 - 16",10,174,226,462,51076,30276,51,0.627839512243092,32,19,"32 - 19","#D0D02B",1,1,"2028"
24,100,207,2028-08-12,1905,9,10,13,"FL","Florida Space Rangers","away",0,1,"Eastern Division","PBE",35,17,18,"35 - 17",14,188,236,475,55696,35344,52,0.611775043936731,32,20,"32 - 20","#D0D02B",1,1,"2028"
24,100,211,2028-08-13,1905,9,1,4,"FL","Florida Space Rangers","home",0,1,"Eastern Division","PBE",35,18,17,"35 - 18",3,191,237,479,56169,36481,53,0.606249325418241,32,21,"32 - 21","#D0D02B",1,1,"2028"
24,100,215,2028-08-14,1905,9,7,15,"FL","Florida Space Rangers","home",1,0,"Eastern Division","PBE",36,18,18,"36 - 18",1,192,244,494,59536,36864,54,0.617593360995851,33,21,"33 - 21","#D0D02B",1,1,"2028"
24,100,218,2028-08-16,1905,9,5,7,"FL","Florida Space Rangers","away",1,0,"Eastern Division","PBE",37,18,19,"37 - 18",3,195,249,501,62001,38025,55,0.619848839301782,34,21,"34 - 21","#D0D02B",1,1,"2028"
24,100,221,2028-08-17,1905,10,6,11,"FL","Florida Space Rangers","away",1,0,"Eastern Division","PBE",38,18,20,"38 - 18",5,200,255,512,65025,40000,56,0.619138300404666,35,21,"35 - 21","#D0D02B",1,1,"2028"
24,100,225,2028-08-18,1905,9,14,18,"FL","Florida Space Rangers","away",1,0,"Eastern Division","PBE",39,18,21,"39 - 18",3,203,269,530,72361,41209,57,0.637148894954654,36,21,"36 - 21","#D0D02B",1,1,"2028"
25,100,4,2028-05-15,1905,9,4,6,"UTA","Utah Railroaders","away",0,1,"Western Division","PBE",0,1,-1,"0 - 1",5,5,4,6,16,25,1,0.390243902439024,0,1,"0 - 1","#2C0060",4,8,"2028"
25,100,8,2028-05-16,1905,9,3,13,"UTA","Utah Railroaders","away",0,1,"Western Division","PBE",0,2,-2,"0 - 2",8,13,7,19,49,169,2,0.224770642201835,0,2,"0 - 2","#2C0060",4,8,"2028"
25,100,12,2028-05-17,1905,9,1,3,"UTA","Utah Railroaders","away",0,1,"Western Division","PBE",0,3,-3,"0 - 3",4,17,8,22,64,289,3,0.181303116147309,1,2,"1 - 2","#2C0060",4,8,"2028"
25,100,14,2028-05-18,1905,9,4,9,"UTA","Utah Railroaders","away",0,1,"Western Division","PBE",0,4,-4,"0 - 4",9,26,12,31,144,676,4,0.175609756097561,1,3,"1 - 3","#2C0060",4,8,"2028"
25,100,16,2028-05-20,1905,9,8,13,"UTA","Utah Railroaders","away",1,0,"Western Division","PBE",1,4,-3,"1 - 4",0,26,20,44,400,676,5,0.371747211895911,2,3,"2 - 3","#2C0060",4,8,"2028"
25,100,20,2028-05-21,1905,9,1,3,"UTA","Utah Railroaders","away",0,1,"Western Division","PBE",1,5,-4,"1 - 5",6,32,21,47,441,1024,6,0.301023890784983,2,4,"2 - 4","#2C0060",4,8,"2028"
25,100,24,2028-05-22,1905,9,1,7,"UTA","Utah Railroaders","away",0,1,"Western Division","PBE",1,6,-5,"1 - 6",2,34,22,54,484,1156,7,0.295121951219512,2,5,"2 - 5","#2C0060",4,8,"2028"
25,100,31,2028-05-25,1905,9,5,6,"UTA","Utah Railroaders","home",1,0,"Western Division","PBE",2,6,-4,"2 - 6",3,37,27,60,729,1369,8,0.347473784556721,3,5,"3 - 5","#2C0060",4,8,"2028"
25,100,35,2028-05-26,1905,9,2,6,"UTA","Utah Railroaders","home",0,1,"Western Division","PBE",2,7,-5,"2 - 7",12,49,29,66,841,2401,9,0.259407772979642,2,7,"2 - 7","#2C0060",4,8,"2028"
25,100,39,2028-05-27,1905,9,7,12,"UTA","Utah Railroaders","home",1,0,"Western Division","PBE",3,7,-4,"3 - 7",6,55,36,78,1296,3025,10,0.299930571626938,3,7,"3 - 7","#2C0060",4,8,"2028"
25,100,41,2028-05-28,1905,9,4,12,"UTA","Utah Railroaders","home",0,1,"Western Division","PBE",3,8,-5,"3 - 8",11,66,40,90,1600,4356,11,0.268636668905306,3,8,"3 - 8","#2C0060",4,8,"2028"
25,100,45,2028-05-30,1905,9,2,5,"UTA","Utah Railroaders","away",0,1,"Western Division","PBE",3,9,-6,"3 - 9",4,70,42,95,1764,4900,12,0.264705882352941,3,9,"3 - 9","#2C0060",4,8,"2028"
25,100,49,2028-05-31,1905,9,2,6,"UTA","Utah Railroaders","away",0,1,"Western Division","PBE",3,10,-7,"3 - 10",8,78,44,101,1936,6084,13,0.24139650872818,3,10,"3 - 10","#2C0060",4,8,"2028"
25,100,53,2028-06-01,1905,9,1,9,"UTA","Utah Railroaders","away",0,1,"Western Division","PBE",3,11,-8,"3 - 11",2,80,45,110,2025,6400,14,0.240356083086053,3,11,"3 - 11","#2C0060",4,8,"2028"
25,100,58,2028-06-04,1905,9,2,6,"UTA","Utah Railroaders","home",0,1,"Western Division","PBE",3,12,-9,"3 - 12",8,88,47,116,2209,7744,15,0.221943132723802,3,12,"3 - 12","#2C0060",4,8,"2028"
25,100,62,2028-06-05,1905,9,1,3,"UTA","Utah Railroaders","home",0,1,"Western Division","PBE",3,13,-10,"3 - 13",2,90,48,119,2304,8100,16,0.221453287197232,4,12,"4 - 12","#2C0060",4,8,"2028"
25,100,66,2028-06-06,1905,9,13,12,"UTA","Utah Railroaders","home",1,0,"Western Division","PBE",4,13,-9,"4 - 13",9,99,61,131,3721,9801,17,0.275181186215057,5,12,"5 - 12","#2C0060",4,8,"2028"
25,100,68,2028-06-09,1905,9,8,11,"UTA","Utah Railroaders","home",1,0,"Western Division","PBE",5,13,-8,"5 - 13",7,106,69,142,4761,11236,18,0.297618303431893,5,13,"5 - 13","#2C0060",4,8,"2028"
25,100,72,2028-06-10,1905,9,2,6,"UTA","Utah Railroaders","home",0,1,"Western Division","PBE",5,14,-9,"5 - 14",4,110,71,148,5041,12100,19,0.294090193104253,6,13,"6 - 13","#2C0060",4,8,"2028"
25,100,76,2028-06-11,1905,9,3,7,"UTA","Utah Railroaders","away",0,1,"Western Division","PBE",5,15,-10,"5 - 15",5,115,74,155,5476,13225,20,0.292818565852093,6,14,"6 - 14","#2C0060",4,8,"2028"
25,100,80,2028-06-12,1905,9,0,6,"UTA","Utah Railroaders","away",0,1,"Western Division","PBE",5,16,-11,"5 - 16",1,116,74,161,5476,13456,21,0.289245721529685,6,15,"6 - 15","#2C0060",4,8,"2028"
25,100,86,2028-06-15,1905,9,8,11,"UTA","Utah Railroaders","away",1,0,"Western Division","PBE",6,16,-10,"6 - 16",4,120,82,172,6724,14400,22,0.318310925960992,7,15,"7 - 15","#2C0060",4,8,"2028"
25,100,90,2028-06-16,1905,9,0,1,"UTA","Utah Railroaders","away",0,1,"Western Division","PBE",6,17,-11,"6 - 17",5,125,82,173,6724,15625,23,0.300863573314242,7,16,"7 - 16","#2C0060",4,8,"2028"
25,100,94,2028-06-17,1905,9,6,8,"UTA","Utah Railroaders","away",0,1,"Western Division","PBE",6,18,-12,"6 - 18",10,135,88,181,7744,18225,24,0.298201702029343,7,17,"7 - 17","#2C0060",4,8,"2028"
25,100,97,2028-06-19,1905,9,3,11,"UTA","Utah Railroaders","home",0,1,"Western Division","PBE",6,19,-13,"6 - 19",8,143,91,192,8281,20449,25,0.288235294117647,7,18,"7 - 18","#2C0060",4,8,"2028"
25,100,101,2028-06-20,1905,9,4,8,"UTA","Utah Railroaders","home",0,1,"Western Division","PBE",6,20,-14,"6 - 20",7,150,95,200,9025,22500,26,0.286280729579699,7,19,"7 - 19","#2C0060",4,8,"2028"
25,100,105,2028-06-21,1905,9,2,11,"UTA","Utah Railroaders","home",0,1,"Western Division","PBE",6,21,-15,"6 - 21",4,154,97,211,9409,23716,27,0.284045283018868,8,19,"8 - 19","#2C0060",4,8,"2028"
25,100,111,2028-06-24,1905,9,0,3,"UTA","Utah Railroaders","away",0,1,"Western Division","PBE",6,22,-16,"6 - 22",2,156,97,214,9409,24336,28,0.27882649281375,8,20,"8 - 20","#2C0060",4,8,"2028"
25,100,115,2028-06-25,1905,10,2,6,"UTA","Utah Railroaders","away",0,1,"Western Division","PBE",6,23,-17,"6 - 23",3,159,99,220,9801,25281,29,0.279374037968189,8,21,"8 - 21","#2C0060",4,8,"2028"
25,100,119,2028-06-26,1905,9,0,3,"UTA","Utah Railroaders","away",0,1,"Western Division","PBE",6,24,-18,"6 - 24",1,160,99,223,9801,25600,30,0.276856585972148,8,22,"8 - 22","#2C0060",4,8,"2028"
25,100,122,2028-06-29,1905,9,4,8,"UTA","Utah Railroaders","home",0,1,"Western Division","PBE",6,25,-19,"6 - 25",5,165,103,231,10609,27225,31,0.280409155785801,9,22,"9 - 22","#2C0060",4,8,"2028"
25,100,125,2028-06-30,1905,10,7,11,"UTA","Utah Railroaders","home",1,0,"Western Division","PBE",7,25,-18,"7 - 25",5,170,110,242,12100,28900,32,0.295121951219512,9,23,"9 - 23","#2C0060",4,8,"2028"
25,100,129,2028-07-01,1905,9,0,2,"UTA","Utah Railroaders","away",0,1,"Western Division","PBE",7,26,-19,"7 - 26",1,171,110,244,12100,29241,33,0.292687646646187,10,23,"10 - 23","#2C0060",4,8,"2028"
25,100,133,2028-07-02,1905,9,2,5,"UTA","Utah Railroaders","away",0,1,"Western Division","PBE",7,27,-20,"7 - 27",5,176,112,249,12544,30976,34,0.288235294117647,10,24,"10 - 24","#2C0060",4,8,"2028"
25,100,137,2028-07-04,1905,9,0,3,"UTA","Utah Railroaders","away",0,1,"Western Division","PBE",7,28,-21,"7 - 28",8,184,112,252,12544,33856,35,0.270344827586207,9,26,"9 - 26","#2C0060",4,8,"2028"
25,100,141,2028-07-05,1905,9,1,5,"UTA","Utah Railroaders","away",0,1,"Western Division","PBE",7,29,-22,"7 - 29",9,193,113,257,12769,37249,36,0.255288096285337,9,27,"9 - 27","#2C0060",4,8,"2028"
25,100,145,2028-07-06,1905,9,3,8,"UTA","Utah Railroaders","away",1,0,"Western Division","PBE",8,29,-21,"8 - 29",0,193,116,265,13456,37249,37,0.265378167833547,10,27,"10 - 27","#2C0060",4,8,"2028"
25,100,147,2028-07-07,1905,9,1,5,"UTA","Utah Railroaders","away",0,1,"Western Division","PBE",8,30,-22,"8 - 30",8,201,117,270,13689,40401,38,0.253078202995008,10,28,"10 - 28","#2C0060",4,8,"2028"
25,100,149,2028-07-09,1905,9,5,11,"UTA","Utah Railroaders","away",0,1,"Western Division","PBE",8,31,-23,"8 - 31",6,207,122,281,14884,42849,39,0.257807493114856,10,29,"10 - 29","#2C0060",4,8,"2028"
25,100,153,2028-07-10,1905,9,8,8,"UTA","Utah Railroaders","away",1,0,"Western Division","PBE",9,31,-22,"9 - 31",6,213,130,289,16900,45369,40,0.27140310587933,11,29,"11 - 29","#2C0060",4,8,"2028"
25,100,157,2028-07-11,1905,9,8,12,"UTA","Utah Railroaders","home",1,0,"Western Division","PBE",10,31,-21,"10 - 31",4,217,138,301,19044,47089,41,0.287965161114723,12,29,"12 - 29","#2C0060",4,8,"2028"
25,100,161,2028-07-12,1905,9,5,10,"UTA","Utah Railroaders","home",0,1,"Western Division","PBE",10,32,-22,"10 - 32",7,224,143,311,20449,50176,42,0.289543362831858,12,30,"12 - 30","#2C0060",4,8,"2028"
25,100,162,2028-07-14,1905,9,6,12,"UTA","Utah Railroaders","away",0,1,"Western Division","PBE",10,33,-23,"10 - 33",7,231,149,323,22201,53361,43,0.29381170429581,13,30,"13 - 30","#2C0060",4,8,"2028"
25,100,165,2028-07-15,1905,9,1,5,"UTA","Utah Railroaders","away",0,1,"Western Division","PBE",10,34,-24,"10 - 34",6,237,150,328,22500,56169,44,0.286008465850589,13,31,"13 - 31","#2C0060",4,8,"2028"
25,100,169,2028-07-16,1905,9,1,6,"UTA","Utah Railroaders","away",0,1,"Western Division","PBE",10,35,-25,"10 - 35",4,241,151,334,22801,58081,45,0.281904502856012,13,32,"13 - 32","#2C0060",4,8,"2028"
25,100,178,2028-07-19,1905,9,1,6,"UTA","Utah Railroaders","home",0,1,"Western Division","PBE",10,36,-26,"10 - 36",5,246,152,340,23104,60516,46,0.276297536474528,13,33,"13 - 33","#2C0060",4,8,"2028"
25,100,182,2028-07-20,1905,9,2,7,"UTA","Utah Railroaders","home",0,1,"Western Division","PBE",10,37,-27,"10 - 37",7,253,154,347,23716,64009,47,0.270344827586207,13,34,"13 - 34","#2C0060",4,8,"2028"
25,100,186,2028-07-21,1905,15,5,8,"UTA","Utah Railroaders","home",0,1,"Western Division","PBE",10,38,-28,"10 - 38",6,259,159,355,25281,67081,48,0.273716463480652,13,35,"13 - 35","#2C0060",4,8,"2028"
25,100,191,2028-07-24,1905,9,0,4,"UTA","Utah Railroaders","home",0,1,"Western Division","PBE",10,39,-29,"10 - 39",7,266,159,359,25281,70756,49,0.263242292033279,13,36,"13 - 36","#2C0060",4,8,"2028"
25,100,194,2028-07-25,1905,9,0,3,"UTA","Utah Railroaders","home",0,1,"Western Division","PBE",10,40,-30,"10 - 40",11,277,159,362,25281,76729,50,0.247828644250564,12,38,"12 - 38","#2C0060",4,8,"2028"
25,100,198,2028-07-26,1905,9,5,6,"UTA","Utah Railroaders","home",1,0,"Western Division","PBE",11,40,-29,"11 - 40",3,280,164,368,26896,78400,51,0.255432305120802,13,38,"13 - 38","#2C0060",4,8,"2028"
25,100,202,2028-08-11,1905,9,2,5,"UTA","Utah Railroaders","away",0,1,"Western Division","PBE",11,41,-30,"11 - 41",3,283,166,373,27556,80089,52,0.255989595429421,13,39,"13 - 39","#2C0060",4,8,"2028"
25,100,206,2028-08-12,1905,14,10,13,"UTA","Utah Railroaders","away",1,0,"Western Division","PBE",12,41,-29,"12 - 41",6,289,176,386,30976,83521,53,0.270539839471777,14,39,"14 - 39","#2C0060",4,8,"2028"
25,100,210,2028-08-13,1905,9,6,9,"UTA","Utah Railroaders","home",0,1,"Western Division","PBE",12,42,-30,"12 - 42",10,299,182,395,33124,89401,54,0.270344827586207,15,39,"15 - 39","#2C0060",4,8,"2028"
25,100,214,2028-08-14,1905,9,1,8,"UTA","Utah Railroaders","home",0,1,"Western Division","PBE",12,43,-31,"12 - 43",3,302,183,403,33489,91204,55,0.268571611878774,15,40,"15 - 40","#2C0060",4,8,"2028"
25,100,219,2028-08-16,1905,20,5,17,"UTA","Utah Railroaders","away",0,1,"Western Division","PBE",12,44,-32,"12 - 44",6,308,188,420,35344,94864,56,0.271442614893094,15,41,"15 - 41","#2C0060",4,8,"2028"
25,100,222,2028-08-17,1905,9,5,11,"UTA","Utah Railroaders","away",0,1,"Western Division","PBE",12,45,-33,"12 - 45",10,318,193,431,37249,101124,57,0.26919268932523,15,42,"15 - 42","#2C0060",4,8,"2028"
25,100,226,2028-08-18,1905,9,5,7,"UTA","Utah Railroaders","away",1,0,"Western Division","PBE",13,45,-32,"13 - 45",3,321,198,438,39204,103041,58,0.275608984498576,16,42,"16 - 42","#2C0060",4,8,"2028"
