"team_id","league_id","game_id","date","time","innings","runs","hits","team_abbr","team_name","home/away","win","loss","division","league_abbr","ttl_wins","ttl_losses","below.500","winloss","RA","ttl_ra","ttl_runs","ttl_hits","ttl_rs_sq","ttl_ra_sq","gp","wp","pythag_win","pythag_loss","pythag_record","Primary Color","Division Standing","League Standing","season"
1,100,2,2029-05-15,1905,9,5,7,"NYV","New York Voyagers","home",1,0,"Eastern Division","PBE",1,0,1,"1 - 0",3,3,5,7,25,9,1,0.735294117647059,1,0,"1 - 0","#0E1540",2,3,"2029"
1,100,7,2029-05-16,1905,11,5,5,"NYV","New York Voyagers","home",1,0,"Eastern Division","PBE",2,0,2,"2 - 0",4,7,10,12,100,49,2,0.671140939597315,1,1,"1 - 1","#0E1540",2,3,"2029"
1,100,12,2029-05-17,1905,9,5,9,"NYV","New York Voyagers","home",1,0,"Eastern Division","PBE",3,0,3,"3 - 0",4,11,15,21,225,121,3,0.65028901734104,2,1,"2 - 1","#0E1540",2,3,"2029"
1,100,17,2029-05-18,1905,9,4,10,"NYV","New York Voyagers","home",0,1,"Eastern Division","PBE",3,1,2,"3 - 1",7,18,19,31,361,324,4,0.527007299270073,2,2,"2 - 2","#0E1540",2,3,"2029"
1,100,21,2029-05-21,1905,9,1,6,"NYV","New York Voyagers","away",0,1,"Eastern Division","PBE",3,2,1,"3 - 2",2,20,20,37,400,400,5,0.5,2,3,"2 - 3","#0E1540",2,3,"2029"
1,100,26,2029-05-22,1905,9,11,12,"NYV","New York Voyagers","away",1,0,"Eastern Division","PBE",4,2,2,"4 - 2",1,21,31,49,961,441,6,0.685449358059914,4,2,"4 - 2","#0E1540",2,3,"2029"
1,100,31,2029-05-23,1905,10,8,9,"NYV","New York Voyagers","away",1,0,"Eastern Division","PBE",5,2,3,"5 - 2",7,28,39,58,1521,784,7,0.659869848156182,5,2,"5 - 2","#0E1540",2,3,"2029"
1,100,40,2029-05-26,1905,9,4,6,"NYV","New York Voyagers","home",0,1,"Eastern Division","PBE",5,3,2,"5 - 3",8,36,43,64,1849,1296,8,0.5879173290938,5,3,"5 - 3","#0E1540",2,3,"2029"
1,100,44,2029-05-27,1905,9,5,9,"NYV","New York Voyagers","home",1,0,"Eastern Division","PBE",6,3,3,"6 - 3",1,37,48,73,2304,1369,9,0.627280152463926,6,3,"6 - 3","#0E1540",2,3,"2029"
1,100,49,2029-05-28,1905,9,3,6,"NYV","New York Voyagers","home",0,1,"Eastern Division","PBE",6,4,2,"6 - 4",6,43,51,79,2601,1849,10,0.584494382022472,6,4,"6 - 4","#0E1540",2,3,"2029"
1,100,54,2029-05-29,1905,9,4,7,"NYV","New York Voyagers","home",1,0,"Eastern Division","PBE",7,4,3,"7 - 4",3,46,55,86,3025,2116,11,0.588406924722817,6,5,"6 - 5","#0E1540",2,3,"2029"
1,100,61,2029-06-01,1905,9,5,9,"NYV","New York Voyagers","away",0,1,"Eastern Division","PBE",7,5,2,"7 - 5",7,53,60,95,3600,2809,12,0.561710095178655,7,5,"7 - 5","#0E1540",2,3,"2029"
1,100,66,2029-06-02,1905,9,8,9,"NYV","New York Voyagers","away",1,0,"Eastern Division","PBE",8,5,3,"8 - 5",3,56,68,104,4624,3136,13,0.595876288659794,8,5,"8 - 5","#0E1540",2,3,"2029"
1,100,71,2029-06-03,1905,9,11,12,"NYV","New York Voyagers","away",1,0,"Eastern Division","PBE",9,5,4,"9 - 5",1,57,79,116,6241,3249,14,0.657639620653319,9,5,"9 - 5","#0E1540",2,3,"2029"
1,100,76,2029-06-04,1905,9,8,10,"NYV","New York Voyagers","away",1,0,"Eastern Division","PBE",10,5,5,"10 - 5",4,61,87,126,7569,3721,15,0.670416297608503,10,5,"10 - 5","#0E1540",2,3,"2029"
1,100,79,2029-06-06,1905,9,3,10,"NYV","New York Voyagers","away",0,1,"Eastern Division","PBE",10,6,4,"10 - 6",8,69,90,136,8100,4761,16,0.629811056682995,10,6,"10 - 6","#0E1540",2,3,"2029"
1,100,83,2029-06-07,1905,9,8,12,"NYV","New York Voyagers","away",1,0,"Eastern Division","PBE",11,6,5,"11 - 6",0,69,98,148,9604,4761,17,0.668569439610164,11,6,"11 - 6","#0E1540",2,3,"2029"
1,100,88,2029-06-08,1905,9,6,12,"NYV","New York Voyagers","away",1,0,"Eastern Division","PBE",12,6,6,"12 - 6",0,69,104,160,10816,4761,18,0.694357064903383,12,6,"12 - 6","#0E1540",2,3,"2029"
1,100,93,2029-06-09,1905,9,9,13,"NYV","New York Voyagers","away",1,0,"Eastern Division","PBE",13,6,7,"13 - 6",6,75,113,173,12769,5625,19,0.694193758834402,13,6,"13 - 6","#0E1540",2,3,"2029"
1,100,99,2029-06-11,1905,11,3,9,"NYV","New York Voyagers","home",1,0,"Eastern Division","PBE",14,6,8,"14 - 6",1,76,116,182,13456,5776,20,0.699667221297837,14,6,"14 - 6","#0E1540",2,3,"2029"
1,100,104,2029-06-12,1905,9,4,6,"NYV","New York Voyagers","home",1,0,"Eastern Division","PBE",15,6,9,"15 - 6",2,78,120,188,14400,6084,21,0.70298769771529,15,6,"15 - 6","#0E1540",2,3,"2029"
1,100,109,2029-06-13,1905,9,5,7,"NYV","New York Voyagers","home",1,0,"Eastern Division","PBE",16,6,10,"16 - 6",3,81,125,195,15625,6561,22,0.704272964932841,15,7,"15 - 7","#0E1540",2,3,"2029"
1,100,113,2029-06-14,1905,9,4,6,"NYV","New York Voyagers","home",0,1,"Eastern Division","PBE",16,7,9,"16 - 7",6,87,129,201,16641,7569,23,0.687360594795539,16,7,"16 - 7","#0E1540",2,3,"2029"
1,100,116,2029-06-16,1905,9,2,5,"NYV","New York Voyagers","home",0,1,"Eastern Division","PBE",16,8,8,"16 - 8",7,94,131,206,17161,8836,24,0.660114628610994,16,8,"16 - 8","#0E1540",2,3,"2029"
1,100,120,2029-06-17,1905,9,9,17,"NYV","New York Voyagers","home",1,0,"Eastern Division","PBE",17,8,9,"17 - 8",1,95,140,223,19600,9025,25,0.68471615720524,17,8,"17 - 8","#0E1540",2,3,"2029"
1,100,125,2029-06-18,1905,9,4,7,"NYV","New York Voyagers","home",1,0,"Eastern Division","PBE",18,8,10,"18 - 8",2,97,144,230,20736,9409,26,0.687875269530602,18,8,"18 - 8","#0E1540",2,3,"2029"
1,100,130,2029-06-19,1905,9,4,6,"NYV","New York Voyagers","home",0,1,"Eastern Division","PBE",18,9,9,"18 - 9",10,107,148,236,21904,11449,27,0.656732527808593,18,9,"18 - 9","#0E1540",2,3,"2029"
1,100,136,2029-06-22,1905,9,3,6,"NYV","New York Voyagers","away",0,1,"Eastern Division","PBE",18,10,8,"18 - 10",9,116,151,242,22801,13456,28,0.628871666161017,18,10,"18 - 10","#0E1540",2,3,"2029"
1,100,141,2029-06-23,1905,9,2,6,"NYV","New York Voyagers","away",0,1,"Eastern Division","PBE",18,11,7,"18 - 11",5,121,153,248,23409,14641,29,0.615216819973719,18,11,"18 - 11","#0E1540",2,3,"2029"
1,100,146,2029-06-24,1905,9,2,6,"NYV","New York Voyagers","away",0,1,"Eastern Division","PBE",18,12,6,"18 - 12",5,126,155,254,24025,15876,30,0.602115235207138,18,12,"18 - 12","#0E1540",2,3,"2029"
1,100,151,2029-06-25,1905,9,4,7,"NYV","New York Voyagers","away",0,1,"Eastern Division","PBE",18,13,5,"18 - 13",7,133,159,261,25281,17689,31,0.588340702815918,18,13,"18 - 13","#0E1540",2,3,"2029"
1,100,160,2029-06-28,1905,9,4,6,"NYV","New York Voyagers","away",0,1,"Eastern Division","PBE",18,14,4,"18 - 14",9,142,163,267,26569,20164,32,0.56852759292149,18,14,"18 - 14","#0E1540",2,3,"2029"
1,100,165,2029-06-29,1905,9,10,11,"NYV","New York Voyagers","away",1,0,"Eastern Division","PBE",19,14,5,"19 - 14",3,145,173,278,29929,21025,33,0.587372924598658,19,14,"19 - 14","#0E1540",2,3,"2029"
1,100,170,2029-06-30,1905,9,6,11,"NYV","New York Voyagers","away",1,0,"Eastern Division","PBE",20,14,6,"20 - 14",1,146,179,289,32041,21316,34,0.60050227711453,20,14,"20 - 14","#0E1540",2,3,"2029"
1,100,176,2029-07-03,1905,9,6,10,"NYV","New York Voyagers","away",1,0,"Eastern Division","PBE",21,14,7,"21 - 14",2,148,185,299,34225,21904,35,0.609756097560976,21,14,"21 - 14","#0E1540",2,3,"2029"
1,100,181,2029-07-04,1905,9,10,13,"NYV","New York Voyagers","away",1,0,"Eastern Division","PBE",22,14,8,"22 - 14",3,151,195,312,38025,22801,36,0.625143852957617,23,13,"23 - 13","#0E1540",2,3,"2029"
1,100,186,2029-07-05,1905,13,9,13,"NYV","New York Voyagers","away",1,0,"Eastern Division","PBE",23,14,9,"23 - 14",5,156,204,325,41616,24336,37,0.631004366812227,23,14,"23 - 14","#0E1540",2,3,"2029"
1,100,191,2029-07-06,1905,9,7,11,"NYV","New York Voyagers","away",1,0,"Eastern Division","PBE",24,14,10,"24 - 14",1,157,211,336,44521,24649,38,0.643646089345092,24,14,"24 - 14","#0E1540",2,3,"2029"
1,100,195,2029-07-09,1905,9,2,8,"NYV","New York Voyagers","home",0,1,"Eastern Division","PBE",24,15,9,"24 - 15",3,160,213,344,45369,25600,39,0.639279121870112,25,14,"25 - 14","#0E1540",2,3,"2029"
1,100,200,2029-07-10,1905,9,5,8,"NYV","New York Voyagers","home",1,0,"Eastern Division","PBE",25,15,10,"25 - 15",3,163,218,352,47524,26569,40,0.641410119714413,26,14,"26 - 14","#0E1540",2,3,"2029"
1,100,205,2029-07-11,1905,9,21,21,"NYV","New York Voyagers","home",1,0,"Eastern Division","PBE",26,15,11,"26 - 15",4,167,239,373,57121,27889,41,0.671932713798377,28,13,"28 - 13","#0E1540",2,3,"2029"
1,100,210,2029-07-12,1905,9,7,14,"NYV","New York Voyagers","home",1,0,"Eastern Division","PBE",27,15,12,"27 - 15",1,168,246,387,60516,28224,42,0.681947261663286,29,13,"29 - 13","#0E1540",2,3,"2029"
1,100,217,2029-07-15,1905,9,1,4,"NYV","New York Voyagers","away",0,1,"Eastern Division","PBE",27,16,11,"27 - 16",8,176,247,391,61009,30976,43,0.663249442843942,29,14,"29 - 14","#0E1540",2,3,"2029"
1,100,222,2029-07-16,1905,9,3,7,"NYV","New York Voyagers","away",0,1,"Eastern Division","PBE",27,17,10,"27 - 17",13,189,250,398,62500,35721,44,0.636320135205302,28,16,"28 - 16","#0E1540",2,3,"2029"
1,100,227,2029-07-17,1905,9,8,15,"NYV","New York Voyagers","away",1,0,"Eastern Division","PBE",28,17,11,"28 - 17",7,196,258,413,66564,38416,45,0.634063631167841,29,16,"29 - 16","#0E1540",2,3,"2029"
1,100,232,2029-07-18,1905,9,1,5,"NYV","New York Voyagers","away",0,1,"Eastern Division","PBE",28,18,10,"28 - 18",7,203,259,418,67081,41209,46,0.619457013574661,28,18,"28 - 18","#0E1540",2,3,"2029"
1,100,235,2029-07-21,1905,9,1,10,"NYV","New York Voyagers","home",0,1,"Eastern Division","PBE",28,19,9,"28 - 19",10,213,260,428,67600,45369,47,0.598394249749931,28,19,"28 - 19","#0E1540",2,3,"2029"
1,100,240,2029-07-22,1905,9,3,4,"NYV","New York Voyagers","home",0,1,"Eastern Division","PBE",28,20,8,"28 - 20",4,217,263,432,69169,47089,48,0.594961206970703,29,19,"29 - 19","#0E1540",2,3,"2029"
1,100,245,2029-07-23,1905,9,2,5,"NYV","New York Voyagers","home",1,0,"Eastern Division","PBE",29,20,9,"29 - 20",0,217,265,437,70225,47089,49,0.598607156861074,29,20,"29 - 20","#0E1540",2,3,"2029"
1,100,250,2029-07-24,1905,9,18,20,"NYV","New York Voyagers","home",1,0,"Eastern Division","PBE",30,20,10,"30 - 20",1,218,283,457,80089,47524,50,0.627592800106572,31,19,"31 - 19","#0E1540",2,3,"2029"
1,100,255,2029-08-12,1905,10,2,10,"NYV","New York Voyagers","home",0,1,"Eastern Division","PBE",30,21,9,"30 - 21",4,222,285,467,81225,49284,51,0.622370870974416,32,19,"32 - 19","#0E1540",2,3,"2029"
1,100,260,2029-08-13,1905,9,7,12,"NYV","New York Voyagers","home",1,0,"Eastern Division","PBE",31,21,10,"31 - 21",3,225,292,479,85264,50625,52,0.62745328908153,33,19,"33 - 19","#0E1540",2,3,"2029"
1,100,265,2029-08-14,1905,11,3,8,"NYV","New York Voyagers","home",1,0,"Eastern Division","PBE",32,21,11,"32 - 21",2,227,295,487,87025,51529,53,0.628094461365244,33,20,"33 - 20","#0E1540",2,3,"2029"
1,100,270,2029-08-15,1905,9,7,11,"NYV","New York Voyagers","home",1,0,"Eastern Division","PBE",33,21,12,"33 - 21",2,229,302,498,91204,52441,54,0.634926381008737,34,20,"34 - 20","#0E1540",2,3,"2029"
1,100,273,2029-08-17,1905,9,6,10,"NYV","New York Voyagers","home",0,1,"Eastern Division","PBE",33,22,11,"33 - 22",8,237,308,508,94864,56169,55,0.628101143458714,35,20,"35 - 20","#0E1540",2,3,"2029"
1,100,277,2029-08-18,1905,9,7,8,"NYV","New York Voyagers","home",1,0,"Eastern Division","PBE",34,22,12,"34 - 22",5,242,315,516,99225,58564,56,0.628846117283207,35,21,"35 - 21","#0E1540",2,3,"2029"
1,100,282,2029-08-19,1905,9,11,11,"NYV","New York Voyagers","home",1,0,"Eastern Division","PBE",35,22,13,"35 - 22",0,242,326,527,106276,58564,57,0.644722154816792,37,20,"37 - 20","#0E1540",2,3,"2029"
1,100,287,2029-08-20,1905,9,2,6,"NYV","New York Voyagers","home",1,0,"Eastern Division","PBE",36,22,14,"36 - 22",1,243,328,533,107584,59049,58,0.645634418152467,37,21,"37 - 21","#0E1540",2,3,"2029"
1,100,292,2029-08-22,1905,9,4,8,"NYV","New York Voyagers","home",1,0,"Eastern Division","PBE",37,22,15,"37 - 22",3,246,332,541,110224,60516,59,0.645566358205459,38,21,"38 - 21","#0E1540",2,3,"2029"
1,100,296,2029-08-23,1905,9,10,14,"NYV","New York Voyagers","home",1,0,"Eastern Division","PBE",38,22,16,"38 - 22",9,255,342,555,116964,65025,60,0.642698185055141,39,21,"39 - 21","#0E1540",2,3,"2029"
1,100,301,2029-08-24,1905,9,0,3,"NYV","New York Voyagers","home",0,1,"Eastern Division","PBE",38,23,15,"38 - 23",1,256,342,558,116964,65536,61,0.640898630136986,39,22,"39 - 22","#0E1540",2,3,"2029"
1,100,636,2029-08-27,1905,9,6,8,"NYV","New York Voyagers","away",1,0,"Eastern Division","PBE",39,23,16,"39 - 23",5,261,348,566,121104,68121,62,0.64,40,22,"40 - 22","#0E1540",2,3,"2029"
1,100,641,2029-08-28,1905,9,3,3,"NYV","New York Voyagers","away",0,1,"Eastern Division","PBE",39,24,15,"39 - 24",5,266,351,569,123201,70756,63,0.635197492227659,40,23,"40 - 23","#0E1540",2,3,"2029"
1,100,646,2029-08-29,1905,9,3,9,"NYV","New York Voyagers","away",1,0,"Eastern Division","PBE",40,24,16,"40 - 24",1,267,354,578,125316,71289,64,0.637399862668803,41,23,"41 - 23","#0E1540",2,3,"2029"
1,100,651,2029-08-30,1905,9,7,11,"NYV","New York Voyagers","away",1,0,"Eastern Division","PBE",41,24,17,"41 - 24",0,267,361,589,130321,71289,65,0.646401468181142,42,23,"42 - 23","#0E1540",2,3,"2029"
1,100,655,2029-09-02,1905,9,5,5,"NYV","New York Voyagers","away",0,1,"Eastern Division","PBE",41,25,16,"41 - 25",10,277,366,594,133956,76729,66,0.635811756888246,42,24,"42 - 24","#0E1540",2,3,"2029"
1,100,660,2029-09-03,1905,9,2,3,"NYV","New York Voyagers","away",0,1,"Eastern Division","PBE",41,26,15,"41 - 26",17,294,368,597,135424,86436,67,0.610402956819616,41,26,"41 - 26","#0E1540",2,3,"2029"
1,100,665,2029-09-04,1905,9,6,7,"NYV","New York Voyagers","away",0,1,"Eastern Division","PBE",41,27,14,"41 - 27",8,302,374,604,139876,91204,68,0.60531417690843,41,27,"41 - 27","#0E1540",2,3,"2029"
1,100,670,2029-09-05,1905,9,2,4,"NYV","New York Voyagers","away",0,1,"Eastern Division","PBE",41,28,13,"41 - 28",5,307,376,608,141376,94249,69,0.60000424403183,41,28,"41 - 28","#0E1540",2,3,"2029"
1,100,675,2029-09-08,1905,9,3,10,"NYV","New York Voyagers","away",0,1,"Eastern Division","PBE",41,29,12,"41 - 29",5,312,379,618,143641,97344,70,0.59605784592402,42,28,"42 - 28","#0E1540",2,3,"2029"
1,100,680,2029-09-09,1905,9,5,12,"NYV","New York Voyagers","away",0,1,"Eastern Division","PBE",41,30,11,"41 - 30",6,318,384,630,147456,101124,71,0.593193338160753,42,29,"42 - 29","#0E1540",2,3,"2029"
1,100,685,2029-09-10,1905,9,5,6,"NYV","New York Voyagers","away",0,1,"Eastern Division","PBE",41,31,10,"41 - 31",20,338,389,636,151321,114244,72,0.569807768342967,41,31,"41 - 31","#0E1540",2,3,"2029"
1,100,690,2029-09-11,1905,9,12,12,"NYV","New York Voyagers","away",1,0,"Eastern Division","PBE",42,31,11,"42 - 31",9,347,401,648,160801,120409,73,0.571818214146012,42,31,"42 - 31","#0E1540",2,3,"2029"
1,100,697,2029-09-14,1905,9,5,8,"NYV","New York Voyagers","home",0,1,"Eastern Division","PBE",42,32,10,"42 - 32",17,364,406,656,164836,132496,74,0.554383651944628,41,33,"41 - 33","#0E1540",2,3,"2029"
1,100,702,2029-09-15,1905,9,3,5,"NYV","New York Voyagers","home",0,1,"Eastern Division","PBE",42,33,9,"42 - 33",6,370,409,661,167281,136900,75,0.54993901657237,41,34,"41 - 34","#0E1540",2,3,"2029"
1,100,707,2029-09-16,1905,9,5,7,"NYV","New York Voyagers","home",1,0,"Eastern Division","PBE",43,33,10,"43 - 33",2,372,414,668,171396,138384,76,0.553282975014526,42,34,"42 - 34","#0E1540",2,3,"2029"
1,100,712,2029-09-17,1905,9,7,7,"NYV","New York Voyagers","home",1,0,"Eastern Division","PBE",44,33,11,"44 - 33",3,375,421,675,177241,140625,77,0.5575965973083,43,34,"43 - 34","#0E1540",2,3,"2029"
1,100,714,2029-09-20,1905,9,0,2,"NYV","New York Voyagers","home",0,1,"Eastern Division","PBE",44,34,10,"44 - 34",8,383,421,677,177241,146689,78,0.547158336677677,43,35,"43 - 35","#0E1540",2,3,"2029"
1,100,719,2029-09-21,1905,9,9,11,"NYV","New York Voyagers","home",1,0,"Eastern Division","PBE",45,34,11,"45 - 34",2,385,430,688,184900,148225,79,0.555046904315197,44,35,"44 - 35","#0E1540",2,3,"2029"
1,100,724,2029-09-22,1905,9,5,9,"NYV","New York Voyagers","home",0,1,"Eastern Division","PBE",45,35,10,"45 - 35",6,391,435,697,189225,152881,80,0.553118039438069,44,36,"44 - 36","#0E1540",2,3,"2029"
1,100,730,2029-09-23,1905,10,9,11,"NYV","New York Voyagers","home",0,1,"Eastern Division","PBE",45,36,9,"45 - 36",11,402,444,708,197136,161604,81,0.549523331660813,45,36,"45 - 36","#0E1540",2,3,"2029"
1,100,738,2029-09-25,1905,9,13,14,"NYV","New York Voyagers","home",1,0,"Eastern Division","PBE",46,36,10,"46 - 36",1,403,457,722,208849,162409,82,0.562544106793658,46,36,"46 - 36","#0E1540",2,3,"2029"
1,100,743,2029-09-26,1905,9,4,8,"NYV","New York Voyagers","home",1,0,"Eastern Division","PBE",47,36,11,"47 - 36",2,405,461,730,212521,164025,83,0.564395850706155,47,36,"47 - 36","#0E1540",2,3,"2029"
1,100,748,2029-09-27,1905,9,5,6,"NYV","New York Voyagers","home",1,0,"Eastern Division","PBE",48,36,12,"48 - 36",3,408,466,736,217156,166464,84,0.566070590688702,48,36,"48 - 36","#0E1540",2,3,"2029"
1,100,752,2029-09-28,1905,9,2,5,"NYV","New York Voyagers","home",0,1,"Eastern Division","PBE",48,37,11,"48 - 37",6,414,468,741,219024,171396,85,0.560995850622407,48,37,"48 - 37","#0E1540",2,3,"2029"
1,100,755,2029-09-30,1905,9,0,3,"NYV","New York Voyagers","away",0,1,"Eastern Division","PBE",48,38,10,"48 - 38",4,418,468,744,219024,174724,86,0.556254253989862,48,38,"48 - 38","#0E1540",2,3,"2029"
1,100,760,2029-10-01,1905,9,10,14,"NYV","New York Voyagers","away",1,0,"Eastern Division","PBE",49,38,11,"49 - 38",1,419,478,758,228484,175561,87,0.565491467534557,49,38,"49 - 38","#0E1540",2,3,"2029"
1,100,765,2029-10-02,1905,11,9,13,"NYV","New York Voyagers","away",1,0,"Eastern Division","PBE",50,38,12,"50 - 38",8,427,487,771,237169,182329,88,0.565363839636899,50,38,"50 - 38","#0E1540",2,3,"2029"
1,100,770,2029-10-03,1905,9,13,17,"NYV","New York Voyagers","away",1,0,"Eastern Division","PBE",51,38,13,"51 - 38",5,432,500,788,250000,186624,89,0.572575030231962,51,38,"51 - 38","#0E1540",2,3,"2029"
1,100,773,2029-10-05,1905,9,8,13,"NYV","New York Voyagers","away",1,0,"Eastern Division","PBE",52,38,14,"52 - 38",3,435,508,801,258064,189225,90,0.576951367013273,52,38,"52 - 38","#0E1540",2,3,"2029"
1,100,777,2029-10-06,1905,9,6,14,"NYV","New York Voyagers","away",0,1,"Eastern Division","PBE",52,39,13,"52 - 39",14,449,514,815,264196,201601,91,0.567191287191631,52,39,"52 - 39","#0E1540",2,3,"2029"
1,100,782,2029-10-07,1905,9,0,5,"NYV","New York Voyagers","away",0,1,"Eastern Division","PBE",52,40,12,"52 - 40",3,452,514,820,264196,204304,92,0.563918890074707,52,40,"52 - 40","#0E1540",2,3,"2029"
1,100,787,2029-10-08,1905,9,7,13,"NYV","New York Voyagers","away",1,0,"Eastern Division","PBE",53,40,13,"53 - 40",5,457,521,833,271441,208849,93,0.565160632118095,53,40,"53 - 40","#0E1540",2,3,"2029"
1,100,792,2029-10-10,1905,11,4,11,"NYV","New York Voyagers","away",0,1,"Eastern Division","PBE",53,41,12,"53 - 41",5,462,525,844,275625,213444,94,0.563570784490532,53,41,"53 - 41","#0E1540",2,3,"2029"
1,100,796,2029-10-11,1905,9,4,10,"NYV","New York Voyagers","away",0,1,"Eastern Division","PBE",53,42,11,"53 - 42",6,468,529,854,279841,219024,95,0.560955368686919,53,42,"53 - 42","#0E1540",2,3,"2029"
1,100,801,2029-10-12,1905,9,7,5,"NYV","New York Voyagers","away",1,0,"Eastern Division","PBE",54,42,12,"54 - 42",3,471,536,859,287296,221841,96,0.564280341047694,54,42,"54 - 42","#0E1540",2,3,"2029"
1,100,806,2029-10-13,1905,9,3,8,"NYV","New York Voyagers","away",1,0,"Eastern Division","PBE",55,42,13,"55 - 42",1,472,539,867,290521,222784,97,0.565981239224243,55,42,"55 - 42","#0E1540",2,3,"2029"
1,100,815,2029-10-16,1905,9,8,11,"NYV","New York Voyagers","home",1,0,"Eastern Division","PBE",56,42,14,"56 - 42",4,476,547,878,299209,226576,98,0.569071008111681,56,42,"56 - 42","#0E1540",2,3,"2029"
1,100,820,2029-10-17,1905,9,10,13,"NYV","New York Voyagers","home",1,0,"Eastern Division","PBE",57,42,15,"57 - 42",3,479,557,891,310249,229441,99,0.574865200392818,57,42,"57 - 42","#0E1540",2,3,"2029"
1,100,825,2029-10-18,1905,9,10,13,"NYV","New York Voyagers","home",1,0,"Eastern Division","PBE",58,42,16,"58 - 42",4,483,567,904,321489,233289,100,0.579491255961844,58,42,"58 - 42","#0E1540",2,3,"2029"
2,100,2,2029-05-15,1905,9,3,7,"OBX","Outer Banks Aviators","away",0,1,"Eastern Division","PBE",0,1,-1,"0 - 1",5,5,3,7,9,25,1,0.264705882352941,0,1,"0 - 1","#FF6700",3,5,"2029"
2,100,7,2029-05-16,1905,11,4,9,"OBX","Outer Banks Aviators","away",0,1,"Eastern Division","PBE",0,2,-2,"0 - 2",5,10,7,16,49,100,2,0.328859060402685,1,1,"1 - 1","#FF6700",3,5,"2029"
2,100,12,2029-05-17,1905,9,4,11,"OBX","Outer Banks Aviators","away",0,1,"Eastern Division","PBE",0,3,-3,"0 - 3",5,15,11,27,121,225,3,0.34971098265896,1,2,"1 - 2","#FF6700",3,5,"2029"
2,100,17,2029-05-18,1905,9,7,10,"OBX","Outer Banks Aviators","away",1,0,"Eastern Division","PBE",1,3,-2,"1 - 3",4,19,18,37,324,361,4,0.472992700729927,2,2,"2 - 2","#FF6700",3,5,"2029"
2,100,23,2029-05-21,1905,9,6,8,"OBX","Outer Banks Aviators","home",1,0,"Eastern Division","PBE",2,3,-1,"2 - 3",4,23,24,45,576,529,5,0.521266968325792,3,2,"3 - 2","#FF6700",3,5,"2029"
2,100,28,2029-05-22,1905,9,3,6,"OBX","Outer Banks Aviators","home",0,1,"Eastern Division","PBE",2,4,-2,"2 - 4",5,28,27,51,729,784,6,0.481824190350297,3,3,"3 - 3","#FF6700",3,5,"2029"
2,100,33,2029-05-23,1905,9,7,12,"OBX","Outer Banks Aviators","home",1,0,"Eastern Division","PBE",3,4,-1,"3 - 4",6,34,34,63,1156,1156,7,0.5,4,3,"4 - 3","#FF6700",3,5,"2029"
2,100,37,2029-05-24,1905,11,2,8,"OBX","Outer Banks Aviators","home",0,1,"Eastern Division","PBE",3,5,-2,"3 - 5",3,37,36,71,1296,1369,8,0.486303939962477,4,4,"4 - 4","#FF6700",3,5,"2029"
2,100,41,2029-05-26,1905,9,5,10,"OBX","Outer Banks Aviators","away",1,0,"Eastern Division","PBE",4,5,-1,"4 - 5",0,37,41,81,1681,1369,9,0.551147540983607,5,4,"5 - 4","#FF6700",3,5,"2029"
2,100,45,2029-05-27,1905,9,10,14,"OBX","Outer Banks Aviators","away",1,0,"Eastern Division","PBE",5,5,0,"5 - 5",5,42,51,95,2601,1764,10,0.595876288659794,6,4,"6 - 4","#FF6700",3,5,"2029"
2,100,50,2029-05-28,1905,9,7,11,"OBX","Outer Banks Aviators","away",1,0,"Eastern Division","PBE",6,5,1,"6 - 5",3,45,58,106,3364,2025,11,0.62423455186491,7,4,"7 - 4","#FF6700",3,5,"2029"
2,100,55,2029-05-29,1905,9,4,9,"OBX","Outer Banks Aviators","away",1,0,"Eastern Division","PBE",7,5,2,"7 - 5",1,46,62,115,3844,2116,12,0.64496644295302,8,4,"8 - 4","#FF6700",3,5,"2029"
2,100,59,2029-06-01,1905,9,2,7,"OBX","Outer Banks Aviators","home",0,1,"Eastern Division","PBE",7,6,1,"7 - 6",3,49,64,122,4096,2401,13,0.630444820686471,8,5,"8 - 5","#FF6700",3,5,"2029"
2,100,64,2029-06-02,1905,9,8,7,"OBX","Outer Banks Aviators","home",1,0,"Eastern Division","PBE",8,6,2,"8 - 6",4,53,72,129,5184,2809,14,0.64856749655949,9,5,"9 - 5","#FF6700",3,5,"2029"
2,100,69,2029-06-03,1905,9,5,10,"OBX","Outer Banks Aviators","home",0,1,"Eastern Division","PBE",8,7,1,"8 - 7",12,65,77,139,5929,4225,15,0.583907819578491,9,6,"9 - 6","#FF6700",3,5,"2029"
2,100,74,2029-06-04,1905,9,4,10,"OBX","Outer Banks Aviators","home",0,1,"Eastern Division","PBE",8,8,0,"8 - 8",13,78,81,149,6561,6084,16,0.518861209964413,8,8,"8 - 8","#FF6700",3,5,"2029"
2,100,80,2029-06-06,1905,9,4,9,"OBX","Outer Banks Aviators","home",1,0,"Eastern Division","PBE",9,8,1,"9 - 8",1,79,85,158,7225,6241,17,0.536536462201099,9,8,"9 - 8","#FF6700",3,5,"2029"
2,100,84,2029-06-07,1905,10,3,6,"OBX","Outer Banks Aviators","home",1,0,"Eastern Division","PBE",10,8,2,"10 - 8",2,81,88,164,7744,6561,18,0.541349178608878,10,8,"10 - 8","#FF6700",3,5,"2029"
2,100,89,2029-06-08,1905,9,4,10,"OBX","Outer Banks Aviators","home",1,0,"Eastern Division","PBE",11,8,3,"11 - 8",3,84,92,174,8464,7056,19,0.545360824742268,10,9,"10 - 9","#FF6700",3,5,"2029"
2,100,97,2029-06-11,1905,12,5,8,"OBX","Outer Banks Aviators","away",0,1,"Eastern Division","PBE",11,9,2,"11 - 9",6,90,97,182,9409,8100,20,0.537380775601119,11,9,"11 - 9","#FF6700",3,5,"2029"
2,100,102,2029-06-12,1905,9,3,7,"OBX","Outer Banks Aviators","away",1,0,"Eastern Division","PBE",12,9,3,"12 - 9",1,91,100,189,10000,8281,21,0.547016027569608,11,10,"11 - 10","#FF6700",3,5,"2029"
2,100,107,2029-06-13,1905,9,4,8,"OBX","Outer Banks Aviators","away",0,1,"Eastern Division","PBE",12,10,2,"12 - 10",6,97,104,197,10816,9409,22,0.534783683559951,12,10,"12 - 10","#FF6700",3,5,"2029"
2,100,117,2029-06-16,1905,9,13,16,"OBX","Outer Banks Aviators","away",1,0,"Eastern Division","PBE",13,10,3,"13 - 10",3,100,117,213,13689,10000,23,0.577863143231035,13,10,"13 - 10","#FF6700",3,5,"2029"
2,100,122,2029-06-17,1905,9,3,6,"OBX","Outer Banks Aviators","away",0,1,"Eastern Division","PBE",13,11,2,"13 - 11",5,105,120,219,14400,11025,24,0.566371681415929,14,10,"14 - 10","#FF6700",3,5,"2029"
2,100,127,2029-06-18,1905,9,5,11,"OBX","Outer Banks Aviators","away",1,0,"Eastern Division","PBE",14,11,3,"14 - 11",0,105,125,230,15625,11025,25,0.586303939962477,15,10,"15 - 10","#FF6700",3,5,"2029"
2,100,132,2029-06-19,1905,13,9,18,"OBX","Outer Banks Aviators","away",1,0,"Eastern Division","PBE",15,11,4,"15 - 11",7,112,134,248,17956,12544,26,0.58872131147541,15,11,"15 - 11","#FF6700",3,5,"2029"
2,100,136,2029-06-22,1905,9,9,12,"OBX","Outer Banks Aviators","home",1,0,"Eastern Division","PBE",16,11,5,"16 - 11",3,115,143,260,20449,13225,27,0.607263764328562,16,11,"16 - 11","#FF6700",3,5,"2029"
2,100,141,2029-06-23,1905,9,5,14,"OBX","Outer Banks Aviators","home",1,0,"Eastern Division","PBE",17,11,6,"17 - 11",2,117,148,274,21904,13689,28,0.615401904868935,17,11,"17 - 11","#FF6700",3,5,"2029"
2,100,146,2029-06-24,1905,9,5,8,"OBX","Outer Banks Aviators","home",1,0,"Eastern Division","PBE",18,11,7,"18 - 11",2,119,153,282,23409,14161,29,0.623076923076923,18,11,"18 - 11","#FF6700",3,5,"2029"
2,100,151,2029-06-25,1905,9,7,10,"OBX","Outer Banks Aviators","home",1,0,"Eastern Division","PBE",19,11,8,"19 - 11",4,123,160,292,25600,15129,30,0.628544771538707,19,11,"19 - 11","#FF6700",3,5,"2029"
2,100,155,2029-06-27,1905,9,7,14,"OBX","Outer Banks Aviators","away",0,1,"Eastern Division","PBE",19,12,7,"19 - 12",11,134,167,306,27889,17956,31,0.60833242447377,19,12,"19 - 12","#FF6700",3,5,"2029"
2,100,159,2029-06-28,1905,9,0,3,"OBX","Outer Banks Aviators","away",0,1,"Eastern Division","PBE",19,13,6,"19 - 13",9,143,167,309,27889,20449,32,0.576958086805412,18,14,"18 - 14","#FF6700",3,5,"2029"
2,100,164,2029-06-29,1905,9,7,11,"OBX","Outer Banks Aviators","away",1,0,"Eastern Division","PBE",20,13,7,"20 - 13",5,148,174,320,30276,21904,33,0.58022230739747,19,14,"19 - 14","#FF6700",3,5,"2029"
2,100,169,2029-06-30,1905,9,6,8,"OBX","Outer Banks Aviators","away",1,0,"Eastern Division","PBE",21,13,8,"21 - 13",2,150,180,328,32400,22500,34,0.590163934426229,20,14,"20 - 14","#FF6700",3,5,"2029"
2,100,174,2029-07-03,1905,9,4,8,"OBX","Outer Banks Aviators","home",0,1,"Eastern Division","PBE",21,14,7,"21 - 14",5,155,184,336,33856,24025,35,0.584924241115392,20,15,"20 - 15","#FF6700",3,5,"2029"
2,100,179,2029-07-04,1905,9,8,14,"OBX","Outer Banks Aviators","home",1,0,"Eastern Division","PBE",22,14,8,"22 - 14",0,155,192,350,36864,24025,36,0.605429552135854,22,14,"22 - 14","#FF6700",3,5,"2029"
2,100,184,2029-07-05,1905,9,26,19,"OBX","Outer Banks Aviators","home",1,0,"Eastern Division","PBE",23,14,9,"23 - 14",0,155,218,369,47524,24025,37,0.664216131602119,25,12,"25 - 12","#FF6700",3,5,"2029"
2,100,189,2029-07-06,1905,9,13,17,"OBX","Outer Banks Aviators","home",1,0,"Eastern Division","PBE",24,14,10,"24 - 14",3,158,231,386,53361,24964,38,0.681276731567188,26,12,"26 - 12","#FF6700",3,5,"2029"
2,100,196,2029-07-09,1905,10,8,9,"OBX","Outer Banks Aviators","home",1,0,"Eastern Division","PBE",25,14,11,"25 - 14",5,163,239,395,57121,26569,39,0.682530768311626,27,12,"27 - 12","#FF6700",3,5,"2029"
2,100,201,2029-07-10,1905,9,6,11,"OBX","Outer Banks Aviators","home",1,0,"Eastern Division","PBE",26,14,12,"26 - 14",1,164,245,406,60025,26896,40,0.690569597680653,28,12,"28 - 12","#FF6700",3,5,"2029"
2,100,206,2029-07-11,1905,9,5,10,"OBX","Outer Banks Aviators","home",1,0,"Eastern Division","PBE",27,14,13,"27 - 14",1,165,250,416,62500,27225,41,0.696572861521315,29,12,"29 - 12","#FF6700",3,5,"2029"
2,100,211,2029-07-12,1905,9,1,4,"OBX","Outer Banks Aviators","home",0,1,"Eastern Division","PBE",27,15,12,"27 - 15",6,171,251,420,63001,29241,42,0.682996899460116,29,13,"29 - 13","#FF6700",3,5,"2029"
2,100,218,2029-07-15,1905,9,5,6,"OBX","Outer Banks Aviators","away",0,1,"Eastern Division","PBE",27,16,11,"27 - 16",15,186,256,426,65536,34596,43,0.654496065193944,28,15,"28 - 15","#FF6700",3,5,"2029"
2,100,223,2029-07-16,1905,9,4,6,"OBX","Outer Banks Aviators","away",1,0,"Eastern Division","PBE",28,16,12,"28 - 16",3,189,260,432,67600,35721,44,0.654271638873027,29,15,"29 - 15","#FF6700",3,5,"2029"
2,100,228,2029-07-17,1905,9,1,8,"OBX","Outer Banks Aviators","away",1,0,"Eastern Division","PBE",29,16,13,"29 - 16",0,189,261,440,68121,35721,45,0.65600624024961,30,15,"30 - 15","#FF6700",3,5,"2029"
2,100,233,2029-07-18,1905,9,1,6,"OBX","Outer Banks Aviators","away",0,1,"Eastern Division","PBE",29,17,12,"29 - 17",3,192,262,446,68644,36864,46,0.650604693482959,30,16,"30 - 16","#FF6700",3,5,"2029"
2,100,237,2029-07-21,1905,9,3,7,"OBX","Outer Banks Aviators","away",1,0,"Eastern Division","PBE",30,17,13,"30 - 17",2,194,265,453,70225,37636,47,0.651069431954089,31,16,"31 - 16","#FF6700",3,5,"2029"
2,100,242,2029-07-22,1905,9,1,5,"OBX","Outer Banks Aviators","away",0,1,"Eastern Division","PBE",30,18,12,"30 - 18",3,197,266,458,70756,38809,48,0.645790170218592,31,17,"31 - 17","#FF6700",3,5,"2029"
2,100,247,2029-07-23,1905,9,5,10,"OBX","Outer Banks Aviators","away",1,0,"Eastern Division","PBE",31,18,13,"31 - 18",2,199,271,468,73441,39601,49,0.649678880416129,32,17,"32 - 17","#FF6700",3,5,"2029"
2,100,252,2029-07-24,1905,9,5,8,"OBX","Outer Banks Aviators","away",0,1,"Eastern Division","PBE",31,19,12,"31 - 19",6,205,276,476,76176,42025,50,0.644461552778741,32,18,"32 - 18","#FF6700",3,5,"2029"
2,100,254,2029-08-12,1905,9,10,16,"OBX","Outer Banks Aviators","away",1,0,"Eastern Division","PBE",32,19,13,"32 - 19",3,208,286,492,81796,43264,51,0.654054054054054,33,18,"33 - 18","#FF6700",3,5,"2029"
2,100,259,2029-08-13,1905,9,1,3,"OBX","Outer Banks Aviators","away",0,1,"Eastern Division","PBE",32,20,12,"32 - 20",5,213,287,495,82369,45369,52,0.644827694186538,34,18,"34 - 18","#FF6700",3,5,"2029"
2,100,264,2029-08-14,1905,9,4,9,"OBX","Outer Banks Aviators","away",1,0,"Eastern Division","PBE",33,20,13,"33 - 20",0,213,291,504,84681,45369,53,0.651141868512111,35,18,"35 - 18","#FF6700",3,5,"2029"
2,100,269,2029-08-15,1905,9,5,6,"OBX","Outer Banks Aviators","away",1,0,"Eastern Division","PBE",34,20,14,"34 - 20",3,216,296,510,87616,46656,54,0.652526215443279,35,19,"35 - 19","#FF6700",3,5,"2029"
2,100,275,2029-08-17,1905,9,1,7,"OBX","Outer Banks Aviators","away",0,1,"Eastern Division","PBE",34,21,13,"34 - 21",2,218,297,517,88209,47524,55,0.649871438780547,36,19,"36 - 19","#FF6700",3,5,"2029"
2,100,279,2029-08-18,1905,9,1,5,"OBX","Outer Banks Aviators","away",0,1,"Eastern Division","PBE",34,22,12,"34 - 22",2,220,298,522,88804,48400,56,0.647240605230168,36,20,"36 - 20","#FF6700",3,5,"2029"
2,100,284,2029-08-19,1905,9,6,10,"OBX","Outer Banks Aviators","away",1,0,"Eastern Division","PBE",35,22,13,"35 - 22",5,225,304,532,92416,50625,57,0.646080494403702,37,20,"37 - 20","#FF6700",3,5,"2029"
2,100,289,2029-08-20,1905,9,7,10,"OBX","Outer Banks Aviators","away",1,0,"Eastern Division","PBE",36,22,14,"36 - 22",3,228,311,542,96721,51984,58,0.650421976396221,38,20,"38 - 20","#FF6700",3,5,"2029"
2,100,292,2029-08-22,1905,9,3,6,"OBX","Outer Banks Aviators","away",0,1,"Eastern Division","PBE",36,23,13,"36 - 23",4,232,314,548,98596,53824,59,0.646870489437082,38,21,"38 - 21","#FF6700",3,5,"2029"
2,100,296,2029-08-23,1905,9,9,13,"OBX","Outer Banks Aviators","away",0,1,"Eastern Division","PBE",36,24,12,"36 - 24",10,242,323,561,104329,58564,60,0.640475649659592,38,22,"38 - 22","#FF6700",3,5,"2029"
2,100,301,2029-08-24,1905,9,1,5,"OBX","Outer Banks Aviators","away",1,0,"Eastern Division","PBE",37,24,13,"37 - 24",0,242,324,566,104976,58564,61,0.641898006603889,39,22,"39 - 22","#FF6700",3,5,"2029"
2,100,636,2029-08-27,1905,9,5,7,"OBX","Outer Banks Aviators","home",0,1,"Eastern Division","PBE",37,25,12,"37 - 25",6,248,329,573,108241,61504,62,0.637668267106542,40,22,"40 - 22","#FF6700",3,5,"2029"
2,100,641,2029-08-28,1905,9,5,8,"OBX","Outer Banks Aviators","home",1,0,"Eastern Division","PBE",38,25,13,"38 - 25",3,251,334,581,111556,63001,63,0.639080644144893,40,23,"40 - 23","#FF6700",3,5,"2029"
2,100,646,2029-08-29,1905,9,1,7,"OBX","Outer Banks Aviators","home",0,1,"Eastern Division","PBE",38,26,12,"38 - 26",3,254,335,588,112225,64516,64,0.634968682988101,41,23,"41 - 23","#FF6700",3,5,"2029"
2,100,651,2029-08-30,1905,9,0,4,"OBX","Outer Banks Aviators","home",0,1,"Eastern Division","PBE",38,27,11,"38 - 27",7,261,335,592,112225,68121,65,0.622276069333393,40,25,"40 - 25","#FF6700",3,5,"2029"
2,100,656,2029-09-02,1905,12,2,8,"OBX","Outer Banks Aviators","home",0,1,"Eastern Division","PBE",38,28,10,"38 - 28",3,264,337,600,113569,69696,66,0.619698251166344,41,25,"41 - 25","#FF6700",3,5,"2029"
2,100,661,2029-09-03,1905,9,7,14,"OBX","Outer Banks Aviators","home",1,0,"Eastern Division","PBE",39,28,11,"39 - 28",5,269,344,614,118336,72361,67,0.62054463363346,42,25,"42 - 25","#FF6700",3,5,"2029"
2,100,666,2029-09-04,1905,9,3,6,"OBX","Outer Banks Aviators","home",1,0,"Eastern Division","PBE",40,28,12,"40 - 28",2,271,347,620,120409,73441,68,0.621145215372711,42,26,"42 - 26","#FF6700",3,5,"2029"
2,100,671,2029-09-05,1905,9,5,9,"OBX","Outer Banks Aviators","home",1,0,"Eastern Division","PBE",41,28,13,"41 - 28",2,273,352,629,123904,74529,69,0.62441227013652,43,26,"43 - 26","#FF6700",3,5,"2029"
2,100,674,2029-09-08,1905,9,4,9,"OBX","Outer Banks Aviators","away",0,1,"Eastern Division","PBE",41,29,12,"41 - 29",6,279,356,638,126736,77841,70,0.619502681142064,43,27,"43 - 27","#FF6700",3,5,"2029"
2,100,679,2029-09-09,1905,12,2,5,"OBX","Outer Banks Aviators","away",0,1,"Eastern Division","PBE",41,30,11,"41 - 30",3,282,358,643,128164,79524,71,0.617098725010593,44,27,"44 - 27","#FF6700",3,5,"2029"
2,100,684,2029-09-10,1905,9,1,5,"OBX","Outer Banks Aviators","away",0,1,"Eastern Division","PBE",41,31,10,"41 - 31",5,287,359,648,128881,82369,72,0.610087573964497,44,28,"44 - 28","#FF6700",3,5,"2029"
2,100,689,2029-09-11,1905,9,0,3,"OBX","Outer Banks Aviators","away",0,1,"Eastern Division","PBE",41,32,9,"41 - 32",2,289,359,651,128881,83521,73,0.606778655568215,44,29,"44 - 29","#FF6700",3,5,"2029"
2,100,698,2029-09-14,1905,9,1,5,"OBX","Outer Banks Aviators","home",0,1,"Eastern Division","PBE",41,33,8,"41 - 33",2,291,360,656,129600,84681,74,0.60481330589273,45,29,"45 - 29","#FF6700",3,5,"2029"
2,100,703,2029-09-15,1905,9,5,8,"OBX","Outer Banks Aviators","home",1,0,"Eastern Division","PBE",42,33,9,"42 - 33",4,295,365,664,133225,87025,75,0.604880817253121,45,30,"45 - 30","#FF6700",3,5,"2029"
2,100,708,2029-09-16,1905,9,7,10,"OBX","Outer Banks Aviators","home",0,1,"Eastern Division","PBE",42,34,8,"42 - 34",9,304,372,674,138384,92416,76,0.599584055459272,46,30,"46 - 30","#FF6700",3,5,"2029"
2,100,713,2029-09-17,1905,9,4,9,"OBX","Outer Banks Aviators","home",0,1,"Eastern Division","PBE",42,35,7,"42 - 35",7,311,376,683,141376,96721,77,0.593774806066435,46,31,"46 - 31","#FF6700",3,5,"2029"
2,100,715,2029-09-20,1905,9,5,7,"OBX","Outer Banks Aviators","home",1,0,"Eastern Division","PBE",43,35,8,"43 - 35",4,315,381,690,145161,99225,78,0.593982470354276,46,32,"46 - 32","#FF6700",3,5,"2029"
2,100,720,2029-09-21,1905,9,4,8,"OBX","Outer Banks Aviators","home",1,0,"Eastern Division","PBE",44,35,9,"44 - 35",3,318,385,698,148225,101124,79,0.594447942442119,47,32,"47 - 32","#FF6700",3,5,"2029"
2,100,725,2029-09-22,1905,9,3,5,"OBX","Outer Banks Aviators","home",0,1,"Eastern Division","PBE",44,36,8,"44 - 36",4,322,388,703,150544,103684,80,0.59216136696194,47,33,"47 - 33","#FF6700",3,5,"2029"
2,100,734,2029-09-25,1905,9,3,6,"OBX","Outer Banks Aviators","home",0,1,"Eastern Division","PBE",44,37,7,"44 - 37",12,334,391,709,152881,111556,81,0.578137703876538,47,34,"47 - 34","#FF6700",3,5,"2029"
2,100,739,2029-09-26,1905,9,1,7,"OBX","Outer Banks Aviators","home",0,1,"Eastern Division","PBE",44,38,6,"44 - 38",4,338,392,716,153664,114244,82,0.573570031503352,47,35,"47 - 35","#FF6700",3,5,"2029"
2,100,744,2029-09-27,1905,9,12,15,"OBX","Outer Banks Aviators","home",1,0,"Eastern Division","PBE",45,38,7,"45 - 38",5,343,404,731,163216,117649,83,0.581119042956581,48,35,"48 - 35","#FF6700",3,5,"2029"
2,100,749,2029-09-28,1905,9,7,12,"OBX","Outer Banks Aviators","home",0,1,"Eastern Division","PBE",45,39,6,"45 - 39",8,351,411,743,168921,123201,84,0.578254975660854,49,35,"49 - 35","#FF6700",3,5,"2029"
2,100,754,2029-09-30,1905,9,6,8,"OBX","Outer Banks Aviators","away",1,0,"Eastern Division","PBE",46,39,7,"46 - 39",4,355,417,751,173889,126025,85,0.579796208246364,49,36,"49 - 36","#FF6700",3,5,"2029"
2,100,759,2029-10-01,1905,9,1,6,"OBX","Outer Banks Aviators","away",0,1,"Eastern Division","PBE",46,40,6,"46 - 40",2,357,418,757,174724,127449,86,0.578225056507365,50,36,"50 - 36","#FF6700",3,5,"2029"
2,100,764,2029-10-02,1905,9,1,4,"OBX","Outer Banks Aviators","away",0,1,"Eastern Division","PBE",46,41,5,"46 - 41",4,361,419,761,175561,130321,87,0.573950085327022,50,37,"50 - 37","#FF6700",3,5,"2029"
2,100,769,2029-10-03,1905,11,3,9,"OBX","Outer Banks Aviators","away",0,1,"Eastern Division","PBE",46,42,4,"46 - 42",4,365,422,770,178084,133225,88,0.572048993122589,50,38,"50 - 38","#FF6700",3,5,"2029"
2,100,775,2029-10-05,1905,9,0,6,"OBX","Outer Banks Aviators","home",0,1,"Eastern Division","PBE",46,43,3,"46 - 43",2,367,422,776,178084,134689,89,0.569371397147452,51,38,"51 - 38","#FF6700",3,5,"2029"
2,100,780,2029-10-06,1905,9,8,9,"OBX","Outer Banks Aviators","home",1,0,"Eastern Division","PBE",47,43,4,"47 - 43",7,374,430,785,184900,139876,90,0.569315466660098,51,39,"51 - 39","#FF6700",3,5,"2029"
2,100,785,2029-10-07,1905,9,2,8,"OBX","Outer Banks Aviators","home",0,1,"Eastern Division","PBE",47,44,3,"47 - 44",4,378,432,793,186624,142884,91,0.566371681415929,52,39,"52 - 39","#FF6700",3,5,"2029"
2,100,790,2029-10-08,1905,10,2,6,"OBX","Outer Banks Aviators","home",1,0,"Eastern Division","PBE",48,44,4,"48 - 44",1,379,434,799,188356,143641,92,0.567342475986229,52,40,"52 - 40","#FF6700",3,5,"2029"
2,100,791,2029-10-10,1905,9,4,11,"OBX","Outer Banks Aviators","away",1,0,"Eastern Division","PBE",49,44,5,"49 - 44",3,382,438,810,191844,145924,93,0.567975651926766,53,40,"53 - 40","#FF6700",3,5,"2029"
2,100,795,2029-10-11,1905,9,6,12,"OBX","Outer Banks Aviators","away",1,0,"Eastern Division","PBE",50,44,6,"50 - 44",2,384,444,822,197136,147456,94,0.572085248641872,54,40,"54 - 40","#FF6700",3,5,"2029"
2,100,800,2029-10-12,1905,12,2,7,"OBX","Outer Banks Aviators","away",0,1,"Eastern Division","PBE",50,45,5,"50 - 45",4,388,446,829,198916,150544,95,0.569209637726778,54,41,"54 - 41","#FF6700",3,5,"2029"
2,100,805,2029-10-13,1905,9,1,6,"OBX","Outer Banks Aviators","away",0,1,"Eastern Division","PBE",50,46,4,"50 - 46",2,390,447,835,199809,152100,96,0.56778599012813,55,41,"55 - 41","#FF6700",3,5,"2029"
2,100,811,2029-10-15,1905,15,7,18,"OBX","Outer Banks Aviators","home",1,0,"Eastern Division","PBE",51,46,5,"51 - 46",6,396,454,853,206116,156816,97,0.567919059217705,55,42,"55 - 42","#FF6700",3,5,"2029"
2,100,816,2029-10-16,1905,9,7,11,"OBX","Outer Banks Aviators","home",1,0,"Eastern Division","PBE",52,46,6,"52 - 46",1,397,461,864,212521,157609,98,0.574179342393213,56,42,"56 - 42","#FF6700",3,5,"2029"
2,100,821,2029-10-17,1905,9,3,8,"OBX","Outer Banks Aviators","home",0,1,"Eastern Division","PBE",52,47,5,"52 - 47",9,406,464,872,215296,164836,99,0.566371681415929,56,43,"56 - 43","#FF6700",3,5,"2029"
2,100,826,2029-10-18,1905,9,6,6,"OBX","Outer Banks Aviators","home",1,0,"Eastern Division","PBE",53,47,6,"53 - 47",2,408,470,878,220900,166464,100,0.570264660629279,57,43,"57 - 43","#FF6700",3,5,"2029"
3,100,3,2029-05-15,1905,9,0,2,"PRO","Providence Crabs","home",0,1,"Eastern Division","PBE",0,1,-1,"0 - 1",19,19,0,2,0,361,1,0,0,1,"0 - 1","#005CAD",5,9,"2029"
3,100,8,2029-05-16,1905,9,1,8,"PRO","Providence Crabs","home",0,1,"Eastern Division","PBE",0,2,-2,"0 - 2",9,28,1,10,1,784,2,0.00127388535031847,0,2,"0 - 2","#005CAD",5,9,"2029"
3,100,13,2029-05-17,1905,9,1,7,"PRO","Providence Crabs","home",1,0,"Eastern Division","PBE",1,2,-1,"1 - 2",0,28,2,17,4,784,3,0.0050761421319797,0,3,"0 - 3","#005CAD",5,9,"2029"
3,100,18,2029-05-18,1905,9,2,7,"PRO","Providence Crabs","home",0,1,"Eastern Division","PBE",1,3,-2,"1 - 3",7,35,4,24,16,1225,4,0.0128928283642224,0,4,"0 - 4","#005CAD",5,9,"2029"
3,100,22,2029-05-21,1905,9,7,13,"PRO","Providence Crabs","away",0,1,"Eastern Division","PBE",1,4,-3,"1 - 4",11,46,11,37,121,2116,5,0.05409029950827,0,5,"0 - 5","#005CAD",5,9,"2029"
3,100,27,2029-05-22,1905,9,2,6,"PRO","Providence Crabs","away",0,1,"Eastern Division","PBE",1,5,-4,"1 - 5",4,50,13,43,169,2500,6,0.0633195953540652,0,6,"0 - 6","#005CAD",5,9,"2029"
3,100,32,2029-05-23,1905,9,0,1,"PRO","Providence Crabs","away",0,1,"Eastern Division","PBE",1,6,-5,"1 - 6",6,56,13,44,169,3136,7,0.0511346444780635,0,7,"0 - 7","#005CAD",5,9,"2029"
3,100,36,2029-05-24,1905,9,2,9,"PRO","Providence Crabs","away",0,1,"Eastern Division","PBE",1,7,-6,"1 - 7",5,61,15,53,225,3721,8,0.0570197668525089,0,8,"0 - 8","#005CAD",5,9,"2029"
3,100,41,2029-05-26,1905,9,0,6,"PRO","Providence Crabs","home",0,1,"Eastern Division","PBE",1,8,-7,"1 - 8",5,66,15,59,225,4356,9,0.0491159135559921,0,9,"0 - 9","#005CAD",5,9,"2029"
3,100,45,2029-05-27,1905,9,5,9,"PRO","Providence Crabs","home",0,1,"Eastern Division","PBE",1,9,-8,"1 - 9",10,76,20,68,400,5776,10,0.0647668393782383,1,9,"1 - 9","#005CAD",5,9,"2029"
3,100,50,2029-05-28,1905,9,3,10,"PRO","Providence Crabs","home",0,1,"Eastern Division","PBE",1,10,-9,"1 - 10",7,83,23,78,529,6889,11,0.0713130223779995,1,10,"1 - 10","#005CAD",5,9,"2029"
3,100,55,2029-05-29,1905,9,1,5,"PRO","Providence Crabs","home",0,1,"Eastern Division","PBE",1,11,-10,"1 - 11",4,87,24,83,576,7569,12,0.0707182320441989,1,11,"1 - 11","#005CAD",5,9,"2029"
3,100,60,2029-06-01,1905,9,4,10,"PRO","Providence Crabs","away",0,1,"Eastern Division","PBE",1,12,-11,"1 - 12",7,94,28,93,784,8836,13,0.0814968814968815,1,12,"1 - 12","#005CAD",5,9,"2029"
3,100,65,2029-06-02,1905,9,0,3,"PRO","Providence Crabs","away",0,1,"Eastern Division","PBE",1,13,-12,"1 - 13",6,100,28,96,784,10000,14,0.072700296735905,1,13,"1 - 13","#005CAD",5,9,"2029"
3,100,70,2029-06-03,1905,9,0,0,"PRO","Providence Crabs","away",0,1,"Eastern Division","PBE",1,14,-13,"1 - 14",3,103,28,96,784,10609,15,0.0688141841481612,1,14,"1 - 14","#005CAD",5,9,"2029"
3,100,75,2029-06-04,1905,9,4,9,"PRO","Providence Crabs","away",1,0,"Eastern Division","PBE",2,14,-12,"2 - 14",2,105,32,105,1024,11025,16,0.0849863059175035,1,15,"1 - 15","#005CAD",5,9,"2029"
3,100,79,2029-06-06,1905,9,8,9,"PRO","Providence Crabs","home",1,0,"Eastern Division","PBE",3,14,-11,"3 - 14",3,108,40,114,1600,11664,17,0.120627261761158,2,15,"2 - 15","#005CAD",5,9,"2029"
3,100,83,2029-06-07,1905,9,0,1,"PRO","Providence Crabs","home",0,1,"Eastern Division","PBE",3,15,-12,"3 - 15",8,116,40,115,1600,13456,18,0.106269925611052,2,16,"2 - 16","#005CAD",5,9,"2029"
3,100,88,2029-06-08,1905,9,0,8,"PRO","Providence Crabs","home",0,1,"Eastern Division","PBE",3,16,-13,"3 - 16",6,122,40,123,1600,14884,19,0.0970638194612958,2,17,"2 - 17","#005CAD",5,9,"2029"
3,100,93,2029-06-09,1905,9,6,10,"PRO","Providence Crabs","home",0,1,"Eastern Division","PBE",3,17,-14,"3 - 17",9,131,46,133,2116,17161,20,0.109768117445661,2,18,"2 - 18","#005CAD",5,9,"2029"
3,100,100,2029-06-11,1905,9,3,8,"PRO","Providence Crabs","away",0,1,"Eastern Division","PBE",3,18,-15,"3 - 18",6,137,49,141,2401,18769,21,0.113415210203118,2,19,"2 - 19","#005CAD",5,9,"2029"
3,100,105,2029-06-12,1905,10,3,9,"PRO","Providence Crabs","away",0,1,"Eastern Division","PBE",3,19,-16,"3 - 19",4,141,52,150,2704,19881,22,0.119725481514279,3,19,"3 - 19","#005CAD",5,9,"2029"
3,100,110,2029-06-13,1905,9,6,12,"PRO","Providence Crabs","away",1,0,"Eastern Division","PBE",4,19,-15,"4 - 19",3,144,58,162,3364,20736,23,0.139585062240664,3,20,"3 - 20","#005CAD",5,9,"2029"
3,100,114,2029-06-14,1905,9,9,15,"PRO","Providence Crabs","away",1,0,"Eastern Division","PBE",5,19,-14,"5 - 19",7,151,67,177,4489,22801,24,0.164492488090876,4,20,"4 - 20","#005CAD",5,9,"2029"
3,100,121,2029-06-17,1905,9,3,5,"PRO","Providence Crabs","home",0,1,"Eastern Division","PBE",5,20,-15,"5 - 20",5,156,70,182,4900,24336,25,0.167601587084416,4,21,"4 - 21","#005CAD",5,9,"2029"
3,100,126,2029-06-18,1905,9,6,11,"PRO","Providence Crabs","home",0,1,"Eastern Division","PBE",5,21,-16,"5 - 21",8,164,76,193,5776,26896,26,0.176787463271303,5,21,"5 - 21","#005CAD",5,9,"2029"
3,100,131,2029-06-19,1905,9,8,11,"PRO","Providence Crabs","home",1,0,"Eastern Division","PBE",6,21,-15,"6 - 21",3,167,84,204,7056,27889,27,0.201917298612105,5,22,"5 - 22","#005CAD",5,9,"2029"
3,100,135,2029-06-22,1905,9,2,3,"PRO","Providence Crabs","home",0,1,"Eastern Division","PBE",6,22,-16,"6 - 22",6,173,86,207,7396,29929,28,0.198151373074347,6,22,"6 - 22","#005CAD",5,9,"2029"
3,100,140,2029-06-23,1905,9,5,8,"PRO","Providence Crabs","home",0,1,"Eastern Division","PBE",6,23,-17,"6 - 23",8,181,91,215,8281,32761,29,0.201768919643292,6,23,"6 - 23","#005CAD",5,9,"2029"
3,100,145,2029-06-24,1905,9,0,5,"PRO","Providence Crabs","home",0,1,"Eastern Division","PBE",6,24,-18,"6 - 24",5,186,91,220,8281,34596,30,0.193133847983768,6,24,"6 - 24","#005CAD",5,9,"2029"
3,100,150,2029-06-25,1905,9,5,10,"PRO","Providence Crabs","home",0,1,"Eastern Division","PBE",6,25,-19,"6 - 25",8,194,96,230,9216,37636,31,0.196704516349355,6,25,"6 - 25","#005CAD",5,9,"2029"
3,100,156,2029-06-27,1905,9,2,4,"PRO","Providence Crabs","home",0,1,"Eastern Division","PBE",6,26,-20,"6 - 26",5,199,98,234,9604,39601,32,0.19518341631948,6,26,"6 - 26","#005CAD",5,9,"2029"
3,100,161,2029-06-28,1905,9,4,6,"PRO","Providence Crabs","home",1,0,"Eastern Division","PBE",7,26,-19,"7 - 26",3,202,102,240,10404,40804,33,0.203171379471958,7,26,"7 - 26","#005CAD",5,9,"2029"
3,100,166,2029-06-29,1905,9,0,6,"PRO","Providence Crabs","home",0,1,"Eastern Division","PBE",7,27,-20,"7 - 27",4,206,102,246,10404,42436,34,0.196896290688872,7,27,"7 - 27","#005CAD",5,9,"2029"
3,100,171,2029-06-30,1905,9,5,9,"PRO","Providence Crabs","home",1,0,"Eastern Division","PBE",8,27,-19,"8 - 27",4,210,107,255,11449,44100,35,0.206106320545824,7,28,"7 - 28","#005CAD",5,9,"2029"
3,100,174,2029-07-03,1905,9,5,12,"PRO","Providence Crabs","away",1,0,"Eastern Division","PBE",9,27,-18,"9 - 27",4,214,112,267,12544,45796,36,0.215015426808365,8,28,"8 - 28","#005CAD",5,9,"2029"
3,100,179,2029-07-04,1905,9,0,3,"PRO","Providence Crabs","away",0,1,"Eastern Division","PBE",9,28,-19,"9 - 28",8,222,112,270,12544,49284,37,0.202885424079705,8,29,"8 - 29","#005CAD",5,9,"2029"
3,100,184,2029-07-05,1905,9,0,2,"PRO","Providence Crabs","away",0,1,"Eastern Division","PBE",9,29,-20,"9 - 29",26,248,112,272,12544,61504,38,0.169403630077787,6,32,"6 - 32","#005CAD",5,9,"2029"
3,100,189,2029-07-06,1905,9,3,5,"PRO","Providence Crabs","away",0,1,"Eastern Division","PBE",9,30,-21,"9 - 30",13,261,115,277,13225,68121,39,0.162577139625796,6,33,"6 - 33","#005CAD",5,9,"2029"
3,100,195,2029-07-09,1905,9,3,9,"PRO","Providence Crabs","away",1,0,"Eastern Division","PBE",10,30,-20,"10 - 30",2,263,118,286,13924,69169,40,0.167571275558711,7,33,"7 - 33","#005CAD",5,9,"2029"
3,100,200,2029-07-10,1905,9,3,9,"PRO","Providence Crabs","away",0,1,"Eastern Division","PBE",10,31,-21,"10 - 31",5,268,121,295,14641,71824,41,0.169328630081536,7,34,"7 - 34","#005CAD",5,9,"2029"
3,100,205,2029-07-11,1905,9,4,8,"PRO","Providence Crabs","away",0,1,"Eastern Division","PBE",10,32,-22,"10 - 32",21,289,125,303,15625,83521,42,0.157595868718859,7,35,"7 - 35","#005CAD",5,9,"2029"
3,100,210,2029-07-12,1905,9,1,6,"PRO","Providence Crabs","away",0,1,"Eastern Division","PBE",10,33,-23,"10 - 33",7,296,126,309,15876,87616,43,0.153403161597032,7,36,"7 - 36","#005CAD",5,9,"2029"
3,100,215,2029-07-15,1905,9,2,8,"PRO","Providence Crabs","home",0,1,"Eastern Division","PBE",10,34,-24,"10 - 34",9,305,128,317,16384,93025,44,0.149750020565036,7,37,"7 - 37","#005CAD",5,9,"2029"
3,100,220,2029-07-16,1905,9,4,9,"PRO","Providence Crabs","home",0,1,"Eastern Division","PBE",10,35,-25,"10 - 35",7,312,132,326,17424,97344,45,0.151819322459222,7,38,"7 - 38","#005CAD",5,9,"2029"
3,100,225,2029-07-17,1905,9,5,9,"PRO","Providence Crabs","home",1,0,"Eastern Division","PBE",11,35,-24,"11 - 35",2,314,137,335,18769,98596,46,0.159919907979381,7,39,"7 - 39","#005CAD",5,9,"2029"
3,100,230,2029-07-18,1905,9,4,10,"PRO","Providence Crabs","home",1,0,"Eastern Division","PBE",12,35,-23,"12 - 35",3,317,141,345,19881,100489,47,0.165165738971505,8,39,"8 - 39","#005CAD",5,9,"2029"
3,100,238,2029-07-21,1905,9,4,9,"PRO","Providence Crabs","away",1,0,"Eastern Division","PBE",13,35,-22,"13 - 35",3,320,145,354,21025,102400,48,0.170346364188779,8,40,"8 - 40","#005CAD",5,9,"2029"
3,100,243,2029-07-22,1905,12,2,8,"PRO","Providence Crabs","away",0,1,"Eastern Division","PBE",13,36,-23,"13 - 36",3,323,147,362,21609,104329,49,0.171584430434023,8,41,"8 - 41","#005CAD",5,9,"2029"
3,100,248,2029-07-23,1905,9,10,14,"PRO","Providence Crabs","away",1,0,"Eastern Division","PBE",14,36,-22,"14 - 36",5,328,157,376,24649,107584,50,0.186405813979869,9,41,"9 - 41","#005CAD",5,9,"2029"
3,100,253,2029-07-24,1905,9,2,7,"PRO","Providence Crabs","away",0,1,"Eastern Division","PBE",14,37,-23,"14 - 37",4,332,159,383,25281,110224,51,0.186568761300321,10,41,"10 - 41","#005CAD",5,9,"2029"
3,100,254,2029-08-12,1905,9,3,7,"PRO","Providence Crabs","home",0,1,"Eastern Division","PBE",14,38,-24,"14 - 38",10,342,162,390,26244,116964,52,0.183257918552036,10,42,"10 - 42","#005CAD",5,9,"2029"
3,100,259,2029-08-13,1905,9,5,9,"PRO","Providence Crabs","home",1,0,"Eastern Division","PBE",15,38,-23,"15 - 38",1,343,167,399,27889,117649,53,0.191626929049458,10,43,"10 - 43","#005CAD",5,9,"2029"
3,100,264,2029-08-14,1905,9,0,6,"PRO","Providence Crabs","home",0,1,"Eastern Division","PBE",15,39,-24,"15 - 39",4,347,167,405,27889,120409,54,0.188060526777165,10,44,"10 - 44","#005CAD",5,9,"2029"
3,100,269,2029-08-15,1905,9,3,6,"PRO","Providence Crabs","home",0,1,"Eastern Division","PBE",15,40,-25,"15 - 40",5,352,170,411,28900,123904,55,0.189131174576582,10,45,"10 - 45","#005CAD",5,9,"2029"
3,100,274,2029-08-17,1905,9,1,8,"PRO","Providence Crabs","home",0,1,"Eastern Division","PBE",15,41,-26,"15 - 41",6,358,171,419,29241,128164,56,0.185769194117087,10,46,"10 - 46","#005CAD",5,9,"2029"
3,100,278,2029-08-18,1905,9,8,10,"PRO","Providence Crabs","home",1,0,"Eastern Division","PBE",16,41,-25,"16 - 41",5,363,179,429,32041,131769,57,0.195598559306514,11,46,"11 - 46","#005CAD",5,9,"2029"
3,100,283,2029-08-19,1905,9,1,7,"PRO","Providence Crabs","home",0,1,"Eastern Division","PBE",16,42,-26,"16 - 42",7,370,180,436,32400,136900,58,0.19137625516834,11,47,"11 - 47","#005CAD",5,9,"2029"
3,100,288,2029-08-20,1905,9,5,8,"PRO","Providence Crabs","home",1,0,"Eastern Division","PBE",17,42,-25,"17 - 42",2,372,185,444,34225,138384,59,0.198280506810189,12,47,"12 - 47","#005CAD",5,9,"2029"
3,100,293,2029-08-22,1905,10,7,15,"PRO","Providence Crabs","away",1,0,"Eastern Division","PBE",18,42,-24,"18 - 42",2,374,192,459,36864,139876,60,0.208577571574064,13,47,"13 - 47","#005CAD",5,9,"2029"
3,100,297,2029-08-23,1905,9,2,9,"PRO","Providence Crabs","away",0,1,"Eastern Division","PBE",18,43,-25,"18 - 43",5,379,194,468,37636,143641,61,0.207615968931525,13,48,"13 - 48","#005CAD",5,9,"2029"
3,100,628,2029-08-24,1905,9,4,7,"PRO","Providence Crabs","away",0,1,"Eastern Division","PBE",18,44,-26,"18 - 44",6,385,198,475,39204,148225,62,0.20916720464816,13,49,"13 - 49","#005CAD",5,9,"2029"
3,100,632,2029-08-25,1905,9,0,2,"PRO","Providence Crabs","away",0,1,"Eastern Division","PBE",18,45,-27,"18 - 45",11,396,198,477,39204,156816,63,0.2,13,50,"13 - 50","#005CAD",5,9,"2029"
3,100,634,2029-08-27,1905,9,4,7,"PRO","Providence Crabs","away",0,1,"Eastern Division","PBE",18,46,-28,"18 - 46",11,407,202,484,40804,165649,64,0.197643047085777,13,51,"13 - 51","#005CAD",5,9,"2029"
3,100,639,2029-08-28,1905,9,1,3,"PRO","Providence Crabs","away",0,1,"Eastern Division","PBE",18,47,-29,"18 - 47",9,416,203,487,41209,173056,65,0.192327258301636,13,52,"13 - 52","#005CAD",5,9,"2029"
3,100,644,2029-08-29,1905,9,4,9,"PRO","Providence Crabs","away",1,0,"Eastern Division","PBE",19,47,-28,"19 - 47",2,418,207,496,42849,174724,66,0.196940796881966,13,53,"13 - 53","#005CAD",5,9,"2029"
3,100,649,2029-08-30,1905,9,4,7,"PRO","Providence Crabs","away",0,1,"Eastern Division","PBE",19,48,-29,"19 - 48",7,425,211,503,44521,180625,67,0.197742798006627,13,54,"13 - 54","#005CAD",5,9,"2029"
3,100,657,2029-09-02,1905,9,9,8,"PRO","Providence Crabs","home",1,0,"Eastern Division","PBE",20,48,-28,"20 - 48",7,432,220,511,48400,186624,68,0.205936415004425,14,54,"14 - 54","#005CAD",5,9,"2029"
3,100,662,2029-09-03,1905,9,7,10,"PRO","Providence Crabs","home",1,0,"Eastern Division","PBE",21,48,-27,"21 - 48",1,433,227,521,51529,187489,69,0.215586273837117,15,54,"15 - 54","#005CAD",5,9,"2029"
3,100,667,2029-09-04,1905,9,2,8,"PRO","Providence Crabs","home",1,0,"Eastern Division","PBE",22,48,-26,"22 - 48",0,433,229,529,52441,187489,70,0.218567915642062,15,55,"15 - 55","#005CAD",5,9,"2029"
3,100,672,2029-09-05,1905,9,1,5,"PRO","Providence Crabs","home",0,1,"Eastern Division","PBE",22,49,-27,"22 - 49",2,435,230,534,52900,189225,71,0.218482188951988,16,55,"16 - 55","#005CAD",5,9,"2029"
3,100,676,2029-09-08,1905,12,5,10,"PRO","Providence Crabs","away",0,1,"Eastern Division","PBE",22,50,-28,"22 - 50",6,441,235,544,55225,194481,72,0.221160084259089,16,56,"16 - 56","#005CAD",5,9,"2029"
3,100,681,2029-09-09,1905,9,4,8,"PRO","Providence Crabs","away",1,0,"Eastern Division","PBE",23,50,-27,"23 - 50",0,441,239,552,57121,194481,73,0.227029196906225,17,56,"17 - 56","#005CAD",5,9,"2029"
3,100,686,2029-09-10,1905,9,1,3,"PRO","Providence Crabs","away",0,1,"Eastern Division","PBE",23,51,-28,"23 - 51",7,448,240,555,57600,200704,74,0.222993062438057,17,57,"17 - 57","#005CAD",5,9,"2029"
3,100,691,2029-09-11,1905,9,3,7,"PRO","Providence Crabs","away",0,1,"Eastern Division","PBE",23,52,-29,"23 - 52",5,453,243,562,59049,205209,75,0.223452080920918,17,58,"17 - 58","#005CAD",5,9,"2029"
3,100,695,2029-09-14,1905,9,14,15,"PRO","Providence Crabs","away",1,0,"Eastern Division","PBE",24,52,-28,"24 - 52",5,458,257,577,66049,209764,76,0.239470220765519,18,58,"18 - 58","#005CAD",5,9,"2029"
3,100,700,2029-09-15,1905,9,7,10,"PRO","Providence Crabs","away",1,0,"Eastern Division","PBE",25,52,-27,"25 - 52",3,461,264,587,69696,212521,77,0.246958900420598,19,58,"19 - 58","#005CAD",5,9,"2029"
3,100,705,2029-09-16,1905,9,1,7,"PRO","Providence Crabs","away",0,1,"Eastern Division","PBE",25,53,-28,"25 - 53",6,467,265,594,70225,218089,78,0.243571245239565,19,59,"19 - 59","#005CAD",5,9,"2029"
3,100,710,2029-09-17,1905,9,2,6,"PRO","Providence Crabs","away",0,1,"Eastern Division","PBE",25,54,-29,"25 - 54",4,471,267,600,71289,221841,79,0.243199263125576,19,60,"19 - 60","#005CAD",5,9,"2029"
3,100,715,2029-09-20,1905,9,4,7,"PRO","Providence Crabs","away",0,1,"Eastern Division","PBE",25,55,-30,"25 - 55",5,476,271,607,73441,226576,80,0.244789461930491,20,60,"20 - 60","#005CAD",5,9,"2029"
3,100,720,2029-09-21,1905,9,3,8,"PRO","Providence Crabs","away",0,1,"Eastern Division","PBE",25,56,-31,"25 - 56",4,480,274,615,75076,230400,81,0.245767261585198,20,61,"20 - 61","#005CAD",5,9,"2029"
3,100,725,2029-09-22,1905,9,4,6,"PRO","Providence Crabs","away",1,0,"Eastern Division","PBE",26,56,-30,"26 - 56",3,483,278,621,77284,233289,82,0.248843267122383,20,62,"20 - 62","#005CAD",5,9,"2029"
3,100,735,2029-09-25,1905,9,3,8,"PRO","Providence Crabs","home",0,1,"Eastern Division","PBE",26,57,-31,"26 - 57",8,491,281,629,78961,241081,83,0.246720742902494,20,63,"20 - 63","#005CAD",5,9,"2029"
3,100,740,2029-09-26,1905,9,4,7,"PRO","Providence Crabs","home",0,1,"Eastern Division","PBE",26,58,-32,"26 - 58",5,496,285,636,81225,246016,84,0.248211562732054,21,63,"21 - 63","#005CAD",5,9,"2029"
3,100,745,2029-09-27,1905,9,3,8,"PRO","Providence Crabs","home",0,1,"Eastern Division","PBE",26,59,-33,"26 - 59",6,502,288,644,82944,252004,85,0.247632468323441,21,64,"21 - 64","#005CAD",5,9,"2029"
3,100,755,2029-09-30,1905,9,4,10,"PRO","Providence Crabs","home",1,0,"Eastern Division","PBE",27,59,-32,"27 - 59",0,502,292,654,85264,252004,86,0.252807856066985,22,64,"22 - 64","#005CAD",5,9,"2029"
3,100,760,2029-10-01,1905,9,1,2,"PRO","Providence Crabs","home",0,1,"Eastern Division","PBE",27,60,-33,"27 - 60",10,512,293,656,85849,262144,87,0.246697491041486,21,66,"21 - 66","#005CAD",5,9,"2029"
3,100,765,2029-10-02,1905,11,8,8,"PRO","Providence Crabs","home",0,1,"Eastern Division","PBE",27,61,-34,"27 - 61",9,521,301,664,90601,271441,88,0.25024997099784,22,66,"22 - 66","#005CAD",5,9,"2029"
3,100,770,2029-10-03,1905,9,5,13,"PRO","Providence Crabs","home",0,1,"Eastern Division","PBE",27,62,-35,"27 - 62",13,534,306,677,93636,285156,89,0.247196350503707,22,67,"22 - 67","#005CAD",5,9,"2029"
3,100,774,2029-10-05,1905,9,8,10,"PRO","Providence Crabs","away",1,0,"Eastern Division","PBE",28,62,-34,"28 - 62",4,538,314,687,98596,289444,90,0.254087207504381,23,67,"23 - 67","#005CAD",5,9,"2029"
3,100,778,2029-10-06,1905,9,1,6,"PRO","Providence Crabs","away",0,1,"Eastern Division","PBE",28,63,-35,"28 - 63",3,541,315,693,99225,292681,91,0.253185712900542,23,68,"23 - 68","#005CAD",5,9,"2029"
3,100,783,2029-10-07,1905,9,1,5,"PRO","Providence Crabs","away",0,1,"Eastern Division","PBE",28,64,-36,"28 - 64",6,547,316,698,99856,299209,92,0.250224900705399,23,69,"23 - 69","#005CAD",5,9,"2029"
3,100,788,2029-10-08,1905,9,0,5,"PRO","Providence Crabs","away",0,1,"Eastern Division","PBE",28,65,-37,"28 - 65",4,551,316,703,99856,303601,93,0.247500972842211,23,70,"23 - 70","#005CAD",5,9,"2029"
3,100,794,2029-10-10,1905,10,6,12,"PRO","Providence Crabs","home",1,0,"Eastern Division","PBE",29,65,-36,"29 - 65",5,556,322,715,103684,309136,94,0.251160312000388,24,70,"24 - 70","#005CAD",5,9,"2029"
3,100,798,2029-10-11,1905,9,1,9,"PRO","Providence Crabs","home",0,1,"Eastern Division","PBE",29,66,-37,"29 - 66",4,560,323,724,104329,313600,95,0.249633310921233,24,71,"24 - 71","#005CAD",5,9,"2029"
3,100,803,2029-10-12,1905,9,4,8,"PRO","Providence Crabs","home",1,0,"Eastern Division","PBE",30,66,-36,"30 - 66",3,563,327,732,106929,316969,96,0.252251720932866,24,72,"24 - 72","#005CAD",5,9,"2029"
3,100,808,2029-10-13,1905,9,10,12,"PRO","Providence Crabs","home",1,0,"Eastern Division","PBE",31,66,-35,"31 - 66",6,569,337,744,113569,323761,97,0.25968719273775,25,72,"25 - 72","#005CAD",5,9,"2029"
3,100,815,2029-10-16,1905,9,4,9,"PRO","Providence Crabs","away",0,1,"Eastern Division","PBE",31,67,-36,"31 - 67",8,577,341,753,116281,332929,98,0.258856659468845,25,73,"25 - 73","#005CAD",5,9,"2029"
3,100,820,2029-10-17,1905,9,3,7,"PRO","Providence Crabs","away",0,1,"Eastern Division","PBE",31,68,-37,"31 - 68",10,587,344,760,118336,344569,99,0.255637765848284,25,74,"25 - 74","#005CAD",5,9,"2029"
3,100,825,2029-10-18,1905,9,4,10,"PRO","Providence Crabs","away",0,1,"Eastern Division","PBE",31,69,-38,"31 - 69",10,597,348,770,121104,356409,100,0.253614037733004,25,75,"25 - 75","#005CAD",5,9,"2029"
9,100,4,2029-05-15,1905,9,7,12,"SAS","San Antonio Sloths","away",1,0,"Western Division","PBE",1,0,1,"1 - 0",2,2,7,12,49,4,1,0.924528301886792,1,0,"1 - 0","#87795E",3,7,"2029"
9,100,9,2029-05-16,1905,9,5,10,"SAS","San Antonio Sloths","away",1,0,"Western Division","PBE",2,0,2,"2 - 0",1,3,12,22,144,9,2,0.941176470588235,2,0,"2 - 0","#87795E",3,7,"2029"
9,100,14,2029-05-17,1905,9,5,15,"SAS","San Antonio Sloths","away",0,1,"Western Division","PBE",2,1,1,"2 - 1",7,10,17,37,289,100,3,0.74293059125964,2,1,"2 - 1","#87795E",3,7,"2029"
9,100,19,2029-05-18,1905,9,1,5,"SAS","San Antonio Sloths","away",0,1,"Western Division","PBE",2,2,0,"2 - 2",6,16,18,42,324,256,4,0.558620689655172,2,2,"2 - 2","#87795E",3,7,"2029"
9,100,25,2029-05-21,1905,9,6,11,"SAS","San Antonio Sloths","home",0,1,"Western Division","PBE",2,3,-1,"2 - 3",8,24,24,53,576,576,5,0.5,2,3,"2 - 3","#87795E",3,7,"2029"
9,100,30,2029-05-22,1905,9,4,9,"SAS","San Antonio Sloths","home",0,1,"Western Division","PBE",2,4,-2,"2 - 4",7,31,28,62,784,961,6,0.449283667621777,3,3,"3 - 3","#87795E",3,7,"2029"
9,100,35,2029-05-23,1905,9,6,13,"SAS","San Antonio Sloths","home",1,0,"Western Division","PBE",3,4,-1,"3 - 4",4,35,34,75,1156,1225,7,0.485510289794204,3,4,"3 - 4","#87795E",3,7,"2029"
9,100,39,2029-05-24,1905,11,4,11,"SAS","San Antonio Sloths","home",1,0,"Western Division","PBE",4,4,0,"4 - 4",3,38,38,86,1444,1444,8,0.5,4,4,"4 - 4","#87795E",3,7,"2029"
9,100,47,2029-05-27,1905,9,1,7,"SAS","San Antonio Sloths","away",0,1,"Western Division","PBE",4,5,-1,"4 - 5",12,50,39,93,1521,2500,9,0.378264113404626,3,6,"3 - 6","#87795E",3,7,"2029"
9,100,52,2029-05-28,1905,9,8,10,"SAS","San Antonio Sloths","away",0,1,"Western Division","PBE",4,6,-2,"4 - 6",15,65,47,103,2209,4225,10,0.343332297171278,3,7,"3 - 7","#87795E",3,7,"2029"
9,100,57,2029-05-29,1905,9,2,7,"SAS","San Antonio Sloths","away",0,1,"Western Division","PBE",4,7,-3,"4 - 7",8,73,49,110,2401,5329,11,0.310608020698577,3,8,"3 - 8","#87795E",3,7,"2029"
9,100,63,2029-06-01,1905,9,0,2,"SAS","San Antonio Sloths","home",0,1,"Western Division","PBE",4,8,-4,"4 - 8",3,76,49,112,2401,5776,12,0.293628470099058,4,8,"4 - 8","#87795E",3,7,"2029"
9,100,68,2029-06-02,1905,9,5,8,"SAS","San Antonio Sloths","home",0,1,"Western Division","PBE",4,9,-5,"4 - 9",9,85,54,120,2916,7225,13,0.287545606942116,4,9,"4 - 9","#87795E",3,7,"2029"
9,100,73,2029-06-03,1905,9,1,4,"SAS","San Antonio Sloths","home",0,1,"Western Division","PBE",4,10,-6,"4 - 10",4,89,55,124,3025,7921,14,0.276356659967111,4,10,"4 - 10","#87795E",3,7,"2029"
9,100,78,2029-06-04,1905,9,6,9,"SAS","San Antonio Sloths","home",0,1,"Western Division","PBE",4,11,-7,"4 - 11",7,96,61,133,3721,9216,15,0.287624642498261,4,11,"4 - 11","#87795E",3,7,"2029"
9,100,81,2029-06-06,1905,9,2,5,"SAS","San Antonio Sloths","away",0,1,"Western Division","PBE",4,12,-8,"4 - 12",3,99,63,138,3969,9801,16,0.288235294117647,5,11,"5 - 11","#87795E",3,7,"2029"
9,100,85,2029-06-07,1905,9,0,6,"SAS","San Antonio Sloths","away",0,1,"Western Division","PBE",4,13,-9,"4 - 13",1,100,63,144,3969,10000,17,0.284129143102584,5,12,"5 - 12","#87795E",3,7,"2029"
9,100,90,2029-06-08,1905,9,5,10,"SAS","San Antonio Sloths","away",0,1,"Western Division","PBE",4,14,-10,"4 - 14",11,111,68,154,4624,12321,18,0.272882856299793,5,13,"5 - 13","#87795E",3,7,"2029"
9,100,94,2029-06-09,1905,9,1,1,"SAS","San Antonio Sloths","away",1,0,"Western Division","PBE",5,14,-9,"5 - 14",0,111,69,155,4761,12321,19,0.278714436248683,5,14,"5 - 14","#87795E",3,7,"2029"
9,100,100,2029-06-11,1905,9,6,9,"SAS","San Antonio Sloths","home",1,0,"Western Division","PBE",6,14,-8,"6 - 14",3,114,75,164,5625,12996,20,0.302078298695022,6,14,"6 - 14","#87795E",3,7,"2029"
9,100,105,2029-06-12,1905,10,4,11,"SAS","San Antonio Sloths","home",1,0,"Western Division","PBE",7,14,-7,"7 - 14",3,117,79,175,6241,13689,21,0.313146011038635,7,14,"7 - 14","#87795E",3,7,"2029"
9,100,110,2029-06-13,1905,9,3,9,"SAS","San Antonio Sloths","home",0,1,"Western Division","PBE",7,15,-8,"7 - 15",6,123,82,184,6724,15129,22,0.307692307692308,7,15,"7 - 15","#87795E",3,7,"2029"
9,100,114,2029-06-14,1905,9,7,11,"SAS","San Antonio Sloths","home",0,1,"Western Division","PBE",7,16,-9,"7 - 16",9,132,89,195,7921,17424,23,0.312527125665812,7,16,"7 - 16","#87795E",3,7,"2029"
9,100,119,2029-06-16,1905,9,7,10,"SAS","San Antonio Sloths","away",1,0,"Western Division","PBE",8,16,-8,"8 - 16",2,134,96,205,9216,17956,24,0.339172677756514,8,16,"8 - 16","#87795E",3,7,"2029"
9,100,124,2029-06-17,1905,9,11,16,"SAS","San Antonio Sloths","away",1,0,"Western Division","PBE",9,16,-7,"9 - 16",3,137,107,221,11449,18769,25,0.378880137666292,9,16,"9 - 16","#87795E",3,7,"2029"
9,100,129,2029-06-18,1905,9,7,8,"SAS","San Antonio Sloths","away",1,0,"Western Division","PBE",10,16,-6,"10 - 16",2,139,114,229,12996,19321,26,0.402141287867067,10,16,"10 - 16","#87795E",3,7,"2029"
9,100,134,2029-06-19,1905,9,5,11,"SAS","San Antonio Sloths","away",0,1,"Western Division","PBE",10,17,-7,"10 - 17",10,149,119,240,14161,22201,27,0.389445025026126,11,16,"11 - 16","#87795E",3,7,"2029"
9,100,138,2029-06-22,1905,9,6,9,"SAS","San Antonio Sloths","home",1,0,"Western Division","PBE",11,17,-6,"11 - 17",2,151,125,249,15625,22801,28,0.406625722167283,11,17,"11 - 17","#87795E",3,7,"2029"
9,100,143,2029-06-23,1905,9,6,11,"SAS","San Antonio Sloths","home",1,0,"Western Division","PBE",12,17,-5,"12 - 17",5,156,131,260,17161,24336,29,0.413547967322939,12,17,"12 - 17","#87795E",3,7,"2029"
9,100,148,2029-06-24,1905,9,5,5,"SAS","San Antonio Sloths","home",0,1,"Western Division","PBE",12,18,-6,"12 - 18",7,163,136,265,18496,26569,30,0.410429379784755,12,18,"12 - 18","#87795E",3,7,"2029"
9,100,153,2029-06-25,1905,10,10,13,"SAS","San Antonio Sloths","home",1,0,"Western Division","PBE",13,18,-5,"13 - 18",8,171,146,278,21316,29241,31,0.421623118460352,13,18,"13 - 18","#87795E",3,7,"2029"
9,100,158,2029-06-27,1905,9,2,8,"SAS","San Antonio Sloths","home",0,1,"Western Division","PBE",13,19,-6,"13 - 19",5,176,148,286,21904,30976,32,0.414220877458396,13,19,"13 - 19","#87795E",3,7,"2029"
9,100,163,2029-06-28,1905,9,1,2,"SAS","San Antonio Sloths","home",1,0,"Western Division","PBE",14,19,-5,"14 - 19",0,176,149,288,22201,30976,33,0.4174925249638,14,19,"14 - 19","#87795E",3,7,"2029"
9,100,168,2029-06-29,1905,9,6,10,"SAS","San Antonio Sloths","home",1,0,"Western Division","PBE",15,19,-4,"15 - 19",2,178,155,298,24025,31684,34,0.431258863020338,15,19,"15 - 19","#87795E",3,7,"2029"
9,100,173,2029-06-30,1905,9,1,5,"SAS","San Antonio Sloths","home",0,1,"Western Division","PBE",15,20,-5,"15 - 20",3,181,156,303,24336,32761,35,0.42622204318966,15,20,"15 - 20","#87795E",3,7,"2029"
9,100,175,2029-07-03,1905,9,3,6,"SAS","San Antonio Sloths","away",0,1,"Western Division","PBE",15,21,-6,"15 - 21",6,187,159,309,25281,34969,36,0.419601659751037,15,21,"15 - 21","#87795E",3,7,"2029"
9,100,180,2029-07-04,1905,9,12,13,"SAS","San Antonio Sloths","away",1,0,"Western Division","PBE",16,21,-5,"16 - 21",4,191,171,322,29241,36481,37,0.444919509448891,16,21,"16 - 21","#87795E",3,7,"2029"
9,100,185,2029-07-05,1905,9,3,5,"SAS","San Antonio Sloths","away",0,1,"Western Division","PBE",16,22,-6,"16 - 22",8,199,174,327,30276,39601,38,0.433275612862601,16,22,"16 - 22","#87795E",3,7,"2029"
9,100,190,2029-07-06,1905,9,3,7,"SAS","San Antonio Sloths","away",0,1,"Western Division","PBE",16,23,-7,"16 - 23",12,211,177,334,31329,44521,39,0.413038892551088,16,23,"16 - 23","#87795E",3,7,"2029"
9,100,198,2029-07-09,1905,9,3,9,"SAS","San Antonio Sloths","away",0,1,"Western Division","PBE",16,24,-8,"16 - 24",4,215,180,343,32400,46225,40,0.4120826709062,16,24,"16 - 24","#87795E",3,7,"2029"
9,100,203,2029-07-10,1905,9,1,2,"SAS","San Antonio Sloths","away",0,1,"Western Division","PBE",16,25,-9,"16 - 25",2,217,181,345,32761,47089,41,0.410281778334377,17,24,"17 - 24","#87795E",3,7,"2029"
9,100,208,2029-07-11,1905,9,6,11,"SAS","San Antonio Sloths","away",1,0,"Western Division","PBE",17,25,-8,"17 - 25",4,221,187,356,34969,48841,42,0.417241379310345,18,24,"18 - 24","#87795E",3,7,"2029"
9,100,213,2029-07-12,1905,9,0,4,"SAS","San Antonio Sloths","away",0,1,"Western Division","PBE",17,26,-9,"17 - 26",10,231,187,360,34969,53361,43,0.395890410958904,17,26,"17 - 26","#87795E",3,7,"2029"
9,100,217,2029-07-15,1905,9,8,12,"SAS","San Antonio Sloths","home",1,0,"Western Division","PBE",18,26,-8,"18 - 26",1,232,195,372,38025,53824,44,0.413994708706682,18,26,"18 - 26","#87795E",3,7,"2029"
9,100,222,2029-07-16,1905,9,13,9,"SAS","San Antonio Sloths","home",1,0,"Western Division","PBE",19,26,-7,"19 - 26",3,235,208,381,43264,55225,45,0.439277482764573,20,25,"20 - 25","#87795E",3,7,"2029"
9,100,227,2029-07-17,1905,9,7,7,"SAS","San Antonio Sloths","home",0,1,"Western Division","PBE",19,27,-8,"19 - 27",8,243,215,388,46225,59049,46,0.43909227349583,20,26,"20 - 26","#87795E",3,7,"2029"
9,100,232,2029-07-18,1905,9,7,8,"SAS","San Antonio Sloths","home",1,0,"Western Division","PBE",20,27,-7,"20 - 27",1,244,222,396,49284,59536,47,0.452894688476383,21,26,"21 - 26","#87795E",3,7,"2029"
9,100,237,2029-07-21,1905,9,2,7,"SAS","San Antonio Sloths","home",0,1,"Western Division","PBE",20,28,-8,"20 - 28",3,247,224,403,50176,61009,48,0.451283896209021,22,26,"22 - 26","#87795E",3,7,"2029"
9,100,242,2029-07-22,1905,9,3,6,"SAS","San Antonio Sloths","home",1,0,"Western Division","PBE",21,28,-7,"21 - 28",1,248,227,409,51529,61504,49,0.455875717710757,22,27,"22 - 27","#87795E",3,7,"2029"
9,100,247,2029-07-23,1905,9,2,5,"SAS","San Antonio Sloths","home",0,1,"Western Division","PBE",21,29,-8,"21 - 29",5,253,229,414,52441,64009,50,0.450330613997424,23,27,"23 - 27","#87795E",3,7,"2029"
9,100,252,2029-07-24,1905,9,6,9,"SAS","San Antonio Sloths","home",1,0,"Western Division","PBE",22,29,-7,"22 - 29",5,258,235,423,55225,66564,51,0.453448176764732,23,28,"23 - 28","#87795E",3,7,"2029"
9,100,256,2029-08-12,1905,9,3,10,"SAS","San Antonio Sloths","home",0,1,"Western Division","PBE",22,30,-8,"22 - 30",8,266,238,433,56644,70756,52,0.444615384615385,23,29,"23 - 29","#87795E",3,7,"2029"
9,100,261,2029-08-13,1905,9,5,10,"SAS","San Antonio Sloths","home",1,0,"Western Division","PBE",23,30,-7,"23 - 30",1,267,243,443,59049,71289,53,0.453045159508355,24,29,"24 - 29","#87795E",3,7,"2029"
9,100,266,2029-08-14,1905,9,2,5,"SAS","San Antonio Sloths","home",0,1,"Western Division","PBE",23,31,-8,"23 - 31",4,271,245,448,60025,73441,54,0.449740008691352,24,30,"24 - 30","#87795E",3,7,"2029"
9,100,271,2029-08-15,1905,9,2,5,"SAS","San Antonio Sloths","home",0,1,"Western Division","PBE",23,32,-9,"23 - 32",13,284,247,453,61009,80656,55,0.430656831256838,24,31,"24 - 31","#87795E",3,7,"2029"
9,100,281,2029-08-18,1905,9,6,11,"SAS","San Antonio Sloths","home",1,0,"Western Division","PBE",24,32,-8,"24 - 32",2,286,253,464,64009,81796,56,0.439004149377593,25,31,"25 - 31","#87795E",3,7,"2029"
9,100,286,2029-08-19,1905,9,2,7,"SAS","San Antonio Sloths","home",0,1,"Western Division","PBE",24,33,-9,"24 - 33",3,289,255,471,65025,83521,57,0.437743190661479,25,32,"25 - 32","#87795E",3,7,"2029"
9,100,291,2029-08-20,1905,9,7,7,"SAS","San Antonio Sloths","home",1,0,"Western Division","PBE",25,33,-8,"25 - 33",4,293,262,478,68644,85849,58,0.444317865534361,26,32,"26 - 32","#87795E",3,7,"2029"
9,100,298,2029-08-23,1905,11,4,9,"SAS","San Antonio Sloths","away",1,0,"Western Division","PBE",26,33,-7,"26 - 33",3,296,266,487,70756,87616,59,0.446770893844872,26,33,"26 - 33","#87795E",3,7,"2029"
9,100,629,2029-08-24,1905,9,4,6,"SAS","San Antonio Sloths","away",1,0,"Western Division","PBE",27,33,-6,"27 - 33",2,298,270,493,72900,88804,60,0.45082372730421,27,33,"27 - 33","#87795E",3,7,"2029"
9,100,633,2029-08-25,1905,11,7,12,"SAS","San Antonio Sloths","away",1,0,"Western Division","PBE",28,33,-5,"28 - 33",6,304,277,505,76729,92416,61,0.453628543557303,28,33,"28 - 33","#87795E",3,7,"2029"
9,100,637,2029-08-27,1905,9,13,14,"SAS","San Antonio Sloths","home",1,0,"Western Division","PBE",29,33,-4,"29 - 33",6,310,290,519,84100,96100,62,0.466703662597114,29,33,"29 - 33","#87795E",3,7,"2029"
9,100,642,2029-08-28,1905,9,18,17,"SAS","San Antonio Sloths","home",1,0,"Western Division","PBE",30,33,-3,"30 - 33",9,319,308,536,94864,101761,63,0.482461538461538,30,33,"30 - 33","#87795E",3,7,"2029"
9,100,647,2029-08-29,1905,9,6,9,"SAS","San Antonio Sloths","home",0,1,"Western Division","PBE",30,34,-4,"30 - 34",15,334,314,545,98596,111556,64,0.469165175682363,30,34,"30 - 34","#87795E",3,7,"2029"
9,100,652,2029-08-30,1905,9,2,7,"SAS","San Antonio Sloths","home",0,1,"Western Division","PBE",30,35,-5,"30 - 35",11,345,316,552,99856,119025,65,0.456211365993394,30,35,"30 - 35","#87795E",3,7,"2029"
9,100,656,2029-09-02,1905,12,3,6,"SAS","San Antonio Sloths","away",1,0,"Western Division","PBE",31,35,-4,"31 - 35",2,347,319,558,101761,120409,66,0.458032137552325,30,36,"30 - 36","#87795E",3,7,"2029"
9,100,661,2029-09-03,1905,9,5,8,"SAS","San Antonio Sloths","away",0,1,"Western Division","PBE",31,36,-5,"31 - 36",7,354,324,566,104976,125316,67,0.455838674378615,31,36,"31 - 36","#87795E",3,7,"2029"
9,100,666,2029-09-04,1905,9,2,2,"SAS","San Antonio Sloths","away",0,1,"Western Division","PBE",31,37,-6,"31 - 37",3,357,326,568,106276,127449,68,0.454705316076586,31,37,"31 - 37","#87795E",3,7,"2029"
9,100,671,2029-09-05,1905,9,2,5,"SAS","San Antonio Sloths","away",0,1,"Western Division","PBE",31,38,-7,"31 - 38",5,362,328,573,107584,131044,69,0.450843991484654,31,38,"31 - 38","#87795E",3,7,"2029"
9,100,678,2029-09-08,1905,9,8,12,"SAS","San Antonio Sloths","home",1,0,"Western Division","PBE",32,38,-6,"32 - 38",2,364,336,585,112896,132496,70,0.460063897763578,32,38,"32 - 38","#87795E",3,7,"2029"
9,100,683,2029-09-09,1905,9,2,9,"SAS","San Antonio Sloths","home",1,0,"Western Division","PBE",33,38,-5,"33 - 38",1,365,338,594,114244,133225,71,0.461649741987885,33,38,"33 - 38","#87795E",3,7,"2029"
9,100,688,2029-09-10,1905,9,10,11,"SAS","San Antonio Sloths","home",1,0,"Western Division","PBE",34,38,-4,"34 - 38",4,369,348,605,121104,136161,72,0.4707364002099,34,38,"34 - 38","#87795E",3,7,"2029"
9,100,693,2029-09-11,1905,9,3,9,"SAS","San Antonio Sloths","home",1,0,"Western Division","PBE",35,38,-3,"35 - 38",1,370,351,614,123201,136900,73,0.47366599897732,35,38,"35 - 38","#87795E",3,7,"2029"
9,100,697,2029-09-14,1905,9,17,17,"SAS","San Antonio Sloths","away",1,0,"Western Division","PBE",36,38,-2,"36 - 38",5,375,368,631,135424,140625,74,0.490579571018189,36,38,"36 - 38","#87795E",3,7,"2029"
9,100,702,2029-09-15,1905,9,6,10,"SAS","San Antonio Sloths","away",1,0,"Western Division","PBE",37,38,-1,"37 - 38",3,378,374,641,139876,142884,75,0.49468100155609,37,38,"37 - 38","#87795E",3,7,"2029"
9,100,707,2029-09-16,1905,9,2,6,"SAS","San Antonio Sloths","away",0,1,"Western Division","PBE",37,39,-2,"37 - 39",5,383,376,647,141376,146689,76,0.490778122993074,37,39,"37 - 39","#87795E",3,7,"2029"
9,100,712,2029-09-17,1905,9,3,5,"SAS","San Antonio Sloths","away",0,1,"Western Division","PBE",37,40,-3,"37 - 40",7,390,379,652,143641,152100,77,0.485698634954234,37,40,"37 - 40","#87795E",3,7,"2029"
9,100,716,2029-09-20,1905,9,0,3,"SAS","San Antonio Sloths","away",0,1,"Western Division","PBE",37,41,-4,"37 - 41",10,400,379,655,143641,160000,78,0.473061938275793,37,41,"37 - 41","#87795E",3,7,"2029"
9,100,721,2029-09-21,1905,10,6,8,"SAS","San Antonio Sloths","away",1,0,"Western Division","PBE",38,41,-3,"38 - 41",5,405,385,663,148225,164025,79,0.474699759807846,38,41,"38 - 41","#87795E",3,7,"2029"
9,100,726,2029-09-22,1905,10,3,9,"SAS","San Antonio Sloths","away",0,1,"Western Division","PBE",38,42,-4,"38 - 42",4,409,388,672,150544,167281,80,0.473669472193817,38,42,"38 - 42","#87795E",3,7,"2029"
9,100,731,2029-09-23,1905,9,0,5,"SAS","San Antonio Sloths","away",0,1,"Western Division","PBE",38,43,-5,"38 - 43",2,411,388,677,150544,168921,81,0.471237850781776,38,43,"38 - 43","#87795E",3,7,"2029"
9,100,737,2029-09-25,1905,9,11,19,"SAS","San Antonio Sloths","away",1,0,"Western Division","PBE",39,43,-4,"39 - 43",8,419,399,696,159201,175561,82,0.475564729569067,39,43,"39 - 43","#87795E",3,7,"2029"
9,100,742,2029-09-26,1905,9,5,9,"SAS","San Antonio Sloths","away",0,1,"Western Division","PBE",39,44,-5,"39 - 44",7,426,404,705,163216,181476,83,0.47351258514848,39,44,"39 - 44","#87795E",3,7,"2029"
9,100,747,2029-09-27,1905,9,3,8,"SAS","San Antonio Sloths","away",0,1,"Western Division","PBE",39,45,-6,"39 - 45",4,430,407,713,165649,184900,84,0.472541641824681,40,44,"40 - 44","#87795E",3,7,"2029"
9,100,751,2029-09-28,1905,9,5,10,"SAS","San Antonio Sloths","away",1,0,"Western Division","PBE",40,45,-5,"40 - 45",4,434,412,723,169744,188356,85,0.474012845573862,40,45,"40 - 45","#87795E",3,7,"2029"
9,100,757,2029-09-30,1905,9,5,10,"SAS","San Antonio Sloths","away",1,0,"Western Division","PBE",41,45,-4,"41 - 45",2,436,417,733,173889,190096,86,0.477736719919777,41,45,"41 - 45","#87795E",3,7,"2029"
9,100,762,2029-10-01,1905,9,6,10,"SAS","San Antonio Sloths","away",1,0,"Western Division","PBE",42,45,-3,"42 - 45",5,441,423,743,178929,194481,87,0.479175704989154,42,45,"42 - 45","#87795E",3,7,"2029"
9,100,767,2029-10-02,1905,9,8,10,"SAS","San Antonio Sloths","away",0,1,"Western Division","PBE",42,46,-4,"42 - 46",9,450,431,753,185761,202500,88,0.47844362426306,42,46,"42 - 46","#87795E",3,7,"2029"
9,100,772,2029-10-03,1905,9,5,5,"SAS","San Antonio Sloths","away",1,0,"Western Division","PBE",43,46,-3,"43 - 46",2,452,436,758,190096,204304,89,0.481987829614604,43,46,"43 - 46","#87795E",3,7,"2029"
9,100,776,2029-10-05,1905,12,13,16,"SAS","San Antonio Sloths","home",1,0,"Western Division","PBE",44,46,-2,"44 - 46",9,461,449,774,201601,212521,90,0.48681547949638,44,46,"44 - 46","#87795E",3,7,"2029"
9,100,781,2029-10-06,1905,9,4,6,"SAS","San Antonio Sloths","home",1,0,"Western Division","PBE",45,46,-1,"45 - 46",2,463,453,780,205209,214369,91,0.489084270385959,45,46,"45 - 46","#87795E",3,7,"2029"
9,100,786,2029-10-07,1905,9,5,11,"SAS","San Antonio Sloths","home",1,0,"Western Division","PBE",46,46,0,"46 - 46",3,466,458,791,209764,217156,92,0.491342640307318,45,47,"45 - 47","#87795E",3,7,"2029"
9,100,794,2029-10-10,1905,10,5,10,"SAS","San Antonio Sloths","away",0,1,"Western Division","PBE",46,47,-1,"46 - 47",6,472,463,801,214369,222784,93,0.490375223319982,46,47,"46 - 47","#87795E",3,7,"2029"
9,100,798,2029-10-11,1905,9,4,8,"SAS","San Antonio Sloths","away",1,0,"Western Division","PBE",47,47,0,"47 - 47",1,473,467,809,218089,223729,94,0.493617281323984,46,48,"46 - 48","#87795E",3,7,"2029"
9,100,803,2029-10-12,1905,9,3,9,"SAS","San Antonio Sloths","away",0,1,"Western Division","PBE",47,48,-1,"47 - 48",4,477,470,818,220900,227529,95,0.492608640386772,47,48,"47 - 48","#87795E",3,7,"2029"
9,100,808,2029-10-13,1905,9,6,15,"SAS","San Antonio Sloths","away",0,1,"Western Division","PBE",47,49,-2,"47 - 49",10,487,476,833,226576,237169,96,0.488578852602184,47,49,"47 - 49","#87795E",3,7,"2029"
9,100,810,2029-10-15,1905,11,4,10,"SAS","San Antonio Sloths","home",1,0,"Western Division","PBE",48,49,-1,"48 - 49",3,490,480,843,230400,240100,97,0.489691817215728,48,49,"48 - 49","#87795E",3,7,"2029"
9,100,814,2029-10-16,1905,9,3,8,"SAS","San Antonio Sloths","home",0,1,"Western Division","PBE",48,50,-2,"48 - 50",12,502,483,851,233289,252004,98,0.480717834380467,47,51,"47 - 51","#87795E",3,7,"2029"
9,100,819,2029-10-17,1905,9,1,5,"SAS","San Antonio Sloths","home",0,1,"Western Division","PBE",48,51,-3,"48 - 51",8,510,484,856,234256,260100,99,0.473860942316873,47,52,"47 - 52","#87795E",3,7,"2029"
9,100,824,2029-10-18,1905,9,1,9,"SAS","San Antonio Sloths","home",0,1,"Western Division","PBE",48,52,-4,"48 - 52",5,515,485,865,235225,265225,100,0.47002697572185,47,53,"47 - 53","#87795E",3,7,"2029"
10,100,3,2029-05-15,1905,9,19,15,"DV","Death Valley Scorpions","away",1,0,"Western Division","PBE",1,0,1,"1 - 0",0,0,19,15,361,0,1,1,1,0,"1 - 0","#97162B",1,2,"2029"
10,100,8,2029-05-16,1905,9,9,12,"DV","Death Valley Scorpions","away",1,0,"Western Division","PBE",2,0,2,"2 - 0",1,1,28,27,784,1,2,0.998726114649682,2,0,"2 - 0","#97162B",1,2,"2029"
10,100,13,2029-05-17,1905,9,0,5,"DV","Death Valley Scorpions","away",0,1,"Western Division","PBE",2,1,1,"2 - 1",1,2,28,32,784,4,3,0.99492385786802,3,0,"3 - 0","#97162B",1,2,"2029"
10,100,18,2029-05-18,1905,9,7,10,"DV","Death Valley Scorpions","away",1,0,"Western Division","PBE",3,1,2,"3 - 1",2,4,35,42,1225,16,4,0.987107171635778,4,0,"4 - 0","#97162B",1,2,"2029"
10,100,24,2029-05-21,1905,9,5,11,"DV","Death Valley Scorpions","home",1,0,"Western Division","PBE",4,1,3,"4 - 1",3,7,40,53,1600,49,5,0.970285021224985,5,0,"5 - 0","#97162B",1,2,"2029"
10,100,29,2029-05-22,1905,9,6,7,"DV","Death Valley Scorpions","home",1,0,"Western Division","PBE",5,1,4,"5 - 1",3,10,46,60,2116,100,6,0.954873646209386,6,0,"6 - 0","#97162B",1,2,"2029"
10,100,34,2029-05-23,1905,9,6,12,"DV","Death Valley Scorpions","home",1,0,"Western Division","PBE",6,1,5,"6 - 1",4,14,52,72,2704,196,7,0.932413793103448,7,0,"7 - 0","#97162B",1,2,"2029"
10,100,38,2029-05-24,1905,9,7,8,"DV","Death Valley Scorpions","home",1,0,"Western Division","PBE",7,1,6,"7 - 1",6,20,59,80,3481,400,8,0.89693377995362,7,1,"7 - 1","#97162B",1,2,"2029"
10,100,47,2029-05-27,1905,9,12,18,"DV","Death Valley Scorpions","home",1,0,"Western Division","PBE",8,1,7,"8 - 1",1,21,71,98,5041,441,9,0.91955490696826,8,1,"8 - 1","#97162B",1,2,"2029"
10,100,52,2029-05-28,1905,9,15,18,"DV","Death Valley Scorpions","home",1,0,"Western Division","PBE",9,1,8,"9 - 1",8,29,86,116,7396,841,10,0.897899720772126,9,1,"9 - 1","#97162B",1,2,"2029"
10,100,57,2029-05-29,1905,9,8,8,"DV","Death Valley Scorpions","home",1,0,"Western Division","PBE",10,1,9,"10 - 1",2,31,94,124,8836,961,11,0.901908747575789,10,1,"10 - 1","#97162B",1,2,"2029"
10,100,62,2029-06-01,1905,9,9,10,"DV","Death Valley Scorpions","away",1,0,"Western Division","PBE",11,1,10,"11 - 1",2,33,103,134,10609,1089,12,0.906907163617712,11,1,"11 - 1","#97162B",1,2,"2029"
10,100,67,2029-06-02,1905,10,6,9,"DV","Death Valley Scorpions","away",0,1,"Western Division","PBE",11,2,9,"11 - 2",7,40,109,143,11881,1600,13,0.881314442548772,11,2,"11 - 2","#97162B",1,2,"2029"
10,100,72,2029-06-03,1905,9,13,14,"DV","Death Valley Scorpions","away",1,0,"Western Division","PBE",12,2,10,"12 - 2",4,44,122,157,14884,1936,14,0.884898929845422,12,2,"12 - 2","#97162B",1,2,"2029"
10,100,77,2029-06-04,1905,9,4,12,"DV","Death Valley Scorpions","away",1,0,"Western Division","PBE",13,2,11,"13 - 2",0,44,126,169,15876,1936,15,0.891309229732764,13,2,"13 - 2","#97162B",1,2,"2029"
10,100,87,2029-06-07,1905,9,2,7,"DV","Death Valley Scorpions","away",0,1,"Western Division","PBE",13,3,10,"13 - 3",4,48,128,176,16384,2304,16,0.876712328767123,14,2,"14 - 2","#97162B",1,2,"2029"
10,100,92,2029-06-08,1905,10,5,9,"DV","Death Valley Scorpions","away",1,0,"Western Division","PBE",14,3,11,"14 - 3",4,52,133,185,17689,2704,17,0.867405482273329,15,2,"15 - 2","#97162B",1,2,"2029"
10,100,96,2029-06-09,1905,9,9,10,"DV","Death Valley Scorpions","away",1,0,"Western Division","PBE",15,3,12,"15 - 3",2,54,142,195,20164,2916,18,0.873656845753899,16,2,"16 - 2","#97162B",1,2,"2029"
10,100,98,2029-06-11,1905,9,11,12,"DV","Death Valley Scorpions","home",1,0,"Western Division","PBE",16,3,13,"16 - 3",8,62,153,207,23409,3844,19,0.858951308112868,16,3,"16 - 3","#97162B",1,2,"2029"
10,100,103,2029-06-12,1905,9,8,10,"DV","Death Valley Scorpions","home",1,0,"Western Division","PBE",17,3,14,"17 - 3",6,68,161,217,25921,4624,20,0.848616794892781,17,3,"17 - 3","#97162B",1,2,"2029"
10,100,108,2029-06-13,1905,9,8,13,"DV","Death Valley Scorpions","home",1,0,"Western Division","PBE",18,3,15,"18 - 3",0,68,169,230,28561,4624,21,0.860659936718397,18,3,"18 - 3","#97162B",1,2,"2029"
10,100,112,2029-06-14,1905,9,10,9,"DV","Death Valley Scorpions","home",1,0,"Western Division","PBE",19,3,16,"19 - 3",2,70,179,239,32041,4900,22,0.867356054248667,19,3,"19 - 3","#97162B",1,2,"2029"
10,100,118,2029-06-16,1905,9,3,7,"DV","Death Valley Scorpions","home",0,1,"Western Division","PBE",19,4,15,"19 - 4",4,74,182,246,33124,5476,23,0.858134715025907,20,3,"20 - 3","#97162B",1,2,"2029"
10,100,123,2029-06-17,1905,9,11,12,"DV","Death Valley Scorpions","home",1,0,"Western Division","PBE",20,4,16,"20 - 4",1,75,193,258,37249,5625,24,0.868801604702151,21,3,"21 - 3","#97162B",1,2,"2029"
10,100,128,2029-06-18,1905,9,4,5,"DV","Death Valley Scorpions","home",1,0,"Western Division","PBE",21,4,17,"21 - 4",0,75,197,263,38809,5625,25,0.873407750821443,22,3,"22 - 3","#97162B",1,2,"2029"
10,100,133,2029-06-19,1905,9,6,10,"DV","Death Valley Scorpions","home",1,0,"Western Division","PBE",22,4,18,"22 - 4",0,75,203,273,41209,5625,26,0.879894948114618,23,3,"23 - 3","#97162B",1,2,"2029"
10,100,138,2029-06-22,1905,9,2,12,"DV","Death Valley Scorpions","away",0,1,"Western Division","PBE",22,5,17,"22 - 5",6,81,205,285,42025,6561,27,0.864961099905323,23,4,"23 - 4","#97162B",1,2,"2029"
10,100,143,2029-06-23,1905,9,5,7,"DV","Death Valley Scorpions","away",0,1,"Western Division","PBE",22,6,16,"22 - 6",6,87,210,292,44100,7569,28,0.853509841491029,24,4,"24 - 4","#97162B",1,2,"2029"
10,100,148,2029-06-24,1905,9,7,10,"DV","Death Valley Scorpions","away",1,0,"Western Division","PBE",23,6,17,"23 - 6",5,92,217,302,47089,8464,29,0.847640991485608,25,4,"25 - 4","#97162B",1,2,"2029"
10,100,153,2029-06-25,1905,10,8,6,"DV","Death Valley Scorpions","away",0,1,"Western Division","PBE",23,7,16,"23 - 7",10,102,225,308,50625,10404,30,0.829523669075358,25,5,"25 - 5","#97162B",1,2,"2029"
10,100,157,2029-06-27,1905,9,2,9,"DV","Death Valley Scorpions","home",0,1,"Western Division","PBE",23,8,15,"23 - 8",3,105,227,317,51529,11025,31,0.823752278031781,26,5,"26 - 5","#97162B",1,2,"2029"
10,100,162,2029-06-28,1905,9,3,5,"DV","Death Valley Scorpions","home",0,1,"Western Division","PBE",23,9,14,"23 - 9",11,116,230,322,52900,13456,32,0.797215022002532,26,6,"26 - 6","#97162B",1,2,"2029"
10,100,167,2029-06-29,1905,9,6,7,"DV","Death Valley Scorpions","home",1,0,"Western Division","PBE",24,9,15,"24 - 9",3,119,236,329,55696,14161,33,0.797285884020213,26,7,"26 - 7","#97162B",1,2,"2029"
10,100,172,2029-06-30,1905,9,3,4,"DV","Death Valley Scorpions","home",1,0,"Western Division","PBE",25,9,16,"25 - 9",2,121,239,333,57121,14641,34,0.795978372955046,27,7,"27 - 7","#97162B",1,2,"2029"
10,100,178,2029-07-03,1905,9,3,9,"DV","Death Valley Scorpions","away",1,0,"Western Division","PBE",26,9,17,"26 - 9",1,122,242,342,58564,14884,35,0.797353229495698,28,7,"28 - 7","#97162B",1,2,"2029"
10,100,183,2029-07-04,1905,9,4,11,"DV","Death Valley Scorpions","away",0,1,"Western Division","PBE",26,10,16,"26 - 10",10,132,246,353,60516,17424,36,0.776443418013857,28,8,"28 - 8","#97162B",1,2,"2029"
10,100,188,2029-07-05,1905,9,12,14,"DV","Death Valley Scorpions","away",1,0,"Western Division","PBE",27,10,17,"27 - 10",3,135,258,367,66564,18225,37,0.785054665109861,29,8,"29 - 8","#97162B",1,2,"2029"
10,100,193,2029-07-06,1905,9,4,6,"DV","Death Valley Scorpions","away",0,1,"Western Division","PBE",27,11,16,"27 - 11",5,140,262,373,68644,19600,38,0.777888581659943,30,8,"30 - 8","#97162B",1,2,"2029"
10,100,196,2029-07-09,1905,10,5,11,"DV","Death Valley Scorpions","away",0,1,"Western Division","PBE",27,12,15,"27 - 12",8,148,267,384,71289,21904,39,0.764960887620315,30,9,"30 - 9","#97162B",1,2,"2029"
10,100,201,2029-07-10,1905,9,1,7,"DV","Death Valley Scorpions","away",0,1,"Western Division","PBE",27,13,14,"27 - 13",6,154,268,391,71824,23716,40,0.751768892610425,30,10,"30 - 10","#97162B",1,2,"2029"
10,100,206,2029-07-11,1905,9,1,4,"DV","Death Valley Scorpions","away",0,1,"Western Division","PBE",27,14,13,"27 - 14",5,159,269,395,72361,25281,41,0.741084779090965,30,11,"30 - 11","#97162B",1,2,"2029"
10,100,211,2029-07-12,1905,9,6,8,"DV","Death Valley Scorpions","away",1,0,"Western Division","PBE",28,14,14,"28 - 14",1,160,275,403,75625,25600,42,0.747098048900963,31,11,"31 - 11","#97162B",1,2,"2029"
10,100,216,2029-07-15,1905,9,2,5,"DV","Death Valley Scorpions","home",0,1,"Western Division","PBE",28,15,13,"28 - 15",3,163,277,408,76729,26569,43,0.742792696857635,32,11,"32 - 11","#97162B",1,2,"2029"
10,100,221,2029-07-16,1905,9,7,10,"DV","Death Valley Scorpions","home",0,1,"Western Division","PBE",28,16,12,"28 - 16",10,173,284,418,80656,29929,44,0.72935750779943,32,12,"32 - 12","#97162B",1,2,"2029"
10,100,226,2029-07-17,1905,9,3,6,"DV","Death Valley Scorpions","home",1,0,"Western Division","PBE",29,16,13,"29 - 16",0,173,287,424,82369,29929,45,0.73348590357798,33,12,"33 - 12","#97162B",1,2,"2029"
10,100,231,2029-07-18,1905,9,8,6,"DV","Death Valley Scorpions","home",1,0,"Western Division","PBE",30,16,14,"30 - 16",3,176,295,430,87025,30976,46,0.737493750052966,34,12,"34 - 12","#97162B",1,2,"2029"
10,100,235,2029-07-21,1905,9,10,11,"DV","Death Valley Scorpions","away",1,0,"Western Division","PBE",31,16,15,"31 - 16",1,177,305,441,93025,31329,47,0.748066005114431,35,12,"35 - 12","#97162B",1,2,"2029"
10,100,240,2029-07-22,1905,9,4,7,"DV","Death Valley Scorpions","away",1,0,"Western Division","PBE",32,16,16,"32 - 16",3,180,309,448,95481,32400,48,0.746639453867267,36,12,"36 - 12","#97162B",1,2,"2029"
10,100,245,2029-07-23,1905,9,0,7,"DV","Death Valley Scorpions","away",0,1,"Western Division","PBE",32,17,15,"32 - 17",2,182,309,455,95481,33124,49,0.742436141674118,36,13,"36 - 13","#97162B",1,2,"2029"
10,100,250,2029-07-24,1905,9,1,6,"DV","Death Valley Scorpions","away",0,1,"Western Division","PBE",32,18,14,"32 - 18",18,200,310,461,96100,40000,50,0.706098457016899,35,15,"35 - 15","#97162B",1,2,"2029"
10,100,258,2029-08-12,1905,9,3,9,"DV","Death Valley Scorpions","away",0,1,"Western Division","PBE",32,19,13,"32 - 19",9,209,313,470,97969,43681,51,0.691627250264737,35,16,"35 - 16","#97162B",1,2,"2029"
10,100,263,2029-08-13,1905,9,3,5,"DV","Death Valley Scorpions","away",0,1,"Western Division","PBE",32,20,12,"32 - 20",7,216,316,475,99856,46656,52,0.681555094463252,35,17,"35 - 17","#97162B",1,2,"2029"
10,100,268,2029-08-14,1905,9,12,15,"DV","Death Valley Scorpions","away",1,0,"Western Division","PBE",33,20,13,"33 - 20",4,220,328,490,107584,48400,53,0.689711765309262,37,16,"37 - 16","#97162B",1,2,"2029"
10,100,276,2029-08-17,1905,9,3,7,"DV","Death Valley Scorpions","home",1,0,"Western Division","PBE",34,20,14,"34 - 20",1,221,331,497,109561,48841,54,0.691664246663552,37,17,"37 - 17","#97162B",1,2,"2029"
10,100,280,2029-08-18,1905,9,13,19,"DV","Death Valley Scorpions","home",1,0,"Western Division","PBE",35,20,15,"35 - 20",1,222,344,516,118336,49284,55,0.705977806944279,39,16,"39 - 16","#97162B",1,2,"2029"
10,100,285,2029-08-19,1905,11,3,6,"DV","Death Valley Scorpions","home",0,1,"Western Division","PBE",35,21,14,"35 - 21",7,229,347,522,120409,52441,56,0.696609777263523,39,17,"39 - 17","#97162B",1,2,"2029"
10,100,290,2029-08-20,1905,9,4,12,"DV","Death Valley Scorpions","home",1,0,"Western Division","PBE",36,21,15,"36 - 21",2,231,351,534,123201,53361,57,0.697777551228464,40,17,"40 - 17","#97162B",1,2,"2029"
10,100,293,2029-08-22,1905,10,2,10,"DV","Death Valley Scorpions","home",0,1,"Western Division","PBE",36,22,14,"36 - 22",7,238,353,544,124609,56644,58,0.687486551946726,40,18,"40 - 18","#97162B",1,2,"2029"
10,100,297,2029-08-23,1905,9,5,10,"DV","Death Valley Scorpions","home",1,0,"Western Division","PBE",37,22,15,"37 - 22",2,240,358,554,128164,57600,59,0.689929157425551,41,18,"41 - 18","#97162B",1,2,"2029"
10,100,628,2029-08-24,1905,9,6,10,"DV","Death Valley Scorpions","home",1,0,"Western Division","PBE",38,22,16,"38 - 22",4,244,364,564,132496,59536,60,0.689968338610232,41,19,"41 - 19","#97162B",1,2,"2029"
10,100,632,2029-08-25,1905,9,11,12,"DV","Death Valley Scorpions","home",1,0,"Western Division","PBE",39,22,17,"39 - 22",0,244,375,576,140625,59536,61,0.702559439651081,43,18,"43 - 18","#97162B",1,2,"2029"
10,100,637,2029-08-27,1905,9,6,11,"DV","Death Valley Scorpions","away",0,1,"Western Division","PBE",39,23,16,"39 - 23",13,257,381,587,145161,66049,62,0.687282799109891,43,19,"43 - 19","#97162B",1,2,"2029"
10,100,642,2029-08-28,1905,9,9,11,"DV","Death Valley Scorpions","away",0,1,"Western Division","PBE",39,24,15,"39 - 24",18,275,390,598,152100,75625,63,0.667910857393786,42,21,"42 - 21","#97162B",1,2,"2029"
10,100,647,2029-08-29,1905,9,15,15,"DV","Death Valley Scorpions","away",1,0,"Western Division","PBE",40,24,16,"40 - 24",6,281,405,613,164025,78961,64,0.67503889112953,43,21,"43 - 21","#97162B",1,2,"2029"
10,100,652,2029-08-30,1905,9,11,13,"DV","Death Valley Scorpions","away",1,0,"Western Division","PBE",41,24,17,"41 - 24",2,283,416,626,173056,80089,65,0.683624009954769,44,21,"44 - 21","#97162B",1,2,"2029"
10,100,655,2029-09-02,1905,9,10,13,"DV","Death Valley Scorpions","home",1,0,"Western Division","PBE",42,24,18,"42 - 24",5,288,426,639,181476,82944,66,0.686317222600408,45,21,"45 - 21","#97162B",1,2,"2029"
10,100,660,2029-09-03,1905,9,17,15,"DV","Death Valley Scorpions","home",1,0,"Western Division","PBE",43,24,19,"43 - 24",2,290,443,654,196249,84100,67,0.700016764818137,47,20,"47 - 20","#97162B",1,2,"2029"
10,100,665,2029-09-04,1905,9,8,9,"DV","Death Valley Scorpions","home",1,0,"Western Division","PBE",44,24,20,"44 - 24",6,296,451,663,203401,87616,68,0.698931677530866,48,20,"48 - 20","#97162B",1,2,"2029"
10,100,670,2029-09-05,1905,9,5,7,"DV","Death Valley Scorpions","home",1,0,"Western Division","PBE",45,24,21,"45 - 24",2,298,456,670,207936,88804,69,0.700734649861832,48,21,"48 - 21","#97162B",1,2,"2029"
10,100,677,2029-09-08,1905,9,7,8,"DV","Death Valley Scorpions","home",1,0,"Western Division","PBE",46,24,22,"46 - 24",3,301,463,678,214369,90601,70,0.702918319834738,49,21,"49 - 21","#97162B",1,2,"2029"
10,100,682,2029-09-09,1905,9,0,6,"DV","Death Valley Scorpions","home",0,1,"Western Division","PBE",46,25,21,"46 - 25",3,304,463,684,214369,92416,71,0.69875971771762,50,21,"50 - 21","#97162B",1,2,"2029"
10,100,687,2029-09-10,1905,9,5,8,"DV","Death Valley Scorpions","home",0,1,"Western Division","PBE",46,26,20,"46 - 26",10,314,468,692,219024,98596,72,0.689578741892828,50,22,"50 - 22","#97162B",1,2,"2029"
10,100,692,2029-09-11,1905,9,5,8,"DV","Death Valley Scorpions","home",1,0,"Western Division","PBE",47,26,21,"47 - 26",2,316,473,700,223729,99856,73,0.691407203671369,50,23,"50 - 23","#97162B",1,2,"2029"
10,100,696,2029-09-14,1905,9,2,5,"DV","Death Valley Scorpions","away",0,1,"Western Division","PBE",47,27,20,"47 - 27",3,319,475,705,225625,101761,74,0.68917119241507,51,23,"51 - 23","#97162B",1,2,"2029"
10,100,701,2029-09-15,1905,9,1,8,"DV","Death Valley Scorpions","away",0,1,"Western Division","PBE",47,28,19,"47 - 28",3,322,476,713,226576,103684,75,0.686053412462908,51,24,"51 - 24","#97162B",1,2,"2029"
10,100,706,2029-09-16,1905,9,4,7,"DV","Death Valley Scorpions","away",1,0,"Western Division","PBE",48,28,20,"48 - 28",1,323,480,720,230400,104329,76,0.688318012481739,52,24,"52 - 24","#97162B",1,2,"2029"
10,100,711,2029-09-17,1905,9,2,8,"DV","Death Valley Scorpions","away",1,0,"Western Division","PBE",49,28,21,"49 - 28",1,324,482,728,232324,104976,77,0.688775570708568,53,24,"53 - 24","#97162B",1,2,"2029"
10,100,716,2029-09-20,1905,9,10,15,"DV","Death Valley Scorpions","home",1,0,"Western Division","PBE",50,28,22,"50 - 28",0,324,492,743,242064,104976,78,0.697510373443983,54,24,"54 - 24","#97162B",1,2,"2029"
10,100,721,2029-09-21,1905,10,5,8,"DV","Death Valley Scorpions","home",0,1,"Western Division","PBE",50,29,21,"50 - 29",6,330,497,751,247009,108900,79,0.69402291035068,55,24,"55 - 24","#97162B",1,2,"2029"
10,100,726,2029-09-22,1905,10,4,6,"DV","Death Valley Scorpions","home",1,0,"Western Division","PBE",51,29,22,"51 - 29",3,333,501,757,251001,110889,80,0.693583685650336,55,25,"55 - 25","#97162B",1,2,"2029"
10,100,731,2029-09-23,1905,9,2,5,"DV","Death Valley Scorpions","home",1,0,"Western Division","PBE",52,29,23,"52 - 29",0,333,503,762,253009,110889,81,0.695274499997252,56,25,"56 - 25","#97162B",1,2,"2029"
10,100,736,2029-09-25,1905,9,9,12,"DV","Death Valley Scorpions","away",1,0,"Western Division","PBE",53,29,24,"53 - 29",1,334,512,774,262144,111556,82,0.701482472571581,58,24,"58 - 24","#97162B",1,2,"2029"
10,100,741,2029-09-26,1905,9,9,8,"DV","Death Valley Scorpions","away",1,0,"Western Division","PBE",54,29,25,"54 - 29",2,336,521,782,271441,112896,83,0.706257789387959,59,24,"59 - 24","#97162B",1,2,"2029"
10,100,746,2029-09-27,1905,9,23,20,"DV","Death Valley Scorpions","away",1,0,"Western Division","PBE",55,29,26,"55 - 29",6,342,544,802,295936,116964,84,0.716725599418745,60,24,"60 - 24","#97162B",1,2,"2029"
10,100,750,2029-09-28,1905,9,6,9,"DV","Death Valley Scorpions","away",1,0,"Western Division","PBE",56,29,27,"56 - 29",3,345,550,811,302500,119025,85,0.717632406144357,61,24,"61 - 24","#97162B",1,2,"2029"
10,100,754,2029-09-30,1905,9,4,9,"DV","Death Valley Scorpions","home",0,1,"Western Division","PBE",56,30,26,"56 - 30",6,351,554,820,306916,123201,86,0.713563983753258,61,25,"61 - 25","#97162B",1,2,"2029"
10,100,759,2029-10-01,1905,9,2,4,"DV","Death Valley Scorpions","home",1,0,"Western Division","PBE",57,30,27,"57 - 30",1,352,556,824,309136,123904,87,0.713874007020137,62,25,"62 - 25","#97162B",1,2,"2029"
10,100,764,2029-10-02,1905,9,4,6,"DV","Death Valley Scorpions","home",1,0,"Western Division","PBE",58,30,28,"58 - 30",1,353,560,830,313600,124609,88,0.715640253851473,63,25,"63 - 25","#97162B",1,2,"2029"
10,100,769,2029-10-03,1905,11,4,12,"DV","Death Valley Scorpions","home",1,0,"Western Division","PBE",59,30,29,"59 - 30",3,356,564,842,318096,126736,89,0.715092439392849,64,25,"64 - 25","#97162B",1,2,"2029"
10,100,779,2029-10-06,1905,9,9,10,"DV","Death Valley Scorpions","home",1,0,"Western Division","PBE",60,30,30,"60 - 30",0,356,573,852,328329,126736,90,0.721499126498412,65,25,"65 - 25","#97162B",1,2,"2029"
10,100,784,2029-10-07,1905,9,3,5,"DV","Death Valley Scorpions","home",0,1,"Western Division","PBE",60,31,29,"60 - 31",4,360,576,857,331776,129600,91,0.719101123595506,65,26,"65 - 26","#97162B",1,2,"2029"
10,100,789,2029-10-08,1905,9,4,8,"DV","Death Valley Scorpions","home",1,0,"Western Division","PBE",61,31,30,"61 - 31",2,362,580,865,336400,131044,92,0.719658397583454,66,26,"66 - 26","#97162B",1,2,"2029"
10,100,793,2029-10-10,1905,9,3,6,"DV","Death Valley Scorpions","away",1,0,"Western Division","PBE",62,31,31,"62 - 31",2,364,583,871,339889,132496,93,0.71951691946188,67,26,"67 - 26","#97162B",1,2,"2029"
10,100,797,2029-10-11,1905,10,6,12,"DV","Death Valley Scorpions","away",1,0,"Western Division","PBE",63,31,32,"63 - 31",4,368,589,883,346921,135424,94,0.719238304533062,68,26,"68 - 26","#97162B",1,2,"2029"
10,100,802,2029-10-12,1905,9,5,7,"DV","Death Valley Scorpions","away",1,0,"Western Division","PBE",64,31,33,"64 - 31",3,371,594,890,352836,137641,95,0.719373181617079,68,27,"68 - 27","#97162B",1,2,"2029"
10,100,807,2029-10-13,1905,9,1,3,"DV","Death Valley Scorpions","away",0,1,"Western Division","PBE",64,32,32,"64 - 32",15,386,595,893,354025,148996,96,0.703797654571082,68,28,"68 - 28","#97162B",1,2,"2029"
10,100,812,2029-10-15,1905,9,7,9,"DV","Death Valley Scorpions","away",0,1,"Western Division","PBE",64,33,31,"64 - 33",12,398,602,902,362404,158404,97,0.695849526120951,67,30,"67 - 30","#97162B",1,2,"2029"
10,100,817,2029-10-16,1905,9,3,7,"DV","Death Valley Scorpions","away",0,1,"Western Division","PBE",64,34,30,"64 - 34",4,402,605,909,366025,161604,98,0.693716607692147,68,30,"68 - 30","#97162B",1,2,"2029"
10,100,822,2029-10-17,1905,9,10,9,"DV","Death Valley Scorpions","away",1,0,"Western Division","PBE",65,34,31,"65 - 34",5,407,615,918,378225,165649,99,0.695427617426095,69,30,"69 - 30","#97162B",1,2,"2029"
10,100,827,2029-10-18,1905,9,9,13,"DV","Death Valley Scorpions","away",1,0,"Western Division","PBE",66,34,32,"66 - 34",2,409,624,931,389376,167281,100,0.699489991143559,70,30,"70 - 30","#97162B",1,2,"2029"
11,100,5,2029-05-15,1905,9,4,9,"VAN","Vancouver Vandals","away",1,0,"Western Division","PBE",1,0,1,"1 - 0",1,1,4,9,16,1,1,0.941176470588235,1,0,"1 - 0","#183013",2,5,"2029"
11,100,10,2029-05-16,1905,9,4,9,"VAN","Vancouver Vandals","away",1,0,"Western Division","PBE",2,0,2,"2 - 0",2,3,8,18,64,9,2,0.876712328767123,2,0,"2 - 0","#183013",2,5,"2029"
11,100,15,2029-05-17,1905,10,3,9,"VAN","Vancouver Vandals","away",1,0,"Western Division","PBE",3,0,3,"3 - 0",2,5,11,27,121,25,3,0.828767123287671,2,1,"2 - 1","#183013",2,5,"2029"
11,100,20,2029-05-18,1905,9,10,18,"VAN","Vancouver Vandals","away",1,0,"Western Division","PBE",4,0,4,"4 - 0",0,5,21,45,441,25,4,0.946351931330472,4,0,"4 - 0","#183013",2,5,"2029"
11,100,24,2029-05-21,1905,9,3,11,"VAN","Vancouver Vandals","away",0,1,"Western Division","PBE",4,1,3,"4 - 1",5,10,24,56,576,100,5,0.85207100591716,4,1,"4 - 1","#183013",2,5,"2029"
11,100,29,2029-05-22,1905,9,3,5,"VAN","Vancouver Vandals","away",0,1,"Western Division","PBE",4,2,2,"4 - 2",6,16,27,61,729,256,6,0.74010152284264,4,2,"4 - 2","#183013",2,5,"2029"
11,100,34,2029-05-23,1905,9,4,6,"VAN","Vancouver Vandals","away",0,1,"Western Division","PBE",4,3,1,"4 - 3",6,22,31,67,961,484,7,0.665051903114187,5,2,"5 - 2","#183013",2,5,"2029"
11,100,38,2029-05-24,1905,9,6,12,"VAN","Vancouver Vandals","away",0,1,"Western Division","PBE",4,4,0,"4 - 4",7,29,37,79,1369,841,8,0.619457013574661,5,3,"5 - 3","#183013",2,5,"2029"
11,100,42,2029-05-26,1905,13,1,6,"VAN","Vancouver Vandals","home",1,0,"Western Division","PBE",5,4,1,"5 - 4",0,29,38,85,1444,841,9,0.631947483588621,6,3,"6 - 3","#183013",2,5,"2029"
11,100,46,2029-05-27,1905,9,2,9,"VAN","Vancouver Vandals","home",0,1,"Western Division","PBE",5,5,0,"5 - 5",7,36,40,94,1600,1296,10,0.552486187845304,6,4,"6 - 4","#183013",2,5,"2029"
11,100,51,2029-05-28,1905,10,1,4,"VAN","Vancouver Vandals","home",1,0,"Western Division","PBE",6,5,1,"6 - 5",0,36,41,98,1681,1296,11,0.564662411823984,6,5,"6 - 5","#183013",2,5,"2029"
11,100,56,2029-05-29,1905,9,10,13,"VAN","Vancouver Vandals","home",1,0,"Western Division","PBE",7,5,2,"7 - 5",3,39,51,111,2601,1521,12,0.631004366812227,8,4,"8 - 4","#183013",2,5,"2029"
11,100,63,2029-06-01,1905,9,3,7,"VAN","Vancouver Vandals","away",1,0,"Western Division","PBE",8,5,3,"8 - 5",0,39,54,118,2916,1521,13,0.657200811359026,9,4,"9 - 4","#183013",2,5,"2029"
11,100,68,2029-06-02,1905,9,9,8,"VAN","Vancouver Vandals","away",1,0,"Western Division","PBE",9,5,4,"9 - 5",5,44,63,126,3969,1936,14,0.672142252328535,9,5,"9 - 5","#183013",2,5,"2029"
11,100,73,2029-06-03,1905,9,4,10,"VAN","Vancouver Vandals","away",1,0,"Western Division","PBE",10,5,5,"10 - 5",1,45,67,136,4489,2025,15,0.689131102241326,10,5,"10 - 5","#183013",2,5,"2029"
11,100,78,2029-06-04,1905,9,7,9,"VAN","Vancouver Vandals","away",1,0,"Western Division","PBE",11,5,6,"11 - 5",6,51,74,145,5476,2601,16,0.677974495480995,11,5,"11 - 5","#183013",2,5,"2029"
11,100,82,2029-06-06,1905,13,2,10,"VAN","Vancouver Vandals","home",1,0,"Western Division","PBE",12,5,7,"12 - 5",1,52,76,155,5776,2704,17,0.681132075471698,12,5,"12 - 5","#183013",2,5,"2029"
11,100,86,2029-06-07,1905,9,13,17,"VAN","Vancouver Vandals","home",1,0,"Western Division","PBE",13,5,8,"13 - 5",5,57,89,172,7921,3249,18,0.709131602506714,13,5,"13 - 5","#183013",2,5,"2029"
11,100,91,2029-06-08,1905,9,3,10,"VAN","Vancouver Vandals","home",1,0,"Western Division","PBE",14,5,9,"14 - 5",2,59,92,182,8464,3481,19,0.708580996232733,13,6,"13 - 6","#183013",2,5,"2029"
11,100,95,2029-06-09,1905,9,1,4,"VAN","Vancouver Vandals","home",0,1,"Western Division","PBE",14,6,8,"14 - 6",7,66,93,186,8649,4356,20,0.665051903114187,13,7,"13 - 7","#183013",2,5,"2029"
11,100,99,2029-06-11,1905,11,1,10,"VAN","Vancouver Vandals","away",0,1,"Western Division","PBE",14,7,7,"14 - 7",3,69,94,196,8836,4761,21,0.649849231448114,14,7,"14 - 7","#183013",2,5,"2029"
11,100,104,2029-06-12,1905,9,2,11,"VAN","Vancouver Vandals","away",0,1,"Western Division","PBE",14,8,6,"14 - 8",4,73,96,207,9216,5329,22,0.633619800618769,14,8,"14 - 8","#183013",2,5,"2029"
11,100,109,2029-06-13,1905,9,3,10,"VAN","Vancouver Vandals","away",0,1,"Western Division","PBE",14,9,5,"14 - 9",5,78,99,217,9801,6084,23,0.61699716713881,14,9,"14 - 9","#183013",2,5,"2029"
11,100,113,2029-06-14,1905,9,6,14,"VAN","Vancouver Vandals","away",1,0,"Western Division","PBE",15,9,6,"15 - 9",4,82,105,231,11025,6724,24,0.621161755591864,15,9,"15 - 9","#183013",2,5,"2029"
11,100,119,2029-06-16,1905,9,2,12,"VAN","Vancouver Vandals","home",0,1,"Western Division","PBE",15,10,5,"15 - 10",7,89,107,243,11449,7921,25,0.591068662880743,15,10,"15 - 10","#183013",2,5,"2029"
11,100,124,2029-06-17,1905,9,3,10,"VAN","Vancouver Vandals","home",0,1,"Western Division","PBE",15,11,4,"15 - 11",11,100,110,253,12100,10000,26,0.547511312217195,14,12,"14 - 12","#183013",2,5,"2029"
11,100,129,2029-06-18,1905,9,2,5,"VAN","Vancouver Vandals","home",0,1,"Western Division","PBE",15,12,3,"15 - 12",7,107,112,258,12544,11449,27,0.522819155587046,14,13,"14 - 13","#183013",2,5,"2029"
11,100,134,2029-06-19,1905,9,10,12,"VAN","Vancouver Vandals","home",1,0,"Western Division","PBE",16,12,4,"16 - 12",5,112,122,270,14884,12544,28,0.542657138690389,15,13,"15 - 13","#183013",2,5,"2029"
11,100,139,2029-06-22,1905,9,7,10,"VAN","Vancouver Vandals","home",1,0,"Western Division","PBE",17,12,5,"17 - 12",5,117,129,280,16641,13689,29,0.5486646884273,16,13,"16 - 13","#183013",2,5,"2029"
11,100,144,2029-06-23,1905,9,4,8,"VAN","Vancouver Vandals","home",0,1,"Western Division","PBE",17,13,4,"17 - 13",6,123,133,288,17689,15129,30,0.539002986166128,16,14,"16 - 14","#183013",2,5,"2029"
11,100,149,2029-06-24,1905,9,9,15,"VAN","Vancouver Vandals","home",1,0,"Western Division","PBE",18,13,5,"18 - 13",6,129,142,303,20164,16641,31,0.547860345061812,17,14,"17 - 14","#183013",2,5,"2029"
11,100,154,2029-06-25,1905,12,6,14,"VAN","Vancouver Vandals","home",0,1,"Western Division","PBE",18,14,4,"18 - 14",7,136,148,317,21904,18496,32,0.542178217821782,17,15,"17 - 15","#183013",2,5,"2029"
11,100,156,2029-06-27,1905,9,5,11,"VAN","Vancouver Vandals","away",1,0,"Western Division","PBE",19,14,5,"19 - 14",2,138,153,328,23409,19044,33,0.551409794360823,18,15,"18 - 15","#183013",2,5,"2029"
11,100,161,2029-06-28,1905,9,3,7,"VAN","Vancouver Vandals","away",0,1,"Western Division","PBE",19,15,4,"19 - 15",4,142,156,335,24336,20164,34,0.546876404494382,19,15,"19 - 15","#183013",2,5,"2029"
11,100,166,2029-06-29,1905,9,4,9,"VAN","Vancouver Vandals","away",1,0,"Western Division","PBE",20,15,5,"20 - 15",0,142,160,344,25600,20164,35,0.559391661568045,20,15,"20 - 15","#183013",2,5,"2029"
11,100,171,2029-06-30,1905,9,4,11,"VAN","Vancouver Vandals","away",0,1,"Western Division","PBE",20,16,4,"20 - 16",5,147,164,355,26896,21609,36,0.554499536130296,20,16,"20 - 16","#183013",2,5,"2029"
11,100,178,2029-07-03,1905,9,1,7,"VAN","Vancouver Vandals","home",0,1,"Western Division","PBE",20,17,3,"20 - 17",3,150,165,362,27225,22500,37,0.547511312217195,20,17,"20 - 17","#183013",2,5,"2029"
11,100,183,2029-07-04,1905,9,10,11,"VAN","Vancouver Vandals","home",1,0,"Western Division","PBE",21,17,4,"21 - 17",4,154,175,373,30625,23716,38,0.563570784490532,21,17,"21 - 17","#183013",2,5,"2029"
11,100,188,2029-07-05,1905,9,3,6,"VAN","Vancouver Vandals","home",0,1,"Western Division","PBE",21,18,3,"21 - 18",12,166,178,379,31684,27556,39,0.534841323430115,21,18,"21 - 18","#183013",2,5,"2029"
11,100,193,2029-07-06,1905,9,5,13,"VAN","Vancouver Vandals","home",1,0,"Western Division","PBE",22,18,4,"22 - 18",4,170,183,392,33489,28900,40,0.536777316514129,21,19,"21 - 19","#183013",2,5,"2029"
11,100,197,2029-07-09,1905,15,8,17,"VAN","Vancouver Vandals","away",1,0,"Western Division","PBE",23,18,5,"23 - 18",3,173,191,409,36481,29929,41,0.549329920192742,23,18,"23 - 18","#183013",2,5,"2029"
11,100,202,2029-07-10,1905,9,6,10,"VAN","Vancouver Vandals","away",0,1,"Western Division","PBE",23,19,4,"23 - 19",7,180,197,419,38809,32400,42,0.545001334101027,23,19,"23 - 19","#183013",2,5,"2029"
11,100,207,2029-07-11,1905,9,5,7,"VAN","Vancouver Vandals","away",0,1,"Western Division","PBE",23,20,3,"23 - 20",7,187,202,426,40804,34969,43,0.53850316075647,23,20,"23 - 20","#183013",2,5,"2029"
11,100,212,2029-07-12,1905,9,3,6,"VAN","Vancouver Vandals","away",0,1,"Western Division","PBE",23,21,2,"23 - 21",4,191,205,432,42025,36481,44,0.535309403102948,24,20,"24 - 20","#183013",2,5,"2029"
11,100,218,2029-07-15,1905,9,15,19,"VAN","Vancouver Vandals","home",1,0,"Western Division","PBE",24,21,3,"24 - 21",5,196,220,451,48400,38416,45,0.557500921489126,25,20,"25 - 20","#183013",2,5,"2029"
11,100,223,2029-07-16,1905,9,3,5,"VAN","Vancouver Vandals","home",0,1,"Western Division","PBE",24,22,2,"24 - 22",4,200,223,456,49729,40000,46,0.554213242095644,25,21,"25 - 21","#183013",2,5,"2029"
11,100,228,2029-07-17,1905,9,0,8,"VAN","Vancouver Vandals","home",0,1,"Western Division","PBE",24,23,1,"24 - 23",1,201,223,464,49729,40401,47,0.55174747586819,26,21,"26 - 21","#183013",2,5,"2029"
11,100,233,2029-07-18,1905,9,3,12,"VAN","Vancouver Vandals","home",1,0,"Western Division","PBE",25,23,2,"25 - 23",1,202,226,476,51076,40804,48,0.555898998693949,27,21,"27 - 21","#183013",2,5,"2029"
11,100,234,2029-07-21,1905,9,2,5,"VAN","Vancouver Vandals","home",1,0,"Western Division","PBE",26,23,3,"26 - 23",1,203,228,481,51984,41209,49,0.557810135954417,27,22,"27 - 22","#183013",2,5,"2029"
11,100,239,2029-07-22,1905,9,5,10,"VAN","Vancouver Vandals","home",0,1,"Western Division","PBE",26,24,2,"26 - 24",9,212,233,491,54289,44944,50,0.547086150776455,27,23,"27 - 23","#183013",2,5,"2029"
11,100,244,2029-07-23,1905,9,3,6,"VAN","Vancouver Vandals","home",0,1,"Western Division","PBE",26,25,1,"26 - 25",4,216,236,497,55696,46656,51,0.544161325621385,28,23,"28 - 23","#183013",2,5,"2029"
11,100,249,2029-07-24,1905,9,0,3,"VAN","Vancouver Vandals","home",0,1,"Western Division","PBE",26,26,0,"26 - 26",5,221,236,500,55696,48841,52,0.532787434114237,28,24,"28 - 24","#183013",2,5,"2029"
11,100,258,2029-08-12,1905,9,9,14,"VAN","Vancouver Vandals","home",1,0,"Western Division","PBE",27,26,1,"27 - 26",3,224,245,514,60025,50176,53,0.544686527345487,29,24,"29 - 24","#183013",2,5,"2029"
11,100,263,2029-08-13,1905,9,7,14,"VAN","Vancouver Vandals","home",1,0,"Western Division","PBE",28,26,2,"28 - 26",3,227,252,528,63504,51529,54,0.552050281223649,30,24,"30 - 24","#183013",2,5,"2029"
11,100,268,2029-08-14,1905,9,4,6,"VAN","Vancouver Vandals","home",0,1,"Western Division","PBE",28,27,1,"28 - 27",12,239,256,534,65536,57121,55,0.534302974962701,29,26,"29 - 26","#183013",2,5,"2029"
11,100,276,2029-08-17,1905,9,1,7,"VAN","Vancouver Vandals","away",0,1,"Western Division","PBE",28,28,0,"28 - 28",3,242,257,541,66049,58564,56,0.530032982112621,30,26,"30 - 26","#183013",2,5,"2029"
11,100,280,2029-08-18,1905,9,1,4,"VAN","Vancouver Vandals","away",0,1,"Western Division","PBE",28,29,-1,"28 - 29",13,255,258,545,66564,65025,57,0.505847753231653,29,28,"29 - 28","#183013",2,5,"2029"
11,100,285,2029-08-19,1905,11,7,11,"VAN","Vancouver Vandals","away",1,0,"Western Division","PBE",29,29,0,"29 - 29",3,258,265,556,70225,66564,58,0.513381923985116,30,28,"30 - 28","#183013",2,5,"2029"
11,100,290,2029-08-20,1905,9,2,8,"VAN","Vancouver Vandals","away",0,1,"Western Division","PBE",29,30,-1,"29 - 30",4,262,267,564,71289,68644,59,0.509450951526802,30,29,"30 - 29","#183013",2,5,"2029"
11,100,294,2029-08-22,1905,10,3,10,"VAN","Vancouver Vandals","away",1,0,"Western Division","PBE",30,30,0,"30 - 30",2,264,270,574,72900,69696,60,0.511234536733148,31,29,"31 - 29","#183013",2,5,"2029"
11,100,299,2029-08-23,1905,9,11,14,"VAN","Vancouver Vandals","away",1,0,"Western Division","PBE",31,30,1,"31 - 30",2,266,281,588,78961,70756,61,0.527401697869981,32,29,"32 - 29","#183013",2,5,"2029"
11,100,630,2029-08-24,1905,9,4,7,"VAN","Vancouver Vandals","away",0,1,"Western Division","PBE",31,31,0,"31 - 31",7,273,285,595,81225,74529,62,0.521495435109211,32,30,"32 - 30","#183013",2,5,"2029"
11,100,638,2029-08-27,1905,9,3,11,"VAN","Vancouver Vandals","home",0,1,"Western Division","PBE",31,32,-1,"31 - 32",9,282,288,606,82944,79524,63,0.510525149567915,32,31,"32 - 31","#183013",2,5,"2029"
11,100,643,2029-08-28,1905,9,14,15,"VAN","Vancouver Vandals","home",1,0,"Western Division","PBE",32,32,0,"32 - 32",2,284,302,621,91204,80656,64,0.530687769114395,34,30,"34 - 30","#183013",2,5,"2029"
11,100,648,2029-08-29,1905,9,6,9,"VAN","Vancouver Vandals","home",1,0,"Western Division","PBE",33,32,1,"33 - 32",4,288,308,630,94864,82944,65,0.533519301718708,35,30,"35 - 30","#183013",2,5,"2029"
11,100,653,2029-08-30,1905,12,6,11,"VAN","Vancouver Vandals","home",0,1,"Western Division","PBE",33,33,0,"33 - 33",7,295,314,641,98596,87025,66,0.531168348408855,35,31,"35 - 31","#183013",2,5,"2029"
11,100,658,2029-09-02,1905,9,2,8,"VAN","Vancouver Vandals","away",0,1,"Western Division","PBE",33,34,-1,"33 - 34",3,298,316,649,99856,88804,67,0.529290787660341,35,32,"35 - 32","#183013",2,5,"2029"
11,100,663,2029-09-03,1905,12,7,17,"VAN","Vancouver Vandals","away",1,0,"Western Division","PBE",34,34,0,"34 - 34",6,304,323,666,104329,92416,68,0.530275229357798,36,32,"36 - 32","#183013",2,5,"2029"
11,100,668,2029-09-04,1905,9,3,7,"VAN","Vancouver Vandals","away",0,1,"Western Division","PBE",34,35,-1,"34 - 35",4,308,326,673,106276,94864,69,0.528368300686089,36,33,"36 - 33","#183013",2,5,"2029"
11,100,673,2029-09-05,1905,9,10,10,"VAN","Vancouver Vandals","away",1,0,"Western Division","PBE",35,35,0,"35 - 35",3,311,336,683,112896,96721,70,0.538582271476073,38,32,"38 - 32","#183013",2,5,"2029"
11,100,676,2029-09-08,1905,12,6,18,"VAN","Vancouver Vandals","home",1,0,"Western Division","PBE",36,35,1,"36 - 35",5,316,342,701,116964,99856,71,0.539452080066415,38,33,"38 - 33","#183013",2,5,"2029"
11,100,681,2029-09-09,1905,9,0,3,"VAN","Vancouver Vandals","home",0,1,"Western Division","PBE",36,36,0,"36 - 36",4,320,342,704,116964,102400,72,0.533195966521398,38,34,"38 - 34","#183013",2,5,"2029"
11,100,686,2029-09-10,1905,9,7,10,"VAN","Vancouver Vandals","home",1,0,"Western Division","PBE",37,36,1,"37 - 36",1,321,349,714,121801,103041,73,0.541718184324993,40,33,"40 - 33","#183013",2,5,"2029"
11,100,691,2029-09-11,1905,9,5,9,"VAN","Vancouver Vandals","home",1,0,"Western Division","PBE",38,36,2,"38 - 36",3,324,354,723,125316,104976,74,0.544161325621385,40,34,"40 - 34","#183013",2,5,"2029"
11,100,698,2029-09-14,1905,9,2,5,"VAN","Vancouver Vandals","away",1,0,"Western Division","PBE",39,36,3,"39 - 36",1,325,356,728,126736,105625,75,0.545427158602347,41,34,"41 - 34","#183013",2,5,"2029"
11,100,703,2029-09-15,1905,9,4,6,"VAN","Vancouver Vandals","away",0,1,"Western Division","PBE",39,37,2,"39 - 37",5,330,360,734,129600,108900,76,0.543396226415094,41,35,"41 - 35","#183013",2,5,"2029"
11,100,708,2029-09-16,1905,9,9,11,"VAN","Vancouver Vandals","away",1,0,"Western Division","PBE",40,37,3,"40 - 37",7,337,369,745,136161,113569,77,0.545232851479598,42,35,"42 - 35","#183013",2,5,"2029"
11,100,713,2029-09-17,1905,9,7,13,"VAN","Vancouver Vandals","away",1,0,"Western Division","PBE",41,37,4,"41 - 37",4,341,376,758,141376,116281,78,0.548698463461113,43,35,"43 - 35","#183013",2,5,"2029"
11,100,718,2029-09-20,1905,9,1,6,"VAN","Vancouver Vandals","away",0,1,"Western Division","PBE",41,38,3,"41 - 38",4,345,377,764,142129,119025,79,0.544234436386194,43,36,"43 - 36","#183013",2,5,"2029"
11,100,723,2029-09-21,1905,9,5,7,"VAN","Vancouver Vandals","away",0,1,"Western Division","PBE",41,39,2,"41 - 39",6,351,382,771,145924,123201,80,0.542216442173711,43,37,"43 - 37","#183013",2,5,"2029"
11,100,728,2029-09-22,1905,9,7,10,"VAN","Vancouver Vandals","away",1,0,"Western Division","PBE",42,39,3,"42 - 39",3,354,389,781,151321,125316,81,0.547002027928296,44,37,"44 - 37","#183013",2,5,"2029"
11,100,733,2029-09-23,1905,9,7,11,"VAN","Vancouver Vandals","away",1,0,"Western Division","PBE",43,39,4,"43 - 39",1,355,396,792,156816,126025,82,0.55443164180582,45,37,"45 - 37","#183013",2,5,"2029"
11,100,737,2029-09-25,1905,9,8,9,"VAN","Vancouver Vandals","home",0,1,"Western Division","PBE",43,40,3,"43 - 40",11,366,404,801,163216,133956,83,0.549230748522741,46,37,"46 - 37","#183013",2,5,"2029"
11,100,742,2029-09-26,1905,9,7,10,"VAN","Vancouver Vandals","home",1,0,"Western Division","PBE",44,40,4,"44 - 40",5,371,411,811,168921,137641,84,0.551017412464689,46,38,"46 - 38","#183013",2,5,"2029"
11,100,747,2029-09-27,1905,9,4,7,"VAN","Vancouver Vandals","home",1,0,"Western Division","PBE",45,40,5,"45 - 40",3,374,415,818,172225,139876,85,0.551824569610479,47,38,"47 - 38","#183013",2,5,"2029"
11,100,751,2029-09-28,1905,9,4,9,"VAN","Vancouver Vandals","home",0,1,"Western Division","PBE",45,41,4,"45 - 41",5,379,419,827,175561,143641,86,0.549999686718755,47,39,"47 - 39","#183013",2,5,"2029"
11,100,756,2029-09-30,1905,9,1,4,"VAN","Vancouver Vandals","away",0,1,"Western Division","PBE",45,42,3,"45 - 42",2,381,420,831,176400,145161,87,0.548573987517143,48,39,"48 - 39","#183013",2,5,"2029"
11,100,761,2029-10-01,1905,9,18,19,"VAN","Vancouver Vandals","away",1,0,"Western Division","PBE",46,42,4,"46 - 42",1,382,438,850,191844,145924,88,0.567975651926766,50,38,"50 - 38","#183013",2,5,"2029"
11,100,766,2029-10-02,1905,9,8,12,"VAN","Vancouver Vandals","away",1,0,"Western Division","PBE",47,42,5,"47 - 42",2,384,446,862,198916,147456,89,0.574284295497327,51,38,"51 - 38","#183013",2,5,"2029"
11,100,771,2029-10-03,1905,9,5,9,"VAN","Vancouver Vandals","away",1,0,"Western Division","PBE",48,42,6,"48 - 42",1,385,451,871,203401,148225,90,0.578458362009635,52,38,"52 - 38","#183013",2,5,"2029"
11,100,776,2029-10-05,1905,12,9,19,"VAN","Vancouver Vandals","away",0,1,"Western Division","PBE",48,43,5,"48 - 43",13,398,460,890,211600,158404,91,0.571885709343683,52,39,"52 - 39","#183013",2,5,"2029"
11,100,781,2029-10-06,1905,9,2,7,"VAN","Vancouver Vandals","away",0,1,"Western Division","PBE",48,44,4,"48 - 44",4,402,462,897,213444,161604,92,0.569111153772317,52,40,"52 - 40","#183013",2,5,"2029"
11,100,786,2029-10-07,1905,9,3,6,"VAN","Vancouver Vandals","away",0,1,"Western Division","PBE",48,45,3,"48 - 45",5,407,465,903,216225,165649,93,0.566220795340872,53,40,"53 - 40","#183013",2,5,"2029"
11,100,792,2029-10-10,1905,11,5,10,"VAN","Vancouver Vandals","home",1,0,"Western Division","PBE",49,45,4,"49 - 45",4,411,470,913,220900,168921,94,0.566670343567945,53,41,"53 - 41","#183013",2,5,"2029"
11,100,796,2029-10-11,1905,9,6,12,"VAN","Vancouver Vandals","home",1,0,"Western Division","PBE",50,45,5,"50 - 45",4,415,476,925,226576,172225,95,0.568143008668484,54,41,"54 - 41","#183013",2,5,"2029"
11,100,801,2029-10-12,1905,9,3,11,"VAN","Vancouver Vandals","home",0,1,"Western Division","PBE",50,46,4,"50 - 46",7,422,479,936,229441,178084,96,0.563010858229556,54,42,"54 - 42","#183013",2,5,"2029"
11,100,806,2029-10-13,1905,9,1,8,"VAN","Vancouver Vandals","home",0,1,"Western Division","PBE",50,47,3,"50 - 47",3,425,480,944,230400,180625,97,0.560549844899945,54,43,"54 - 43","#183013",2,5,"2029"
11,100,813,2029-10-15,1905,9,10,14,"VAN","Vancouver Vandals","home",1,0,"Western Division","PBE",51,47,4,"51 - 47",2,427,490,958,240100,182329,98,0.56837953833662,56,42,"56 - 42","#183013",2,5,"2029"
11,100,818,2029-10-16,1905,9,10,13,"VAN","Vancouver Vandals","home",1,0,"Western Division","PBE",52,47,5,"52 - 47",3,430,500,971,250000,184900,99,0.574844791906185,57,42,"57 - 42","#183013",2,5,"2029"
11,100,823,2029-10-17,1905,9,8,9,"VAN","Vancouver Vandals","home",1,0,"Western Division","PBE",53,47,6,"53 - 47",5,435,508,980,258064,189225,100,0.576951367013273,58,42,"58 - 42","#183013",2,5,"2029"
16,101,303,2029-05-16,1905,9,4,14,"ANC","Anchorage Wheelers","home",0,1,"West Division","MiLPBE",0,1,-1,"0 - 1",6,6,4,14,16,36,1,0.307692307692308,0,1,"0 - 1","#007EF3",3,4,"2029"
16,101,306,2029-05-17,1905,9,11,12,"ANC","Anchorage Wheelers","home",0,1,"West Division","MiLPBE",0,2,-2,"0 - 2",12,18,15,26,225,324,2,0.409836065573771,1,1,"1 - 1","#007EF3",3,4,"2029"
16,101,309,2029-05-18,1905,9,5,8,"ANC","Anchorage Wheelers","home",1,0,"West Division","MiLPBE",1,2,-1,"1 - 2",3,21,20,34,400,441,3,0.475624256837099,1,2,"1 - 2","#007EF3",3,4,"2029"
16,101,312,2029-05-19,1905,9,7,14,"ANC","Anchorage Wheelers","home",0,1,"West Division","MiLPBE",1,3,-2,"1 - 3",12,33,27,48,729,1089,4,0.400990099009901,2,2,"2 - 2","#007EF3",3,4,"2029"
16,101,314,2029-05-21,1905,9,3,9,"ANC","Anchorage Wheelers","home",0,1,"West Division","MiLPBE",1,4,-3,"1 - 4",4,37,30,57,900,1369,5,0.396650506831203,2,3,"2 - 3","#007EF3",3,4,"2029"
16,101,317,2029-05-22,1905,9,4,6,"ANC","Anchorage Wheelers","home",1,0,"West Division","MiLPBE",2,4,-2,"2 - 4",3,40,34,63,1156,1600,6,0.41944847605225,3,3,"3 - 3","#007EF3",3,4,"2029"
16,101,320,2029-05-23,1905,9,3,12,"ANC","Anchorage Wheelers","home",1,0,"West Division","MiLPBE",3,4,-1,"3 - 4",1,41,37,75,1369,1681,7,0.448852459016393,3,4,"3 - 4","#007EF3",3,4,"2029"
16,101,323,2029-05-24,1905,11,4,11,"ANC","Anchorage Wheelers","home",1,0,"West Division","MiLPBE",4,4,0,"4 - 4",3,44,41,86,1681,1936,8,0.464749792645839,4,4,"4 - 4","#007EF3",3,4,"2029"
16,101,327,2029-05-27,1905,9,1,9,"ANC","Anchorage Wheelers","home",0,1,"West Division","MiLPBE",4,5,-1,"4 - 5",8,52,42,95,1764,2704,9,0.394807520143241,4,5,"4 - 5","#007EF3",3,4,"2029"
16,101,330,2029-05-28,1905,9,7,14,"ANC","Anchorage Wheelers","home",1,0,"West Division","MiLPBE",5,5,0,"5 - 5",4,56,49,109,2401,3136,10,0.433628318584071,4,6,"4 - 6","#007EF3",3,4,"2029"
16,101,333,2029-05-29,1905,9,5,13,"ANC","Anchorage Wheelers","home",0,1,"West Division","MiLPBE",5,6,-1,"5 - 6",9,65,54,122,2916,4225,11,0.408346170004201,4,7,"4 - 7","#007EF3",3,4,"2029"
16,101,336,2029-05-30,1905,9,4,10,"ANC","Anchorage Wheelers","home",0,1,"West Division","MiLPBE",5,7,-2,"5 - 7",14,79,58,132,3364,6241,12,0.350234252993233,4,8,"4 - 8","#007EF3",3,4,"2029"
16,101,340,2029-06-02,1905,9,5,14,"ANC","Anchorage Wheelers","away",1,0,"West Division","MiLPBE",6,7,-1,"6 - 7",2,81,63,146,3969,6561,13,0.376923076923077,5,8,"5 - 8","#007EF3",3,4,"2029"
16,101,343,2029-06-03,1905,9,5,11,"ANC","Anchorage Wheelers","away",1,0,"West Division","MiLPBE",7,7,0,"7 - 7",0,81,68,157,4624,6561,14,0.413410818059902,6,8,"6 - 8","#007EF3",3,4,"2029"
16,101,346,2029-06-04,1905,9,12,13,"ANC","Anchorage Wheelers","away",1,0,"West Division","MiLPBE",8,7,1,"8 - 7",7,88,80,170,6400,7744,15,0.452488687782805,7,8,"7 - 8","#007EF3",3,4,"2029"
16,101,349,2029-06-05,1905,9,7,11,"ANC","Anchorage Wheelers","away",1,0,"West Division","MiLPBE",9,7,2,"9 - 7",6,94,87,181,7569,8836,16,0.461383724474246,7,9,"7 - 9","#007EF3",3,4,"2029"
16,101,352,2029-06-08,1905,9,8,13,"ANC","Anchorage Wheelers","home",1,0,"West Division","MiLPBE",10,7,3,"10 - 7",4,98,95,194,9025,9604,17,0.484459713350153,8,9,"8 - 9","#007EF3",3,4,"2029"
16,101,355,2029-06-09,1905,9,2,6,"ANC","Anchorage Wheelers","home",0,1,"West Division","MiLPBE",10,8,2,"10 - 8",5,103,97,200,9409,10609,18,0.47002697572185,8,10,"8 - 10","#007EF3",3,4,"2029"
16,101,358,2029-06-10,1905,9,2,5,"ANC","Anchorage Wheelers","home",0,1,"West Division","MiLPBE",10,9,1,"10 - 9",3,106,99,205,9801,11236,19,0.465893425868708,9,10,"9 - 10","#007EF3",3,4,"2029"
16,101,361,2029-06-11,1905,9,5,5,"ANC","Anchorage Wheelers","home",1,0,"West Division","MiLPBE",11,9,2,"11 - 9",4,110,104,210,10816,12100,20,0.471984639553151,9,11,"9 - 11","#007EF3",3,4,"2029"
16,101,363,2029-06-14,1905,9,1,2,"ANC","Anchorage Wheelers","away",0,1,"West Division","MiLPBE",11,10,1,"11 - 10",3,113,105,212,11025,12769,21,0.463352105572833,10,11,"10 - 11","#007EF3",3,4,"2029"
16,101,366,2029-06-15,1905,9,2,5,"ANC","Anchorage Wheelers","away",1,0,"West Division","MiLPBE",12,10,2,"12 - 10",0,113,107,217,11449,12769,22,0.472747543149723,10,12,"10 - 12","#007EF3",3,4,"2029"
16,101,369,2029-06-16,1905,9,3,11,"ANC","Anchorage Wheelers","away",1,0,"West Division","MiLPBE",13,10,3,"13 - 10",2,115,110,228,12100,13225,23,0.477788746298124,11,12,"11 - 12","#007EF3",3,4,"2029"
16,101,372,2029-06-17,1905,9,4,10,"ANC","Anchorage Wheelers","away",0,1,"West Division","MiLPBE",13,11,2,"13 - 11",5,120,114,238,12996,14400,24,0.474375821287779,11,13,"11 - 13","#007EF3",3,4,"2029"
16,101,374,2029-06-20,1905,9,2,6,"ANC","Anchorage Wheelers","away",0,1,"West Division","MiLPBE",13,12,1,"13 - 12",5,125,116,244,13456,15625,25,0.462707609779581,12,13,"12 - 13","#007EF3",3,4,"2029"
16,101,377,2029-06-21,1905,9,4,10,"ANC","Anchorage Wheelers","away",1,0,"West Division","MiLPBE",14,12,2,"14 - 12",3,128,120,254,14400,16384,26,0.467775467775468,12,14,"12 - 14","#007EF3",3,4,"2029"
16,101,380,2029-06-22,1905,9,8,14,"ANC","Anchorage Wheelers","away",1,0,"West Division","MiLPBE",15,12,3,"15 - 12",0,128,128,268,16384,16384,27,0.5,14,13,"14 - 13","#007EF3",3,4,"2029"
16,101,509,2029-06-23,1905,9,4,8,"ANC","Anchorage Wheelers","away",1,0,"West Division","MiLPBE",16,12,4,"16 - 12",3,131,132,276,17424,17161,28,0.503802226398728,14,14,"14 - 14","#007EF3",3,4,"2029"
16,101,514,2029-07-15,1905,9,4,11,"ANC","Anchorage Wheelers","home",1,0,"West Division","MiLPBE",17,12,5,"17 - 12",1,132,136,287,18496,17424,29,0.514922048997773,15,14,"15 - 14","#007EF3",3,4,"2029"
16,101,516,2029-06-25,1905,9,10,12,"ANC","Anchorage Wheelers","away",1,0,"West Division","MiLPBE",18,12,6,"18 - 12",8,140,146,299,21316,19600,30,0.520969791768501,16,14,"16 - 14","#007EF3",3,4,"2029"
16,101,519,2029-06-26,1905,9,8,11,"ANC","Anchorage Wheelers","away",1,0,"West Division","MiLPBE",19,12,7,"19 - 12",3,143,154,310,23716,20449,31,0.536986301369863,17,14,"17 - 14","#007EF3",3,4,"2029"
16,101,522,2029-06-27,1905,9,6,8,"ANC","Anchorage Wheelers","away",0,1,"West Division","MiLPBE",19,13,6,"19 - 13",12,155,160,318,25600,24025,32,0.515869017632242,17,15,"17 - 15","#007EF3",3,4,"2029"
16,101,525,2029-06-28,1905,9,0,2,"ANC","Anchorage Wheelers","away",0,1,"West Division","MiLPBE",19,14,5,"19 - 14",8,163,160,320,25600,26569,33,0.490712875462439,16,17,"16 - 17","#007EF3",3,4,"2029"
16,101,529,2029-07-01,1905,9,6,13,"ANC","Anchorage Wheelers","home",1,0,"West Division","MiLPBE",20,14,6,"20 - 14",5,168,166,333,27556,28224,34,0.494012190749373,17,17,"17 - 17","#007EF3",3,4,"2029"
16,101,532,2029-07-02,1905,9,12,14,"ANC","Anchorage Wheelers","home",1,0,"West Division","MiLPBE",21,14,7,"21 - 14",0,168,178,347,31684,28224,35,0.52887761233892,19,16,"19 - 16","#007EF3",3,4,"2029"
16,101,535,2029-07-03,1905,9,6,12,"ANC","Anchorage Wheelers","home",1,0,"West Division","MiLPBE",22,14,8,"22 - 14",3,171,184,359,33856,29241,36,0.536570676894306,19,17,"19 - 17","#007EF3",3,4,"2029"
16,101,538,2029-07-04,1905,9,15,23,"ANC","Anchorage Wheelers","home",1,0,"West Division","MiLPBE",23,14,9,"23 - 14",6,177,199,382,39601,31329,37,0.558311010855773,21,16,"21 - 16","#007EF3",3,4,"2029"
16,101,541,2029-07-07,1905,9,5,10,"ANC","Anchorage Wheelers","away",1,0,"West Division","MiLPBE",24,14,10,"24 - 14",0,177,204,392,41616,31329,38,0.570512029611351,22,16,"22 - 16","#007EF3",3,4,"2029"
16,101,544,2029-07-08,1905,9,4,11,"ANC","Anchorage Wheelers","away",0,1,"West Division","MiLPBE",24,15,9,"24 - 15",5,182,208,403,43264,33124,39,0.566371681415929,22,17,"22 - 17","#007EF3",3,4,"2029"
16,101,547,2029-07-09,1905,9,3,6,"ANC","Anchorage Wheelers","away",0,1,"West Division","MiLPBE",24,16,8,"24 - 16",6,188,211,409,44521,35344,40,0.557453202278846,22,18,"22 - 18","#007EF3",3,4,"2029"
16,101,550,2029-07-10,1905,9,4,10,"ANC","Anchorage Wheelers","away",0,1,"West Division","MiLPBE",24,17,7,"24 - 17",5,193,215,419,46225,37249,41,0.553765244267676,23,18,"23 - 18","#007EF3",3,4,"2029"
16,101,552,2029-07-12,1905,11,5,10,"ANC","Anchorage Wheelers","home",0,1,"West Division","MiLPBE",24,18,6,"24 - 18",8,201,220,429,48400,40401,42,0.545038907219513,23,19,"23 - 19","#007EF3",3,4,"2029"
16,101,555,2029-07-13,1905,9,1,8,"ANC","Anchorage Wheelers","home",0,1,"West Division","MiLPBE",24,19,5,"24 - 19",7,208,221,437,48841,43264,43,0.530275229357798,23,20,"23 - 20","#007EF3",3,4,"2029"
16,101,558,2029-07-14,1905,9,6,10,"ANC","Anchorage Wheelers","home",1,0,"West Division","MiLPBE",25,19,6,"25 - 19",4,212,227,447,51529,44944,44,0.534128719952733,24,20,"24 - 20","#007EF3",3,4,"2029"
16,101,560,2029-07-18,1905,9,2,5,"ANC","Anchorage Wheelers","home",0,1,"West Division","MiLPBE",25,20,5,"25 - 20",5,217,229,452,52441,47089,45,0.526886365919823,24,21,"24 - 21","#007EF3",3,4,"2029"
16,101,563,2029-07-19,1905,9,7,14,"ANC","Anchorage Wheelers","home",0,1,"West Division","MiLPBE",25,21,4,"25 - 21",9,226,236,466,55696,51076,46,0.521634885550519,24,22,"24 - 22","#007EF3",3,4,"2029"
16,101,566,2029-07-20,1905,10,2,9,"ANC","Anchorage Wheelers","home",0,1,"West Division","MiLPBE",25,22,3,"25 - 22",5,231,238,475,56644,53361,47,0.514922048997773,24,23,"24 - 23","#007EF3",3,4,"2029"
16,101,569,2029-07-21,1905,9,4,10,"ANC","Anchorage Wheelers","home",0,1,"West Division","MiLPBE",25,23,2,"25 - 23",15,246,242,485,58564,60516,48,0.491803829358414,24,24,"24 - 24","#007EF3",3,4,"2029"
16,101,574,2029-07-24,1905,9,9,13,"ANC","Anchorage Wheelers","away",1,0,"West Division","MiLPBE",26,23,3,"26 - 23",2,248,251,498,63001,61504,49,0.506011806754749,25,24,"25 - 24","#007EF3",3,4,"2029"
16,101,577,2029-07-25,1905,9,3,5,"ANC","Anchorage Wheelers","away",0,1,"West Division","MiLPBE",26,24,2,"26 - 24",9,257,254,503,64516,66049,50,0.494129360854747,25,25,"25 - 25","#007EF3",3,4,"2029"
16,101,580,2029-07-26,1905,9,7,13,"ANC","Anchorage Wheelers","away",1,0,"West Division","MiLPBE",27,24,3,"27 - 24",2,259,261,516,68121,67081,51,0.503846096951229,26,25,"26 - 25","#007EF3",3,4,"2029"
16,101,583,2029-07-27,1905,9,4,13,"ANC","Anchorage Wheelers","away",1,0,"West Division","MiLPBE",28,24,4,"28 - 24",3,262,265,529,70225,68644,52,0.50569241515385,26,26,"26 - 26","#007EF3",3,4,"2029"
16,101,585,2029-08-13,1905,9,8,12,"ANC","Anchorage Wheelers","home",1,0,"West Division","MiLPBE",29,24,5,"29 - 24",6,268,273,541,74529,71824,53,0.509241354806529,27,26,"27 - 26","#007EF3",3,4,"2029"
16,101,588,2029-08-14,1905,9,5,8,"ANC","Anchorage Wheelers","home",0,1,"West Division","MiLPBE",29,25,4,"29 - 25",8,276,278,549,77284,76176,54,0.503610061253747,27,27,"27 - 27","#007EF3",3,4,"2029"
16,101,591,2029-08-15,1905,9,4,8,"ANC","Anchorage Wheelers","home",1,0,"West Division","MiLPBE",30,25,5,"30 - 25",1,277,282,557,79524,76729,55,0.508943828278497,28,27,"28 - 27","#007EF3",3,4,"2029"
16,101,594,2029-08-16,1905,11,5,10,"ANC","Anchorage Wheelers","home",0,1,"West Division","MiLPBE",30,26,4,"30 - 26",7,284,287,567,82369,80656,56,0.505253795430149,28,28,"28 - 28","#007EF3",3,4,"2029"
16,101,598,2029-08-19,1905,9,10,18,"ANC","Anchorage Wheelers","away",1,0,"West Division","MiLPBE",31,26,5,"31 - 26",6,290,297,585,88209,84100,57,0.511923347010313,29,28,"29 - 28","#007EF3",3,4,"2029"
16,101,601,2029-08-20,1905,9,8,16,"ANC","Anchorage Wheelers","away",0,1,"West Division","MiLPBE",31,27,4,"31 - 27",9,299,305,601,93025,89401,58,0.509932794667427,30,28,"30 - 28","#007EF3",3,4,"2029"
16,101,604,2029-08-21,1905,9,12,13,"ANC","Anchorage Wheelers","away",1,0,"West Division","MiLPBE",32,27,5,"32 - 27",3,302,317,614,100489,91204,59,0.524218411731258,31,28,"31 - 28","#007EF3",3,4,"2029"
16,101,607,2029-08-22,1905,9,14,19,"ANC","Anchorage Wheelers","away",1,0,"West Division","MiLPBE",33,27,6,"33 - 27",1,303,331,633,109561,91809,60,0.544078065253017,33,27,"33 - 27","#007EF3",3,4,"2029"
16,101,610,2029-08-25,1905,9,2,7,"ANC","Anchorage Wheelers","home",0,1,"West Division","MiLPBE",33,28,5,"33 - 28",5,308,333,640,110889,94864,61,0.538942324048738,33,28,"33 - 28","#007EF3",3,4,"2029"
16,101,613,2029-08-26,1905,9,3,9,"ANC","Anchorage Wheelers","home",0,1,"West Division","MiLPBE",33,29,4,"33 - 29",9,317,336,649,112896,100489,62,0.529071865407597,33,29,"33 - 29","#007EF3",3,4,"2029"
16,101,616,2029-08-27,1905,10,7,12,"ANC","Anchorage Wheelers","home",0,1,"West Division","MiLPBE",33,30,3,"33 - 30",8,325,343,661,117649,105625,63,0.526926556607576,33,30,"33 - 30","#007EF3",3,4,"2029"
16,101,619,2029-08-28,1905,9,2,6,"ANC","Anchorage Wheelers","home",1,0,"West Division","MiLPBE",34,30,4,"34 - 30",1,326,345,667,119025,106276,64,0.528293261015264,34,30,"34 - 30","#007EF3",3,4,"2029"
16,101,621,2029-08-31,1905,9,11,17,"ANC","Anchorage Wheelers","away",1,0,"West Division","MiLPBE",35,30,5,"35 - 30",7,333,356,684,126736,110889,65,0.533344555497107,35,30,"35 - 30","#007EF3",3,4,"2029"
16,101,624,2029-09-01,1905,9,9,12,"ANC","Anchorage Wheelers","away",1,0,"West Division","MiLPBE",36,30,6,"36 - 30",7,340,365,696,133225,115600,66,0.535416457349543,35,31,"35 - 31","#007EF3",3,4,"2029"
16,101,627,2029-09-02,1905,9,6,13,"ANC","Anchorage Wheelers","away",1,0,"West Division","MiLPBE",37,30,7,"37 - 30",1,341,371,709,137641,116281,67,0.542060160206678,36,31,"36 - 31","#007EF3",3,4,"2029"
16,101,950,2029-09-03,1905,10,2,12,"ANC","Anchorage Wheelers","away",0,1,"West Division","MiLPBE",37,31,6,"37 - 31",5,346,373,721,139129,119716,68,0.537499275628272,37,31,"37 - 31","#007EF3",3,4,"2029"
16,101,952,2029-09-06,1905,9,2,9,"ANC","Anchorage Wheelers","away",0,1,"West Division","MiLPBE",37,32,5,"37 - 32",5,351,375,730,140625,123201,69,0.533021764344682,37,32,"37 - 32","#007EF3",3,4,"2029"
16,101,955,2029-09-07,1905,9,2,7,"ANC","Anchorage Wheelers","away",0,1,"West Division","MiLPBE",37,33,4,"37 - 33",5,356,377,737,142129,126736,70,0.528625890316702,37,33,"37 - 33","#007EF3",3,4,"2029"
16,101,958,2029-09-08,1905,9,10,15,"ANC","Anchorage Wheelers","away",1,0,"West Division","MiLPBE",38,33,5,"38 - 33",1,357,387,752,149769,127449,71,0.540257126160639,38,33,"38 - 33","#007EF3",3,4,"2029"
16,101,961,2029-09-09,1905,9,2,6,"ANC","Anchorage Wheelers","away",1,0,"West Division","MiLPBE",39,33,6,"39 - 33",1,358,389,758,151321,128164,72,0.541427983612716,39,33,"39 - 33","#007EF3",3,4,"2029"
16,101,965,2029-09-12,1905,9,5,8,"ANC","Anchorage Wheelers","away",0,1,"West Division","MiLPBE",39,34,5,"39 - 34",8,366,394,766,155236,133956,73,0.536792165758389,39,34,"39 - 34","#007EF3",3,4,"2029"
16,101,968,2029-09-13,1905,9,4,13,"ANC","Anchorage Wheelers","away",1,0,"West Division","MiLPBE",40,34,6,"40 - 34",3,369,398,779,158404,136161,74,0.537755673620423,40,34,"40 - 34","#007EF3",3,4,"2029"
16,101,971,2029-09-14,1905,9,2,9,"ANC","Anchorage Wheelers","away",0,1,"West Division","MiLPBE",40,35,5,"40 - 35",4,373,400,788,160000,139129,75,0.534886286518525,40,35,"40 - 35","#007EF3",3,4,"2029"
16,101,974,2029-09-15,1905,9,18,21,"ANC","Anchorage Wheelers","away",1,0,"West Division","MiLPBE",41,35,6,"41 - 35",1,374,418,809,174724,139876,76,0.555384615384615,42,34,"42 - 34","#007EF3",3,4,"2029"
16,101,978,2029-09-18,1905,9,6,10,"ANC","Anchorage Wheelers","home",0,1,"West Division","MiLPBE",41,36,5,"41 - 36",11,385,424,819,179776,148225,77,0.548095889951555,42,35,"42 - 35","#007EF3",3,4,"2029"
16,101,981,2029-09-19,1905,9,2,8,"ANC","Anchorage Wheelers","home",0,1,"West Division","MiLPBE",41,37,4,"41 - 37",4,389,426,827,181476,151321,78,0.54530539638278,43,35,"43 - 35","#007EF3",3,4,"2029"
16,101,984,2029-09-20,1905,9,10,19,"ANC","Anchorage Wheelers","away",1,0,"West Division","MiLPBE",42,37,5,"42 - 37",0,389,436,846,190096,151321,79,0.556785397329366,44,35,"44 - 35","#007EF3",3,4,"2029"
16,101,987,2029-09-21,1905,9,4,8,"ANC","Anchorage Wheelers","away",0,1,"West Division","MiLPBE",42,38,4,"42 - 38",7,396,440,854,193600,156816,80,0.552486187845304,44,36,"44 - 36","#007EF3",3,4,"2029"
16,101,990,2029-09-23,1905,9,1,7,"ANC","Anchorage Wheelers","away",0,1,"West Division","MiLPBE",42,39,3,"42 - 39",9,405,441,861,194481,164025,81,0.542476276547673,44,37,"44 - 37","#007EF3",3,4,"2029"
16,101,993,2029-09-24,1905,14,6,14,"ANC","Anchorage Wheelers","away",0,1,"West Division","MiLPBE",42,40,2,"42 - 40",7,412,447,875,199809,169744,82,0.540677521221584,44,38,"44 - 38","#007EF3",3,4,"2029"
16,101,996,2029-09-25,1905,9,13,16,"ANC","Anchorage Wheelers","home",1,0,"West Division","MiLPBE",43,40,3,"43 - 40",11,423,460,891,211600,178929,83,0.541829159934345,45,38,"45 - 38","#007EF3",3,4,"2029"
16,101,999,2029-09-26,1905,9,0,2,"ANC","Anchorage Wheelers","home",0,1,"West Division","MiLPBE",43,41,2,"43 - 41",6,429,460,893,211600,184041,84,0.534828291304491,45,39,"45 - 39","#007EF3",3,4,"2029"
16,101,1001,2029-09-29,1905,9,5,7,"ANC","Anchorage Wheelers","home",1,0,"West Division","MiLPBE",44,41,3,"44 - 41",3,432,465,900,216225,186624,85,0.536739572395612,46,39,"46 - 39","#007EF3",3,4,"2029"
16,101,1004,2029-09-30,1905,9,4,8,"ANC","Anchorage Wheelers","home",1,0,"West Division","MiLPBE",45,41,4,"45 - 41",1,433,469,908,219961,187489,86,0.539847834090072,46,40,"46 - 40","#007EF3",3,4,"2029"
16,101,1007,2029-10-01,1905,9,6,11,"ANC","Anchorage Wheelers","away",0,1,"West Division","MiLPBE",45,42,3,"45 - 42",7,440,475,919,225625,193600,87,0.538195479754309,47,40,"47 - 40","#007EF3",3,4,"2029"
16,101,1010,2029-10-02,1905,9,2,6,"ANC","Anchorage Wheelers","away",0,1,"West Division","MiLPBE",45,43,2,"45 - 43",6,446,477,925,227529,198916,88,0.533548288759395,47,41,"47 - 41","#007EF3",3,4,"2029"
16,101,1012,2029-10-05,1905,9,1,5,"ANC","Anchorage Wheelers","home",0,1,"West Division","MiLPBE",45,44,1,"45 - 44",7,453,478,930,228484,205209,89,0.526833497427904,47,42,"47 - 42","#007EF3",3,4,"2029"
16,101,1015,2029-10-06,1905,11,8,12,"ANC","Anchorage Wheelers","home",1,0,"West Division","MiLPBE",46,44,2,"46 - 44",4,457,486,942,236196,208849,90,0.530723859385006,48,42,"48 - 42","#007EF3",3,4,"2029"
16,101,1018,2029-10-07,1905,9,0,4,"ANC","Anchorage Wheelers","away",0,1,"West Division","MiLPBE",46,45,1,"46 - 45",3,460,486,946,236196,211600,91,0.527463398511822,48,43,"48 - 43","#007EF3",3,4,"2029"
16,101,1021,2029-10-08,1905,9,5,9,"ANC","Anchorage Wheelers","away",1,0,"West Division","MiLPBE",47,45,2,"47 - 45",4,464,491,955,241081,215296,92,0.528249670776573,49,43,"49 - 43","#007EF3",3,4,"2029"
16,101,1025,2029-10-11,1905,10,5,12,"ANC","Anchorage Wheelers","home",0,1,"West Division","MiLPBE",47,46,1,"47 - 46",6,470,496,967,246016,220900,93,0.526895630049088,49,44,"49 - 44","#007EF3",3,4,"2029"
16,101,1028,2029-10-12,1905,9,0,6,"ANC","Anchorage Wheelers","home",0,1,"West Division","MiLPBE",47,47,0,"47 - 47",9,479,496,973,246016,229441,94,0.51743059835064,49,45,"49 - 45","#007EF3",3,4,"2029"
16,101,1031,2029-10-13,1905,9,3,5,"ANC","Anchorage Wheelers","away",0,1,"West Division","MiLPBE",47,48,-1,"47 - 48",13,492,499,978,249001,242064,95,0.507063219736695,48,47,"48 - 47","#007EF3",3,4,"2029"
16,101,1034,2029-10-14,1905,9,2,5,"ANC","Anchorage Wheelers","away",0,1,"West Division","MiLPBE",47,49,-2,"47 - 49",4,496,501,983,251001,246016,96,0.505014919006795,48,48,"48 - 48","#007EF3",3,4,"2029"
16,101,1038,2029-10-17,1905,9,11,12,"ANC","Anchorage Wheelers","home",1,0,"West Division","MiLPBE",48,49,-1,"48 - 49",3,499,512,995,262144,249001,97,0.512856430171478,50,47,"50 - 47","#007EF3",3,4,"2029"
16,101,1041,2029-10-18,1905,9,10,9,"ANC","Anchorage Wheelers","home",1,0,"West Division","MiLPBE",49,49,0,"49 - 49",3,502,522,1004,272484,252004,98,0.51952380226049,51,47,"51 - 47","#007EF3",3,4,"2029"
16,101,1044,2029-10-19,1905,10,4,10,"ANC","Anchorage Wheelers","home",0,1,"West Division","MiLPBE",49,50,-1,"49 - 50",6,508,526,1014,276676,258064,99,0.517402849983169,51,48,"51 - 48","#007EF3",3,4,"2029"
16,101,1047,2029-10-20,1905,9,5,12,"ANC","Anchorage Wheelers","home",0,1,"West Division","MiLPBE",49,51,-2,"49 - 51",7,515,531,1026,281961,265225,100,0.515292788923693,52,48,"52 - 48","#007EF3",3,4,"2029"
17,101,303,2029-05-16,1905,9,6,13,"KGN","Kingston Mounties","away",1,0,"East Division","MiLPBE",1,0,1,"1 - 0",4,4,6,13,36,16,1,0.692307692307692,1,0,"1 - 0","#6C0000",2,3,"2029"
17,101,306,2029-05-17,1905,9,12,13,"KGN","Kingston Mounties","away",1,0,"East Division","MiLPBE",2,0,2,"2 - 0",11,15,18,26,324,225,2,0.590163934426229,1,1,"1 - 1","#6C0000",2,3,"2029"
17,101,309,2029-05-18,1905,9,3,10,"KGN","Kingston Mounties","away",0,1,"East Division","MiLPBE",2,1,1,"2 - 1",5,20,21,36,441,400,3,0.524375743162901,2,1,"2 - 1","#6C0000",2,3,"2029"
17,101,312,2029-05-19,1905,9,12,12,"KGN","Kingston Mounties","away",1,0,"East Division","MiLPBE",3,1,2,"3 - 1",7,27,33,48,1089,729,4,0.599009900990099,2,2,"2 - 2","#6C0000",2,3,"2029"
17,101,316,2029-05-21,1905,9,3,9,"KGN","Kingston Mounties","home",0,1,"East Division","MiLPBE",3,2,1,"3 - 2",10,37,36,57,1296,1369,5,0.486303939962477,2,3,"2 - 3","#6C0000",2,3,"2029"
17,101,319,2029-05-22,1905,9,1,9,"KGN","Kingston Mounties","home",0,1,"East Division","MiLPBE",3,3,0,"3 - 3",14,51,37,66,1369,2601,6,0.344836272040302,2,4,"2 - 4","#6C0000",2,3,"2029"
17,101,322,2029-05-23,1905,9,1,6,"KGN","Kingston Mounties","home",0,1,"East Division","MiLPBE",3,4,-1,"3 - 4",3,54,38,72,1444,2916,7,0.331192660550459,2,5,"2 - 5","#6C0000",2,3,"2029"
17,101,325,2029-05-24,1905,9,14,14,"KGN","Kingston Mounties","home",1,0,"East Division","MiLPBE",4,4,0,"4 - 4",5,59,52,86,2704,3481,8,0.437186742118027,3,5,"3 - 5","#6C0000",2,3,"2029"
17,101,328,2029-05-27,1905,9,4,11,"KGN","Kingston Mounties","home",1,0,"East Division","MiLPBE",5,4,1,"5 - 4",1,60,56,97,3136,3600,9,0.465558194774347,4,5,"4 - 5","#6C0000",2,3,"2029"
17,101,331,2029-05-28,1905,9,4,8,"KGN","Kingston Mounties","home",0,1,"East Division","MiLPBE",5,5,0,"5 - 5",8,68,60,105,3600,4624,10,0.437743190661479,4,6,"4 - 6","#6C0000",2,3,"2029"
17,101,334,2029-05-29,1905,9,2,8,"KGN","Kingston Mounties","home",1,0,"East Division","MiLPBE",6,5,1,"6 - 5",1,69,62,113,3844,4761,11,0.446717024985474,5,6,"5 - 6","#6C0000",2,3,"2029"
17,101,337,2029-05-30,1905,9,3,6,"KGN","Kingston Mounties","home",0,1,"East Division","MiLPBE",6,6,0,"6 - 6",4,73,65,119,4225,5329,12,0.442223152606238,5,7,"5 - 7","#6C0000",2,3,"2029"
17,101,339,2029-06-02,1905,9,0,8,"KGN","Kingston Mounties","away",0,1,"East Division","MiLPBE",6,7,-1,"6 - 7",4,77,65,127,4225,5929,13,0.416092180421509,5,8,"5 - 8","#6C0000",2,3,"2029"
17,101,342,2029-06-03,1905,9,3,13,"KGN","Kingston Mounties","away",1,0,"East Division","MiLPBE",7,7,0,"7 - 7",2,79,68,140,4624,6241,14,0.425586746433502,6,8,"6 - 8","#6C0000",2,3,"2029"
17,101,345,2029-06-04,1905,9,3,8,"KGN","Kingston Mounties","away",0,1,"East Division","MiLPBE",7,8,-1,"7 - 8",8,87,71,148,5041,7569,15,0.399762093576527,6,9,"6 - 9","#6C0000",2,3,"2029"
17,101,348,2029-06-05,1905,9,5,13,"KGN","Kingston Mounties","away",1,0,"East Division","MiLPBE",8,8,0,"8 - 8",0,87,76,161,5776,7569,16,0.432821281378794,7,9,"7 - 9","#6C0000",2,3,"2029"
17,101,350,2029-06-08,1905,9,3,3,"KGN","Kingston Mounties","away",0,1,"East Division","MiLPBE",8,9,-1,"8 - 9",5,92,79,164,6241,8464,17,0.424413464807888,7,10,"7 - 10","#6C0000",2,3,"2029"
17,101,353,2029-06-09,1905,9,3,11,"KGN","Kingston Mounties","away",0,1,"East Division","MiLPBE",8,10,-2,"8 - 10",5,97,82,175,6724,9409,18,0.41678547077419,8,10,"8 - 10","#6C0000",2,3,"2029"
17,101,356,2029-06-10,1905,9,7,9,"KGN","Kingston Mounties","away",1,0,"East Division","MiLPBE",9,10,-1,"9 - 10",5,102,89,184,7921,10404,19,0.43225102319236,8,11,"8 - 11","#6C0000",2,3,"2029"
17,101,359,2029-06-11,1905,9,1,6,"KGN","Kingston Mounties","away",1,0,"East Division","MiLPBE",10,10,0,"10 - 10",0,102,90,190,8100,10404,20,0.437743190661479,9,11,"9 - 11","#6C0000",2,3,"2029"
17,101,363,2029-06-14,1905,9,3,10,"KGN","Kingston Mounties","home",1,0,"East Division","MiLPBE",11,10,1,"11 - 10",1,103,93,200,8649,10609,21,0.449112057326825,9,12,"9 - 12","#6C0000",2,3,"2029"
17,101,366,2029-06-15,1905,9,0,2,"KGN","Kingston Mounties","home",0,1,"East Division","MiLPBE",11,11,0,"11 - 11",2,105,93,202,8649,11025,22,0.439615736505032,10,12,"10 - 12","#6C0000",2,3,"2029"
17,101,369,2029-06-16,1905,9,2,7,"KGN","Kingston Mounties","home",0,1,"East Division","MiLPBE",11,12,-1,"11 - 12",3,108,95,209,9025,11664,23,0.436222147034656,10,13,"10 - 13","#6C0000",2,3,"2029"
17,101,372,2029-06-17,1905,9,5,8,"KGN","Kingston Mounties","home",1,0,"East Division","MiLPBE",12,12,0,"12 - 12",4,112,100,217,10000,12544,24,0.443577004968062,11,13,"11 - 13","#6C0000",2,3,"2029"
17,101,376,2029-06-20,1905,9,4,12,"KGN","Kingston Mounties","away",0,1,"East Division","MiLPBE",12,13,-1,"12 - 13",6,118,104,229,10816,13924,25,0.437186742118027,11,14,"11 - 14","#6C0000",2,3,"2029"
17,101,379,2029-06-21,1905,9,1,8,"KGN","Kingston Mounties","away",0,1,"East Division","MiLPBE",12,14,-2,"12 - 14",2,120,105,237,11025,14400,26,0.433628318584071,11,15,"11 - 15","#6C0000",2,3,"2029"
17,101,508,2029-06-22,1905,9,9,13,"KGN","Kingston Mounties","away",1,0,"East Division","MiLPBE",13,14,-1,"13 - 14",6,126,114,250,12996,15876,27,0.450124688279302,12,15,"12 - 15","#6C0000",2,3,"2029"
17,101,511,2029-06-23,1905,9,6,10,"KGN","Kingston Mounties","away",1,0,"East Division","MiLPBE",14,14,0,"14 - 14",5,131,120,260,14400,17161,28,0.456259307373024,13,15,"13 - 15","#6C0000",2,3,"2029"
17,101,514,2029-07-15,1905,9,1,8,"KGN","Kingston Mounties","away",0,1,"East Division","MiLPBE",14,15,-1,"14 - 15",4,135,121,268,14641,18225,29,0.445475567455729,13,16,"13 - 16","#6C0000",2,3,"2029"
17,101,517,2029-06-25,1905,9,2,7,"KGN","Kingston Mounties","away",0,1,"East Division","MiLPBE",14,16,-2,"14 - 16",5,140,123,275,15129,19600,30,0.435630164991794,13,17,"13 - 17","#6C0000",2,3,"2029"
17,101,520,2029-06-26,1905,9,2,11,"KGN","Kingston Mounties","away",0,1,"East Division","MiLPBE",14,17,-3,"14 - 17",4,144,125,286,15625,20736,31,0.429718654602459,13,18,"13 - 18","#6C0000",2,3,"2029"
17,101,523,2029-06-27,1905,9,8,8,"KGN","Kingston Mounties","away",1,0,"East Division","MiLPBE",15,17,-2,"15 - 17",5,149,133,294,17689,22201,32,0.443444472298822,14,18,"14 - 18","#6C0000",2,3,"2029"
17,101,526,2029-06-28,1905,9,7,8,"KGN","Kingston Mounties","away",1,0,"East Division","MiLPBE",16,17,-1,"16 - 17",3,152,140,302,19600,23104,33,0.458973398276508,15,18,"15 - 18","#6C0000",2,3,"2029"
17,101,528,2029-07-01,1905,9,11,16,"KGN","Kingston Mounties","home",1,0,"East Division","MiLPBE",17,17,0,"17 - 17",5,157,151,318,22801,24649,34,0.480526870389884,16,18,"16 - 18","#6C0000",2,3,"2029"
17,101,531,2029-07-02,1905,9,6,9,"KGN","Kingston Mounties","home",1,0,"East Division","MiLPBE",18,17,1,"18 - 17",5,162,157,327,24649,26244,35,0.484329868547737,17,18,"17 - 18","#6C0000",2,3,"2029"
17,101,534,2029-07-03,1905,9,10,15,"KGN","Kingston Mounties","home",1,0,"East Division","MiLPBE",19,17,2,"19 - 17",1,163,167,342,27889,26569,36,0.512119431488486,18,18,"18 - 18","#6C0000",2,3,"2029"
17,101,537,2029-07-04,1905,9,8,9,"KGN","Kingston Mounties","home",1,0,"East Division","MiLPBE",20,17,3,"20 - 17",7,170,175,351,30625,28900,37,0.514489710205796,19,18,"19 - 18","#6C0000",2,3,"2029"
17,101,539,2029-07-07,1905,9,2,4,"KGN","Kingston Mounties","home",0,1,"East Division","MiLPBE",20,18,2,"20 - 18",7,177,177,355,31329,31329,38,0.5,19,19,"19 - 19","#6C0000",2,3,"2029"
17,101,542,2029-07-08,1905,9,4,11,"KGN","Kingston Mounties","home",1,0,"East Division","MiLPBE",21,18,3,"21 - 18",0,177,181,366,32761,31329,39,0.511171789670775,20,19,"20 - 19","#6C0000",2,3,"2029"
17,101,545,2029-07-09,1905,9,3,8,"KGN","Kingston Mounties","home",0,1,"East Division","MiLPBE",21,19,2,"21 - 19",7,184,184,374,33856,33856,40,0.5,20,20,"20 - 20","#6C0000",2,3,"2029"
17,101,548,2029-07-10,1905,12,4,11,"KGN","Kingston Mounties","home",1,0,"East Division","MiLPBE",22,19,3,"22 - 19",3,187,188,385,35344,34969,41,0.502666647703839,21,20,"21 - 20","#6C0000",2,3,"2029"
17,101,552,2029-07-12,1905,11,8,15,"KGN","Kingston Mounties","away",1,0,"East Division","MiLPBE",23,19,4,"23 - 19",5,192,196,400,38416,36864,42,0.510308182784272,21,21,"21 - 21","#6C0000",2,3,"2029"
17,101,555,2029-07-13,1905,9,7,14,"KGN","Kingston Mounties","away",1,0,"East Division","MiLPBE",24,19,5,"24 - 19",1,193,203,414,41209,37249,43,0.525236432231257,23,20,"23 - 20","#6C0000",2,3,"2029"
17,101,558,2029-07-14,1905,9,4,7,"KGN","Kingston Mounties","away",0,1,"East Division","MiLPBE",24,20,4,"24 - 20",6,199,207,421,42849,39601,44,0.519696785930867,23,21,"23 - 21","#6C0000",2,3,"2029"
17,101,562,2029-07-18,1905,9,6,10,"KGN","Kingston Mounties","home",0,1,"East Division","MiLPBE",24,21,3,"24 - 21",8,207,213,431,45369,42849,45,0.514282799428688,23,22,"23 - 22","#6C0000",2,3,"2029"
17,101,565,2029-07-19,1905,9,1,6,"KGN","Kingston Mounties","home",0,1,"East Division","MiLPBE",24,22,2,"24 - 22",3,210,214,437,45796,44100,46,0.509433122719587,23,23,"23 - 23","#6C0000",2,3,"2029"
17,101,568,2029-07-20,1905,9,8,12,"KGN","Kingston Mounties","home",1,0,"East Division","MiLPBE",25,22,3,"25 - 22",3,213,222,449,49284,45369,47,0.520680802510222,24,23,"24 - 23","#6C0000",2,3,"2029"
17,101,571,2029-07-21,1905,9,2,3,"KGN","Kingston Mounties","home",0,1,"East Division","MiLPBE",25,23,2,"25 - 23",6,219,224,452,50176,47961,48,0.511285244097537,25,23,"25 - 23","#6C0000",2,3,"2029"
17,101,572,2029-07-24,1905,9,5,9,"KGN","Kingston Mounties","home",0,1,"East Division","MiLPBE",25,24,1,"25 - 24",6,225,229,461,52441,50625,49,0.508809888809113,25,24,"25 - 24","#6C0000",2,3,"2029"
17,101,575,2029-07-25,1905,9,8,12,"KGN","Kingston Mounties","home",1,0,"East Division","MiLPBE",26,24,2,"26 - 24",1,226,237,473,56169,51076,50,0.523744696722458,26,24,"26 - 24","#6C0000",2,3,"2029"
17,101,578,2029-07-26,1905,9,2,7,"KGN","Kingston Mounties","home",0,1,"East Division","MiLPBE",26,25,1,"26 - 25",5,231,239,480,57121,53361,51,0.51701634655419,26,25,"26 - 25","#6C0000",2,3,"2029"
17,101,581,2029-07-27,1905,10,1,7,"KGN","Kingston Mounties","home",0,1,"East Division","MiLPBE",26,26,0,"26 - 26",2,233,240,487,57600,54289,52,0.514795913807434,27,25,"27 - 25","#6C0000",2,3,"2029"
17,101,586,2029-08-13,1905,9,5,8,"KGN","Kingston Mounties","home",1,0,"East Division","MiLPBE",27,26,1,"27 - 26",2,235,245,495,60025,55225,53,0.520824295010846,28,25,"28 - 25","#6C0000",2,3,"2029"
17,101,589,2029-08-14,1905,9,3,4,"KGN","Kingston Mounties","home",1,0,"East Division","MiLPBE",28,26,2,"28 - 26",1,236,248,499,61504,55696,54,0.524778156996587,28,26,"28 - 26","#6C0000",2,3,"2029"
17,101,592,2029-08-15,1905,9,3,11,"KGN","Kingston Mounties","home",1,0,"East Division","MiLPBE",29,26,3,"29 - 26",1,237,251,510,63001,56169,55,0.528664932449442,29,26,"29 - 26","#6C0000",2,3,"2029"
17,101,595,2029-08-16,1905,9,8,9,"KGN","Kingston Mounties","home",1,0,"East Division","MiLPBE",30,26,4,"30 - 26",1,238,259,519,67081,56644,56,0.542178217821782,30,26,"30 - 26","#6C0000",2,3,"2029"
17,101,597,2029-08-19,1905,9,8,10,"KGN","Kingston Mounties","away",1,0,"East Division","MiLPBE",31,26,5,"31 - 26",2,240,267,529,71289,57600,57,0.553103833531178,32,25,"32 - 25","#6C0000",2,3,"2029"
17,101,600,2029-08-20,1905,9,6,13,"KGN","Kingston Mounties","away",1,0,"East Division","MiLPBE",32,26,6,"32 - 26",5,245,273,542,74529,60025,58,0.553896576839039,32,26,"32 - 26","#6C0000",2,3,"2029"
17,101,603,2029-08-21,1905,9,8,15,"KGN","Kingston Mounties","away",0,1,"East Division","MiLPBE",32,27,5,"32 - 27",9,254,281,557,78961,64516,59,0.550339078737359,32,27,"32 - 27","#6C0000",2,3,"2029"
17,101,606,2029-08-22,1905,9,3,10,"KGN","Kingston Mounties","away",0,1,"East Division","MiLPBE",32,28,4,"32 - 28",11,265,284,567,80656,70225,60,0.534566976623962,32,28,"32 - 28","#6C0000",2,3,"2029"
17,101,608,2029-08-25,1905,9,1,5,"KGN","Kingston Mounties","away",0,1,"East Division","MiLPBE",32,29,3,"32 - 29",9,274,285,572,81225,75076,61,0.519670379588102,32,29,"32 - 29","#6C0000",2,3,"2029"
17,101,611,2029-08-26,1905,9,5,9,"KGN","Kingston Mounties","away",0,1,"East Division","MiLPBE",32,30,2,"32 - 30",7,281,290,581,84100,78961,62,0.515757906550309,32,30,"32 - 30","#6C0000",2,3,"2029"
17,101,614,2029-08-27,1905,9,4,6,"KGN","Kingston Mounties","away",1,0,"East Division","MiLPBE",33,30,3,"33 - 30",0,281,294,587,86436,78961,63,0.522597145050999,33,30,"33 - 30","#6C0000",2,3,"2029"
17,101,617,2029-08-28,1905,9,7,10,"KGN","Kingston Mounties","away",1,0,"East Division","MiLPBE",34,30,4,"34 - 30",4,285,301,597,90601,81225,64,0.527283414617113,34,30,"34 - 30","#6C0000",2,3,"2029"
17,101,621,2029-08-31,1905,9,7,9,"KGN","Kingston Mounties","home",0,1,"East Division","MiLPBE",34,31,3,"34 - 31",11,296,308,606,94864,87616,65,0.519859710653222,34,31,"34 - 31","#6C0000",2,3,"2029"
17,101,624,2029-09-01,1905,9,7,13,"KGN","Kingston Mounties","home",0,1,"East Division","MiLPBE",34,32,2,"34 - 32",9,305,315,619,99225,93025,66,0.516124837451235,34,32,"34 - 32","#6C0000",2,3,"2029"
17,101,627,2029-09-02,1905,9,1,2,"KGN","Kingston Mounties","home",0,1,"East Division","MiLPBE",34,33,1,"34 - 33",6,311,316,621,99856,96721,67,0.507973974574848,34,33,"34 - 33","#6C0000",2,3,"2029"
17,101,950,2029-09-03,1905,10,5,8,"KGN","Kingston Mounties","home",1,0,"East Division","MiLPBE",35,33,2,"35 - 33",2,313,321,629,103041,97969,68,0.512616287746878,35,33,"35 - 33","#6C0000",2,3,"2029"
17,101,954,2029-09-06,1905,9,4,12,"KGN","Kingston Mounties","away",0,1,"East Division","MiLPBE",35,34,1,"35 - 34",8,321,325,641,105625,103041,69,0.506191713072566,35,34,"35 - 34","#6C0000",2,3,"2029"
17,101,957,2029-09-07,1905,9,3,3,"KGN","Kingston Mounties","away",1,0,"East Division","MiLPBE",36,34,2,"36 - 34",2,323,328,644,107584,104329,70,0.507680038506368,36,34,"36 - 34","#6C0000",2,3,"2029"
17,101,960,2029-09-08,1905,9,9,14,"KGN","Kingston Mounties","away",1,0,"East Division","MiLPBE",37,34,3,"37 - 34",0,323,337,658,113569,104329,71,0.521202581024149,37,34,"37 - 34","#6C0000",2,3,"2029"
17,101,963,2029-09-09,1905,9,10,12,"KGN","Kingston Mounties","away",1,0,"East Division","MiLPBE",38,34,4,"38 - 34",6,329,347,670,120409,108241,72,0.526608353378526,38,34,"38 - 34","#6C0000",2,3,"2029"
17,101,966,2029-09-12,1905,9,2,10,"KGN","Kingston Mounties","away",0,1,"East Division","MiLPBE",38,35,3,"38 - 35",8,337,349,680,121801,113569,73,0.517487360326295,38,35,"38 - 35","#6C0000",2,3,"2029"
17,101,969,2029-09-13,1905,9,5,13,"KGN","Kingston Mounties","away",0,1,"East Division","MiLPBE",38,36,2,"38 - 36",11,348,354,693,125316,121104,74,0.50854638422206,38,36,"38 - 36","#6C0000",2,3,"2029"
17,101,972,2029-09-14,1905,9,3,9,"KGN","Kingston Mounties","away",0,1,"East Division","MiLPBE",38,37,1,"38 - 37",10,358,357,702,127449,128164,75,0.498601401337178,37,38,"37 - 38","#6C0000",2,3,"2029"
17,101,975,2029-09-15,1905,9,6,10,"KGN","Kingston Mounties","away",1,0,"East Division","MiLPBE",39,37,2,"39 - 37",0,358,363,712,131769,128164,76,0.506934479269658,39,37,"39 - 37","#6C0000",2,3,"2029"
17,101,977,2029-09-18,1905,9,0,3,"KGN","Kingston Mounties","home",0,1,"East Division","MiLPBE",39,38,1,"39 - 38",2,360,363,715,131769,129600,77,0.504149306153369,39,38,"39 - 38","#6C0000",2,3,"2029"
17,101,980,2029-09-19,1905,9,3,11,"KGN","Kingston Mounties","home",0,1,"East Division","MiLPBE",39,39,0,"39 - 39",5,365,366,726,133956,133225,78,0.501367986496046,39,39,"39 - 39","#6C0000",2,3,"2029"
17,101,983,2029-09-20,1905,9,5,8,"KGN","Kingston Mounties","away",1,0,"East Division","MiLPBE",40,39,1,"40 - 39",2,367,371,734,137641,134689,79,0.505419894980355,40,39,"40 - 39","#6C0000",2,3,"2029"
17,101,986,2029-09-21,1905,9,1,3,"KGN","Kingston Mounties","away",0,1,"East Division","MiLPBE",40,40,0,"40 - 40",4,371,372,737,138384,137641,80,0.501345892582194,40,40,"40 - 40","#6C0000",2,3,"2029"
17,101,988,2029-09-23,1905,9,3,6,"KGN","Kingston Mounties","home",0,1,"East Division","MiLPBE",40,41,-1,"40 - 41",8,379,375,743,140625,143641,81,0.494695109510107,40,41,"40 - 41","#6C0000",2,3,"2029"
17,101,991,2029-09-24,1905,9,4,8,"KGN","Kingston Mounties","home",1,0,"East Division","MiLPBE",41,41,0,"41 - 41",1,380,379,751,143641,144400,82,0.498682479230387,41,41,"41 - 41","#6C0000",2,3,"2029"
17,101,994,2029-09-25,1905,9,8,14,"KGN","Kingston Mounties","away",1,0,"East Division","MiLPBE",42,41,1,"42 - 41",4,384,387,765,149769,147456,83,0.503890991672975,42,41,"42 - 41","#6C0000",2,3,"2029"
17,101,997,2029-09-26,1905,9,6,11,"KGN","Kingston Mounties","away",0,1,"East Division","MiLPBE",42,42,0,"42 - 42",8,392,393,776,154449,153664,84,0.501273883283081,42,42,"42 - 42","#6C0000",2,3,"2029"
17,101,1001,2029-09-29,1905,9,3,12,"KGN","Kingston Mounties","away",0,1,"East Division","MiLPBE",42,43,-1,"42 - 43",5,397,396,788,156816,157609,85,0.498738967957383,42,43,"42 - 43","#6C0000",2,3,"2029"
17,101,1004,2029-09-30,1905,9,1,7,"KGN","Kingston Mounties","away",0,1,"East Division","MiLPBE",42,44,-2,"42 - 44",4,401,397,795,157609,160801,86,0.494987594610722,43,43,"43 - 43","#6C0000",2,3,"2029"
17,101,1007,2029-10-01,1905,9,7,12,"KGN","Kingston Mounties","home",1,0,"East Division","MiLPBE",43,44,-1,"43 - 44",6,407,404,807,163216,165649,87,0.496300913748803,43,44,"43 - 44","#6C0000",2,3,"2029"
17,101,1010,2029-10-02,1905,9,6,11,"KGN","Kingston Mounties","home",1,0,"East Division","MiLPBE",44,44,0,"44 - 44",2,409,410,818,168100,167281,88,0.501220999400682,44,44,"44 - 44","#6C0000",2,3,"2029"
17,101,1014,2029-10-05,1905,9,3,7,"KGN","Kingston Mounties","home",0,1,"East Division","MiLPBE",44,45,-1,"44 - 45",8,417,413,825,170569,173889,89,0.495180834818759,44,45,"44 - 45","#6C0000",2,3,"2029"
17,101,1017,2029-10-06,1905,9,4,7,"KGN","Kingston Mounties","home",1,0,"East Division","MiLPBE",45,45,0,"45 - 45",1,418,417,832,173889,174724,90,0.498802396927252,45,45,"45 - 45","#6C0000",2,3,"2029"
17,101,1020,2029-10-07,1905,9,8,13,"KGN","Kingston Mounties","away",0,1,"East Division","MiLPBE",45,46,-1,"45 - 46",9,427,425,845,180625,182329,91,0.497652595094695,45,46,"45 - 46","#6C0000",2,3,"2029"
17,101,1023,2029-10-08,1905,9,6,9,"KGN","Kingston Mounties","away",1,0,"East Division","MiLPBE",46,46,0,"46 - 46",3,430,431,854,185761,184900,92,0.501161438619116,46,46,"46 - 46","#6C0000",2,3,"2029"
17,101,1026,2029-10-11,1905,9,0,8,"KGN","Kingston Mounties","home",0,1,"East Division","MiLPBE",46,47,-1,"46 - 47",2,432,431,862,185761,186624,93,0.498841253004283,46,47,"46 - 47","#6C0000",2,3,"2029"
17,101,1029,2029-10-12,1905,9,2,6,"KGN","Kingston Mounties","home",0,1,"East Division","MiLPBE",46,48,-2,"46 - 48",5,437,433,868,187489,190969,94,0.495402396038662,47,47,"47 - 47","#6C0000",2,3,"2029"
17,101,1032,2029-10-13,1905,9,3,10,"KGN","Kingston Mounties","away",1,0,"East Division","MiLPBE",47,48,-1,"47 - 48",2,439,436,878,190096,192721,95,0.496571468874162,47,48,"47 - 48","#6C0000",2,3,"2029"
17,101,1035,2029-10-14,1905,9,4,7,"KGN","Kingston Mounties","away",0,1,"East Division","MiLPBE",47,49,-2,"47 - 49",7,446,440,885,193600,198916,96,0.493228301521467,47,49,"47 - 49","#6C0000",2,3,"2029"
17,101,1037,2029-10-17,1905,9,3,12,"KGN","Kingston Mounties","home",1,0,"East Division","MiLPBE",48,49,-1,"48 - 49",0,446,443,897,196249,198916,97,0.496625460250781,48,49,"48 - 49","#6C0000",2,3,"2029"
17,101,1040,2029-10-18,1905,9,6,9,"KGN","Kingston Mounties","home",1,0,"East Division","MiLPBE",49,49,0,"49 - 49",5,451,449,906,201601,203401,98,0.497777788751661,49,49,"49 - 49","#6C0000",2,3,"2029"
17,101,1043,2029-10-19,1905,9,6,12,"KGN","Kingston Mounties","home",1,0,"East Division","MiLPBE",50,49,1,"50 - 49",4,455,455,918,207025,207025,99,0.5,50,49,"50 - 49","#6C0000",2,3,"2029"
17,101,1046,2029-10-20,1905,11,6,13,"KGN","Kingston Mounties","home",1,0,"East Division","MiLPBE",51,49,2,"51 - 49",5,460,461,931,212521,211600,100,0.501085775050045,50,50,"50 - 50","#6C0000",2,3,"2029"
18,101,304,2029-05-16,1905,9,2,8,"SCSS","State College Swift Steeds ","away",0,1,"East Division","MiLPBE",0,1,-1,"0 - 1",4,4,2,8,4,16,1,0.2,0,1,"0 - 1","#115376",1,1,"2029"
18,101,307,2029-05-17,1905,9,4,12,"SCSS","State College Swift Steeds ","away",0,1,"East Division","MiLPBE",0,2,-2,"0 - 2",5,9,6,20,36,81,2,0.307692307692308,1,1,"1 - 1","#115376",1,1,"2029"
18,101,310,2029-05-18,1905,9,9,13,"SCSS","State College Swift Steeds ","away",1,0,"East Division","MiLPBE",1,2,-1,"1 - 2",4,13,15,33,225,169,3,0.571065989847716,2,1,"2 - 1","#115376",1,1,"2029"
18,101,313,2029-05-19,1905,14,7,14,"SCSS","State College Swift Steeds ","away",1,0,"East Division","MiLPBE",2,2,0,"2 - 2",6,19,22,47,484,361,4,0.572781065088757,2,2,"2 - 2","#115376",1,1,"2029"
18,101,316,2029-05-21,1905,9,10,14,"SCSS","State College Swift Steeds ","away",1,0,"East Division","MiLPBE",3,2,1,"3 - 2",3,22,32,61,1024,484,5,0.679045092838196,3,2,"3 - 2","#115376",1,1,"2029"
18,101,319,2029-05-22,1905,9,14,14,"SCSS","State College Swift Steeds ","away",1,0,"East Division","MiLPBE",4,2,2,"4 - 2",1,23,46,75,2116,529,6,0.8,5,1,"5 - 1","#115376",1,1,"2029"
18,101,322,2029-05-23,1905,9,3,5,"SCSS","State College Swift Steeds ","away",1,0,"East Division","MiLPBE",5,2,3,"5 - 2",1,24,49,80,2401,576,7,0.806516627477326,6,1,"6 - 1","#115376",1,1,"2029"
18,101,325,2029-05-24,1905,9,5,7,"SCSS","State College Swift Steeds ","away",0,1,"East Division","MiLPBE",5,3,2,"5 - 3",14,38,54,87,2916,1444,8,0.668807339449541,5,3,"5 - 3","#115376",1,1,"2029"
18,101,327,2029-05-27,1905,9,8,14,"SCSS","State College Swift Steeds ","away",1,0,"East Division","MiLPBE",6,3,3,"6 - 3",1,39,62,101,3844,1521,9,0.716495806150979,6,3,"6 - 3","#115376",1,1,"2029"
18,101,330,2029-05-28,1905,9,4,9,"SCSS","State College Swift Steeds ","away",0,1,"East Division","MiLPBE",6,4,2,"6 - 4",7,46,66,110,4356,2116,10,0.673053152039555,7,3,"7 - 3","#115376",1,1,"2029"
18,101,333,2029-05-29,1905,9,9,12,"SCSS","State College Swift Steeds ","away",1,0,"East Division","MiLPBE",7,4,3,"7 - 4",5,51,75,122,5625,2601,11,0.683807439824945,8,3,"8 - 3","#115376",1,1,"2029"
18,101,336,2029-05-30,1905,9,14,16,"SCSS","State College Swift Steeds ","away",1,0,"East Division","MiLPBE",8,4,4,"8 - 4",4,55,89,138,7921,3025,12,0.723643340032889,9,3,"9 - 3","#115376",1,1,"2029"
18,101,338,2029-06-02,1905,9,1,4,"SCSS","State College Swift Steeds ","away",1,0,"East Division","MiLPBE",9,4,5,"9 - 4",0,55,90,142,8100,3025,13,0.728089887640449,9,4,"9 - 4","#115376",1,1,"2029"
18,101,341,2029-06-03,1905,10,6,9,"SCSS","State College Swift Steeds ","away",1,0,"East Division","MiLPBE",10,4,6,"10 - 4",5,60,96,151,9216,3600,14,0.719101123595506,10,4,"10 - 4","#115376",1,1,"2029"
18,101,344,2029-06-04,1905,9,8,11,"SCSS","State College Swift Steeds ","away",0,1,"East Division","MiLPBE",10,5,5,"10 - 5",11,71,104,162,10816,5041,15,0.682096235101217,10,5,"10 - 5","#115376",1,1,"2029"
18,101,347,2029-06-05,1905,10,7,9,"SCSS","State College Swift Steeds ","away",0,1,"East Division","MiLPBE",10,6,4,"10 - 6",8,79,111,171,12321,6241,16,0.663775455231117,11,5,"11 - 5","#115376",1,1,"2029"
18,101,351,2029-06-08,1905,9,2,12,"SCSS","State College Swift Steeds ","away",0,1,"East Division","MiLPBE",10,7,3,"10 - 7",4,83,113,183,12769,6889,17,0.649557432088717,11,6,"11 - 6","#115376",1,1,"2029"
18,101,354,2029-06-09,1905,9,7,16,"SCSS","State College Swift Steeds ","away",1,0,"East Division","MiLPBE",11,7,4,"11 - 7",4,87,120,199,14400,7569,18,0.655469070053257,12,6,"12 - 6","#115376",1,1,"2029"
18,101,357,2029-06-10,1905,9,16,19,"SCSS","State College Swift Steeds ","away",1,0,"East Division","MiLPBE",12,7,5,"12 - 7",4,91,136,218,18496,8281,19,0.690742054748478,13,6,"13 - 6","#115376",1,1,"2029"
18,101,360,2029-06-11,1905,9,10,15,"SCSS","State College Swift Steeds ","away",1,0,"East Division","MiLPBE",13,7,6,"13 - 7",1,92,146,233,21316,8464,20,0.715782404298187,14,6,"14 - 6","#115376",1,1,"2029"
18,101,364,2029-06-14,1905,9,8,11,"SCSS","State College Swift Steeds ","home",1,0,"East Division","MiLPBE",14,7,7,"14 - 7",0,92,154,244,23716,8464,21,0.736979490366687,15,6,"15 - 6","#115376",1,1,"2029"
18,101,367,2029-06-15,1905,10,6,10,"SCSS","State College Swift Steeds ","home",1,0,"East Division","MiLPBE",15,7,8,"15 - 7",5,97,160,254,25600,9409,22,0.731240538147334,16,6,"16 - 6","#115376",1,1,"2029"
18,101,370,2029-06-16,1905,9,3,10,"SCSS","State College Swift Steeds ","home",0,1,"East Division","MiLPBE",15,8,7,"15 - 8",5,102,163,264,26569,10404,23,0.718605468855651,17,6,"17 - 6","#115376",1,1,"2029"
18,101,373,2029-06-17,1905,9,7,10,"SCSS","State College Swift Steeds ","home",1,0,"East Division","MiLPBE",16,8,8,"16 - 8",4,106,170,274,28900,11236,24,0.720051823799083,17,7,"17 - 7","#115376",1,1,"2029"
18,101,376,2029-06-20,1905,9,6,11,"SCSS","State College Swift Steeds ","home",1,0,"East Division","MiLPBE",17,8,9,"17 - 8",4,110,176,285,30976,12100,25,0.719101123595506,18,7,"18 - 7","#115376",1,1,"2029"
18,101,379,2029-06-21,1905,9,2,8,"SCSS","State College Swift Steeds ","home",1,0,"East Division","MiLPBE",18,8,10,"18 - 8",1,111,178,293,31684,12321,26,0.72000908987615,19,7,"19 - 7","#115376",1,1,"2029"
18,101,508,2029-06-22,1905,9,6,9,"SCSS","State College Swift Steeds ","home",0,1,"East Division","MiLPBE",18,9,9,"18 - 9",9,120,184,302,33856,14400,27,0.70159151193634,19,8,"19 - 8","#115376",1,1,"2029"
18,101,511,2029-06-23,1905,9,5,12,"SCSS","State College Swift Steeds ","home",0,1,"East Division","MiLPBE",18,10,8,"18 - 10",6,126,189,314,35721,15876,28,0.692307692307692,19,9,"19 - 9","#115376",1,1,"2029"
18,101,512,2029-07-15,1405,9,10,17,"SCSS","State College Swift Steeds ","away",1,0,"East Division","MiLPBE",19,10,9,"19 - 10",2,128,199,331,39601,16384,29,0.707350183084755,21,8,"21 - 8","#115376",1,1,"2029"
18,101,516,2029-06-25,1905,9,8,12,"SCSS","State College Swift Steeds ","home",0,1,"East Division","MiLPBE",19,11,8,"19 - 11",10,138,207,343,42849,19044,30,0.692307692307692,21,9,"21 - 9","#115376",1,1,"2029"
18,101,519,2029-06-26,1905,9,3,8,"SCSS","State College Swift Steeds ","home",0,1,"East Division","MiLPBE",19,12,7,"19 - 12",8,146,210,351,44100,21316,31,0.674146997676409,21,10,"21 - 10","#115376",1,1,"2029"
18,101,522,2029-06-27,1905,9,12,15,"SCSS","State College Swift Steeds ","home",1,0,"East Division","MiLPBE",20,12,8,"20 - 12",6,152,222,366,49284,23104,32,0.680831076974084,22,10,"22 - 10","#115376",1,1,"2029"
18,101,525,2029-06-28,1905,9,8,11,"SCSS","State College Swift Steeds ","home",1,0,"East Division","MiLPBE",21,12,9,"21 - 12",0,152,230,377,52900,23104,33,0.696015999157939,23,10,"23 - 10","#115376",1,1,"2029"
18,101,527,2029-07-01,1905,10,6,11,"SCSS","State College Swift Steeds ","home",1,0,"East Division","MiLPBE",22,12,10,"22 - 12",5,157,236,388,55696,24649,34,0.693210529591138,24,10,"24 - 10","#115376",1,1,"2029"
18,101,530,2029-07-02,1905,9,7,13,"SCSS","State College Swift Steeds ","home",1,0,"East Division","MiLPBE",23,12,11,"23 - 12",3,160,243,401,59049,25600,35,0.697574690781935,24,11,"24 - 11","#115376",1,1,"2029"
18,101,533,2029-07-03,1905,9,2,3,"SCSS","State College Swift Steeds ","home",1,0,"East Division","MiLPBE",24,12,12,"24 - 12",1,161,245,404,60025,25921,36,0.698403648802737,25,11,"25 - 11","#115376",1,1,"2029"
18,101,536,2029-07-04,1905,9,6,11,"SCSS","State College Swift Steeds ","home",1,0,"East Division","MiLPBE",25,12,13,"25 - 12",3,164,251,415,63001,26896,37,0.700813152830462,26,11,"26 - 11","#115376",1,1,"2029"
18,101,540,2029-07-07,1905,9,2,6,"SCSS","State College Swift Steeds ","home",0,1,"East Division","MiLPBE",25,13,12,"25 - 13",5,169,253,421,64009,28561,38,0.691465917683915,26,12,"26 - 12","#115376",1,1,"2029"
18,101,543,2029-07-08,1905,9,5,12,"SCSS","State College Swift Steeds ","home",0,1,"East Division","MiLPBE",25,14,11,"25 - 14",14,183,258,433,66564,33489,39,0.66528739767923,26,13,"26 - 13","#115376",1,1,"2029"
18,101,546,2029-07-09,1905,9,9,14,"SCSS","State College Swift Steeds ","home",1,0,"East Division","MiLPBE",26,14,12,"26 - 14",4,187,267,447,71289,34969,40,0.670904778934292,27,13,"27 - 13","#115376",1,1,"2029"
18,101,549,2029-07-10,1905,9,11,16,"SCSS","State College Swift Steeds ","home",1,0,"East Division","MiLPBE",27,14,13,"27 - 14",5,192,278,463,77284,36864,41,0.677050846269755,28,13,"28 - 13","#115376",1,1,"2029"
18,101,553,2029-07-12,1905,9,4,8,"SCSS","State College Swift Steeds ","away",1,0,"East Division","MiLPBE",28,14,14,"28 - 14",3,195,282,471,79524,38025,42,0.676517877651022,28,14,"28 - 14","#115376",1,1,"2029"
18,101,556,2029-07-13,1905,9,4,14,"SCSS","State College Swift Steeds ","away",0,1,"East Division","MiLPBE",28,15,13,"28 - 15",6,201,286,485,81796,40401,43,0.669378135306104,29,14,"29 - 14","#115376",1,1,"2029"
18,101,559,2029-07-14,1905,9,11,14,"SCSS","State College Swift Steeds ","away",1,0,"East Division","MiLPBE",29,15,14,"29 - 15",3,204,297,499,88209,41616,44,0.679445407279029,30,14,"30 - 14","#115376",1,1,"2029"
18,101,562,2029-07-18,1905,9,8,12,"SCSS","State College Swift Steeds ","away",1,0,"East Division","MiLPBE",30,15,15,"30 - 15",6,210,305,511,93025,44100,45,0.678395624430264,31,14,"31 - 14","#115376",1,1,"2029"
18,101,565,2029-07-19,1905,9,3,8,"SCSS","State College Swift Steeds ","away",1,0,"East Division","MiLPBE",31,15,16,"31 - 15",1,211,308,519,94864,44521,46,0.680589733472038,31,15,"31 - 15","#115376",1,1,"2029"
18,101,568,2029-07-20,1905,9,3,6,"SCSS","State College Swift Steeds ","away",0,1,"East Division","MiLPBE",31,16,15,"31 - 16",8,219,311,525,96721,47961,47,0.668507485381734,31,16,"31 - 16","#115376",1,1,"2029"
18,101,571,2029-07-21,1905,9,6,10,"SCSS","State College Swift Steeds ","away",1,0,"East Division","MiLPBE",32,16,16,"32 - 16",2,221,317,535,100489,48841,48,0.672932431527489,32,16,"32 - 16","#115376",1,1,"2029"
18,101,573,2029-07-24,1905,9,6,12,"SCSS","State College Swift Steeds ","home",1,0,"East Division","MiLPBE",33,16,17,"33 - 16",2,223,323,547,104329,49729,49,0.677205987355412,33,16,"33 - 16","#115376",1,1,"2029"
18,101,576,2029-07-25,1905,9,5,15,"SCSS","State College Swift Steeds ","home",0,1,"East Division","MiLPBE",33,17,16,"33 - 17",6,229,328,562,107584,52441,50,0.672294953913451,34,16,"34 - 16","#115376",1,1,"2029"
18,101,579,2029-07-26,1905,9,9,11,"SCSS","State College Swift Steeds ","home",1,0,"East Division","MiLPBE",34,17,17,"34 - 17",7,236,337,573,113569,55696,51,0.670953829793519,34,17,"34 - 17","#115376",1,1,"2029"
18,101,582,2029-07-27,1905,9,6,13,"SCSS","State College Swift Steeds ","home",1,0,"East Division","MiLPBE",35,17,18,"35 - 17",5,241,343,586,117649,58081,52,0.669487281625221,35,17,"35 - 17","#115376",1,1,"2029"
18,101,585,2029-08-13,1905,9,6,8,"SCSS","State College Swift Steeds ","away",0,1,"East Division","MiLPBE",35,18,17,"35 - 18",8,249,349,594,121801,62001,53,0.662675052502149,35,18,"35 - 18","#115376",1,1,"2029"
18,101,588,2029-08-14,1905,9,8,14,"SCSS","State College Swift Steeds ","away",1,0,"East Division","MiLPBE",36,18,18,"36 - 18",5,254,357,608,127449,64516,54,0.663917901700831,36,18,"36 - 18","#115376",1,1,"2029"
18,101,591,2029-08-15,1905,9,1,7,"SCSS","State College Swift Steeds ","away",0,1,"East Division","MiLPBE",36,19,17,"36 - 19",4,258,358,615,128164,66564,55,0.658169343905345,36,19,"36 - 19","#115376",1,1,"2029"
18,101,594,2029-08-16,1905,11,7,15,"SCSS","State College Swift Steeds ","away",1,0,"East Division","MiLPBE",37,19,18,"37 - 19",5,263,365,630,133225,69169,56,0.65824579780033,37,19,"37 - 19","#115376",1,1,"2029"
18,101,596,2029-08-19,1905,9,0,3,"SCSS","State College Swift Steeds ","away",0,1,"East Division","MiLPBE",37,20,17,"37 - 20",4,267,365,633,133225,71289,57,0.651422396510752,37,20,"37 - 20","#115376",1,1,"2029"
18,101,599,2029-08-20,1905,9,6,10,"SCSS","State College Swift Steeds ","away",1,0,"East Division","MiLPBE",38,20,18,"38 - 20",1,268,371,643,137641,71824,58,0.657107392643162,38,20,"38 - 20","#115376",1,1,"2029"
18,101,602,2029-08-21,1905,9,0,9,"SCSS","State College Swift Steeds ","away",0,1,"East Division","MiLPBE",38,21,17,"38 - 21",3,271,371,652,137641,73441,59,0.652073601728238,38,21,"38 - 21","#115376",1,1,"2029"
18,101,605,2029-08-22,1905,9,10,13,"SCSS","State College Swift Steeds ","away",1,0,"East Division","MiLPBE",39,21,18,"39 - 21",4,275,381,665,145161,75625,60,0.657473752864765,39,21,"39 - 21","#115376",1,1,"2029"
18,101,609,2029-08-25,1905,9,7,13,"SCSS","State College Swift Steeds ","away",0,1,"East Division","MiLPBE",39,22,17,"39 - 22",10,285,388,678,150544,81225,61,0.649543295263819,40,21,"40 - 21","#115376",1,1,"2029"
18,101,612,2029-08-26,1905,10,11,15,"SCSS","State College Swift Steeds ","away",1,0,"East Division","MiLPBE",40,22,18,"40 - 22",10,295,399,693,159201,87025,62,0.64656453826972,40,22,"40 - 22","#115376",1,1,"2029"
18,101,615,2029-08-27,1905,9,4,7,"SCSS","State College Swift Steeds ","away",1,0,"East Division","MiLPBE",41,22,19,"41 - 22",2,297,403,700,162409,88209,63,0.648034059804164,41,22,"41 - 22","#115376",1,1,"2029"
18,101,618,2029-08-28,1905,9,9,15,"SCSS","State College Swift Steeds ","away",1,0,"East Division","MiLPBE",42,22,20,"42 - 22",2,299,412,715,169744,89401,64,0.655015531845106,42,22,"42 - 22","#115376",1,1,"2029"
18,101,622,2029-08-31,1905,9,7,13,"SCSS","State College Swift Steeds ","home",0,1,"East Division","MiLPBE",42,23,19,"42 - 23",10,309,419,728,175561,95481,65,0.647726182658038,42,23,"42 - 23","#115376",1,1,"2029"
18,101,625,2029-09-01,1905,9,3,11,"SCSS","State College Swift Steeds ","home",0,1,"East Division","MiLPBE",42,24,18,"42 - 24",5,314,422,739,178084,98596,66,0.643646089345092,42,24,"42 - 24","#115376",1,1,"2029"
18,101,829,2029-09-02,1905,9,6,9,"SCSS","State College Swift Steeds ","home",1,0,"East Division","MiLPBE",43,24,19,"43 - 24",4,318,428,748,183184,101124,67,0.644315320005065,43,24,"43 - 24","#115376",1,1,"2029"
18,101,951,2029-09-03,1905,9,6,9,"SCSS","State College Swift Steeds ","home",1,0,"East Division","MiLPBE",44,24,20,"44 - 24",2,320,434,757,188356,102400,68,0.647814662466123,44,24,"44 - 24","#115376",1,1,"2029"
18,101,954,2029-09-06,1905,9,8,13,"SCSS","State College Swift Steeds ","home",1,0,"East Division","MiLPBE",45,24,21,"45 - 24",4,324,442,770,195364,104976,69,0.650476127056003,45,24,"45 - 24","#115376",1,1,"2029"
18,101,957,2029-09-07,1905,9,2,8,"SCSS","State College Swift Steeds ","home",0,1,"East Division","MiLPBE",45,25,20,"45 - 25",3,327,444,778,197136,106929,70,0.648335059937842,45,25,"45 - 25","#115376",1,1,"2029"
18,101,960,2029-09-08,1905,9,0,7,"SCSS","State College Swift Steeds ","home",0,1,"East Division","MiLPBE",45,26,19,"45 - 26",9,336,444,785,197136,112896,71,0.63585694379935,45,26,"45 - 26","#115376",1,1,"2029"
18,101,963,2029-09-09,1905,9,6,9,"SCSS","State College Swift Steeds ","home",0,1,"East Division","MiLPBE",45,27,18,"45 - 27",10,346,450,794,202500,119716,72,0.628460411649328,45,27,"45 - 27","#115376",1,1,"2029"
18,101,965,2029-09-12,1905,9,8,14,"SCSS","State College Swift Steeds ","home",1,0,"East Division","MiLPBE",46,27,19,"46 - 27",5,351,458,808,209764,123201,73,0.629988136891265,46,27,"46 - 27","#115376",1,1,"2029"
18,101,968,2029-09-13,1905,9,3,6,"SCSS","State College Swift Steeds ","home",0,1,"East Division","MiLPBE",46,28,18,"46 - 28",4,355,461,814,212521,126025,74,0.627746303308856,46,28,"46 - 28","#115376",1,1,"2029"
18,101,971,2029-09-14,1905,9,4,6,"SCSS","State College Swift Steeds ","home",1,0,"East Division","MiLPBE",47,28,19,"47 - 28",2,357,465,820,216225,127449,75,0.629157282773791,47,28,"47 - 28","#115376",1,1,"2029"
18,101,974,2029-09-15,1905,9,1,5,"SCSS","State College Swift Steeds ","home",0,1,"East Division","MiLPBE",47,29,18,"47 - 29",18,375,466,825,217156,140625,76,0.606952297634586,46,30,"46 - 30","#115376",1,1,"2029"
18,101,976,2029-09-18,1905,9,4,9,"SCSS","State College Swift Steeds ","home",1,0,"East Division","MiLPBE",48,29,19,"48 - 29",0,375,470,834,220900,140625,77,0.611022750847106,47,30,"47 - 30","#115376",1,1,"2029"
18,101,979,2029-09-19,1905,9,6,10,"SCSS","State College Swift Steeds ","home",0,1,"East Division","MiLPBE",48,30,18,"48 - 30",8,383,476,844,226576,146689,78,0.60701110471113,47,31,"47 - 31","#115376",1,1,"2029"
18,101,982,2029-09-20,1905,9,5,8,"SCSS","State College Swift Steeds ","away",1,0,"East Division","MiLPBE",49,30,19,"49 - 30",1,384,481,852,231361,147456,79,0.610746085840921,48,31,"48 - 31","#115376",1,1,"2029"
18,101,985,2029-09-21,1905,12,0,6,"SCSS","State College Swift Steeds ","away",0,1,"East Division","MiLPBE",49,31,18,"49 - 31",1,385,481,858,231361,148225,80,0.609508780618885,49,31,"49 - 31","#115376",1,1,"2029"
18,101,989,2029-09-23,1905,9,7,9,"SCSS","State College Swift Steeds ","home",1,0,"East Division","MiLPBE",50,31,19,"50 - 31",5,390,488,867,238144,152100,81,0.610243847439038,49,32,"49 - 32","#115376",1,1,"2029"
18,101,992,2029-09-24,1905,9,7,14,"SCSS","State College Swift Steeds ","home",1,0,"East Division","MiLPBE",51,31,20,"51 - 31",4,394,495,881,245025,155236,82,0.612163063601,50,32,"50 - 32","#115376",1,1,"2029"
18,101,995,2029-09-25,1905,9,0,6,"SCSS","State College Swift Steeds ","away",0,1,"East Division","MiLPBE",51,32,19,"51 - 32",1,395,495,887,245025,156025,83,0.610958733325022,51,32,"51 - 32","#115376",1,1,"2029"
18,101,998,2029-09-26,1905,9,6,10,"SCSS","State College Swift Steeds ","away",0,1,"East Division","MiLPBE",51,33,18,"51 - 33",8,403,501,897,251001,162409,84,0.607147867734211,51,33,"51 - 33","#115376",1,1,"2029"
18,101,1002,2029-09-29,1905,9,7,12,"SCSS","State College Swift Steeds ","away",1,0,"East Division","MiLPBE",52,33,19,"52 - 33",0,403,508,909,258064,162409,85,0.613746899325284,52,33,"52 - 33","#115376",1,1,"2029"
18,101,1005,2029-09-30,1905,9,3,10,"SCSS","State College Swift Steeds ","away",0,1,"East Division","MiLPBE",52,34,18,"52 - 34",10,413,511,919,261121,170569,86,0.604880817253121,52,34,"52 - 34","#115376",1,1,"2029"
18,101,1008,2029-10-01,1905,9,3,10,"SCSS","State College Swift Steeds ","home",0,1,"East Division","MiLPBE",52,35,17,"52 - 35",5,418,514,929,264196,174724,87,0.60192290166773,52,35,"52 - 35","#115376",1,1,"2029"
18,101,1011,2029-10-02,1905,9,7,12,"SCSS","State College Swift Steeds ","home",0,1,"East Division","MiLPBE",52,36,16,"52 - 36",8,426,521,941,271441,181476,88,0.599317314209888,53,35,"53 - 35","#115376",1,1,"2029"
18,101,1014,2029-10-05,1905,9,8,8,"SCSS","State College Swift Steeds ","away",1,0,"East Division","MiLPBE",53,36,17,"53 - 36",3,429,529,949,279841,184041,89,0.60325901845728,54,35,"54 - 35","#115376",1,1,"2029"
18,101,1017,2029-10-06,1905,9,1,6,"SCSS","State College Swift Steeds ","away",0,1,"East Division","MiLPBE",53,37,16,"53 - 37",4,433,530,955,280900,187489,90,0.599715193994735,54,36,"54 - 36","#115376",1,1,"2029"
18,101,1020,2029-10-07,1905,9,9,8,"SCSS","State College Swift Steeds ","home",1,0,"East Division","MiLPBE",54,37,17,"54 - 37",8,441,539,963,290521,194481,91,0.599009900990099,55,36,"55 - 36","#115376",1,1,"2029"
18,101,1023,2029-10-08,1905,9,3,6,"SCSS","State College Swift Steeds ","home",0,1,"East Division","MiLPBE",54,38,16,"54 - 38",6,447,542,969,293764,199809,92,0.595178423455092,55,37,"55 - 37","#115376",1,1,"2029"
18,101,1025,2029-10-11,1905,10,6,12,"SCSS","State College Swift Steeds ","away",1,0,"East Division","MiLPBE",55,38,17,"55 - 38",5,452,548,981,300304,204304,93,0.595123343268438,55,38,"55 - 38","#115376",1,1,"2029"
18,101,1028,2029-10-12,1905,9,9,14,"SCSS","State College Swift Steeds ","away",1,0,"East Division","MiLPBE",56,38,18,"56 - 38",0,452,557,995,310249,204304,94,0.602948578669253,57,37,"57 - 37","#115376",1,1,"2029"
18,101,1031,2029-10-13,1905,9,13,11,"SCSS","State College Swift Steeds ","home",1,0,"East Division","MiLPBE",57,38,19,"57 - 38",3,455,570,1006,324900,207025,95,0.610800394792499,58,37,"58 - 37","#115376",1,1,"2029"
18,101,1034,2029-10-14,1905,9,4,4,"SCSS","State College Swift Steeds ","home",1,0,"East Division","MiLPBE",58,38,20,"58 - 38",2,457,574,1010,329476,208849,96,0.612039195653183,59,37,"59 - 37","#115376",1,1,"2029"
18,101,1036,2029-10-17,1905,9,4,11,"SCSS","State College Swift Steeds ","home",1,0,"East Division","MiLPBE",59,38,21,"59 - 38",2,459,578,1021,334084,210681,97,0.613262599469496,59,38,"59 - 38","#115376",1,1,"2029"
18,101,1039,2029-10-18,1905,9,6,13,"SCSS","State College Swift Steeds ","home",1,0,"East Division","MiLPBE",60,38,22,"60 - 38",4,463,584,1034,341056,214369,98,0.614045100598641,60,38,"60 - 38","#115376",1,1,"2029"
18,101,1042,2029-10-19,1905,9,0,7,"SCSS","State College Swift Steeds ","home",0,1,"East Division","MiLPBE",60,39,21,"60 - 39",1,464,584,1041,341056,215296,99,0.613021971701369,61,38,"61 - 38","#115376",1,1,"2029"
18,101,1045,2029-10-20,1905,9,9,11,"SCSS","State College Swift Steeds ","home",1,0,"East Division","MiLPBE",61,39,22,"61 - 39",4,468,593,1052,351649,219024,100,0.616200521139076,62,38,"62 - 38","#115376",1,1,"2029"
19,101,302,2029-05-16,1905,9,5,12,"ARM","Amarillo Armadillos","away",1,0,"West Division","MiLPBE",1,0,1,"1 - 0",1,1,5,12,25,1,1,0.961538461538462,1,0,"1 - 0","#86572C",1,2,"2029"
19,101,305,2029-05-17,1905,9,0,3,"ARM","Amarillo Armadillos","away",0,1,"West Division","MiLPBE",1,1,0,"1 - 1",2,3,5,15,25,9,2,0.735294117647059,1,1,"1 - 1","#86572C",1,2,"2029"
19,101,308,2029-05-18,1905,9,2,7,"ARM","Amarillo Armadillos","away",0,1,"West Division","MiLPBE",1,2,-1,"1 - 2",8,11,7,22,49,121,3,0.288235294117647,1,2,"1 - 2","#86572C",1,2,"2029"
19,101,311,2029-05-19,1905,9,9,13,"ARM","Amarillo Armadillos","away",1,0,"West Division","MiLPBE",2,2,0,"2 - 2",4,15,16,35,256,225,4,0.532224532224532,2,2,"2 - 2","#86572C",1,2,"2029"
19,101,314,2029-05-21,1905,9,4,8,"ARM","Amarillo Armadillos","away",1,0,"West Division","MiLPBE",3,2,1,"3 - 2",3,18,20,43,400,324,5,0.552486187845304,3,2,"3 - 2","#86572C",1,2,"2029"
19,101,317,2029-05-22,1905,9,3,9,"ARM","Amarillo Armadillos","away",0,1,"West Division","MiLPBE",3,3,0,"3 - 3",4,22,23,52,529,484,6,0.522211253701876,3,3,"3 - 3","#86572C",1,2,"2029"
19,101,320,2029-05-23,1905,9,1,3,"ARM","Amarillo Armadillos","away",0,1,"West Division","MiLPBE",3,4,-1,"3 - 4",3,25,24,55,576,625,7,0.479600333055787,3,4,"3 - 4","#86572C",1,2,"2029"
19,101,323,2029-05-24,1905,11,3,6,"ARM","Amarillo Armadillos","away",0,1,"West Division","MiLPBE",3,5,-2,"3 - 5",4,29,27,61,729,841,8,0.464331210191083,4,4,"4 - 4","#86572C",1,2,"2029"
19,101,326,2029-05-27,1905,10,3,14,"ARM","Amarillo Armadillos","home",0,1,"West Division","MiLPBE",3,6,-3,"3 - 6",4,33,30,75,900,1089,9,0.452488687782805,4,5,"4 - 5","#86572C",1,2,"2029"
19,101,329,2029-05-28,1905,9,10,16,"ARM","Amarillo Armadillos","home",1,0,"West Division","MiLPBE",4,6,-2,"4 - 6",0,33,40,91,1600,1089,10,0.595016734845668,6,4,"6 - 4","#86572C",1,2,"2029"
19,101,332,2029-05-29,1905,9,6,8,"ARM","Amarillo Armadillos","home",1,0,"West Division","MiLPBE",5,6,-1,"5 - 6",4,37,46,99,2116,1369,11,0.607173601147776,7,4,"7 - 4","#86572C",1,2,"2029"
19,101,335,2029-05-30,1905,9,7,9,"ARM","Amarillo Armadillos","home",1,0,"West Division","MiLPBE",6,6,0,"6 - 6",2,39,53,108,2809,1521,12,0.648729792147806,8,4,"8 - 4","#86572C",1,2,"2029"
19,101,338,2029-06-02,1905,9,0,4,"ARM","Amarillo Armadillos","home",0,1,"West Division","MiLPBE",6,7,-1,"6 - 7",1,40,53,112,2809,1600,13,0.637105919709685,8,5,"8 - 5","#86572C",1,2,"2029"
19,101,341,2029-06-03,1905,10,5,9,"ARM","Amarillo Armadillos","home",0,1,"West Division","MiLPBE",6,8,-2,"6 - 8",6,46,58,121,3364,2116,14,0.613868613138686,9,5,"9 - 5","#86572C",1,2,"2029"
19,101,344,2029-06-04,1905,9,11,16,"ARM","Amarillo Armadillos","home",1,0,"West Division","MiLPBE",7,8,-1,"7 - 8",8,54,69,137,4761,2916,15,0.620164126611958,9,6,"9 - 6","#86572C",1,2,"2029"
19,101,347,2029-06-05,1905,10,8,11,"ARM","Amarillo Armadillos","home",1,0,"West Division","MiLPBE",8,8,0,"8 - 8",7,61,77,148,5929,3721,16,0.61440414507772,10,6,"10 - 6","#86572C",1,2,"2029"
19,101,350,2029-06-08,1905,9,5,8,"ARM","Amarillo Armadillos","home",1,0,"West Division","MiLPBE",9,8,1,"9 - 8",3,64,82,156,6724,4096,17,0.621441774491682,11,6,"11 - 6","#86572C",1,2,"2029"
19,101,353,2029-06-09,1905,9,5,12,"ARM","Amarillo Armadillos","home",1,0,"West Division","MiLPBE",10,8,2,"10 - 8",3,67,87,168,7569,4489,18,0.627716039144137,11,7,"11 - 7","#86572C",1,2,"2029"
19,101,356,2029-06-10,1905,9,5,9,"ARM","Amarillo Armadillos","home",0,1,"West Division","MiLPBE",10,9,1,"10 - 9",7,74,92,177,8464,5476,19,0.607173601147776,12,7,"12 - 7","#86572C",1,2,"2029"
19,101,359,2029-06-11,1905,9,0,3,"ARM","Amarillo Armadillos","home",0,1,"West Division","MiLPBE",10,10,0,"10 - 10",1,75,92,180,8464,5625,20,0.600752359997161,12,8,"12 - 8","#86572C",1,2,"2029"
19,101,362,2029-06-14,1905,9,5,12,"ARM","Amarillo Armadillos","home",1,0,"West Division","MiLPBE",11,10,1,"11 - 10",1,76,97,192,9409,5776,21,0.619624629568653,13,8,"13 - 8","#86572C",1,2,"2029"
19,101,365,2029-06-15,1905,9,3,5,"ARM","Amarillo Armadillos","home",1,0,"West Division","MiLPBE",12,10,2,"12 - 10",1,77,100,197,10000,5929,22,0.627785799485216,14,8,"14 - 8","#86572C",1,2,"2029"
19,101,368,2029-06-16,1905,9,1,7,"ARM","Amarillo Armadillos","home",0,1,"West Division","MiLPBE",12,11,1,"12 - 11",5,82,101,204,10201,6724,23,0.602717872968981,14,9,"14 - 9","#86572C",1,2,"2029"
19,101,371,2029-06-17,1905,9,11,17,"ARM","Amarillo Armadillos","home",1,0,"West Division","MiLPBE",13,11,2,"13 - 11",3,85,112,221,12544,7225,24,0.634528807729273,15,9,"15 - 9","#86572C",1,2,"2029"
19,101,374,2029-06-20,1905,9,5,7,"ARM","Amarillo Armadillos","home",1,0,"West Division","MiLPBE",14,11,3,"14 - 11",2,87,117,228,13689,7569,25,0.643945808636749,16,9,"16 - 9","#86572C",1,2,"2029"
19,101,377,2029-06-21,1905,9,3,8,"ARM","Amarillo Armadillos","home",0,1,"West Division","MiLPBE",14,12,2,"14 - 12",4,91,120,236,14400,8281,26,0.634892641417927,17,9,"17 - 9","#86572C",1,2,"2029"
19,101,380,2029-06-22,1905,9,0,5,"ARM","Amarillo Armadillos","home",0,1,"West Division","MiLPBE",14,13,1,"14 - 13",8,99,120,241,14400,9801,27,0.595016734845668,16,11,"16 - 11","#86572C",1,2,"2029"
19,101,509,2029-06-23,1905,9,3,8,"ARM","Amarillo Armadillos","home",0,1,"West Division","MiLPBE",14,14,0,"14 - 14",4,103,123,249,15129,10609,28,0.587807910482555,16,12,"16 - 12","#86572C",1,2,"2029"
19,101,513,2029-07-15,1905,10,8,16,"ARM","Amarillo Armadillos","away",1,0,"West Division","MiLPBE",15,14,1,"15 - 14",6,109,131,265,17161,11881,29,0.590902830383582,17,12,"17 - 12","#86572C",1,2,"2029"
19,101,515,2029-06-25,1905,9,6,14,"ARM","Amarillo Armadillos","away",1,0,"West Division","MiLPBE",16,14,2,"16 - 14",4,113,137,279,18769,12769,30,0.595123343268438,18,12,"18 - 12","#86572C",1,2,"2029"
19,101,518,2029-06-26,1905,9,8,11,"ARM","Amarillo Armadillos","away",1,0,"West Division","MiLPBE",17,14,3,"17 - 14",3,116,145,290,21025,13456,31,0.609756097560976,19,12,"19 - 12","#86572C",1,2,"2029"
19,101,521,2029-06-27,1905,9,8,15,"ARM","Amarillo Armadillos","away",1,0,"West Division","MiLPBE",18,14,4,"18 - 14",1,117,153,305,23409,13689,32,0.631004366812227,20,12,"20 - 12","#86572C",1,2,"2029"
19,101,524,2029-06-28,1905,9,0,3,"ARM","Amarillo Armadillos","away",0,1,"West Division","MiLPBE",18,15,3,"18 - 15",3,120,153,308,23409,14400,33,0.619138300404666,20,13,"20 - 13","#86572C",1,2,"2029"
19,101,527,2029-07-01,1905,10,5,11,"ARM","Amarillo Armadillos","away",0,1,"West Division","MiLPBE",18,16,2,"18 - 16",6,126,158,319,24964,15876,34,0.61126346718903,21,13,"21 - 13","#86572C",1,2,"2029"
19,101,530,2029-07-02,1905,9,3,8,"ARM","Amarillo Armadillos","away",0,1,"West Division","MiLPBE",18,17,1,"18 - 17",7,133,161,327,25921,17689,35,0.59438202247191,21,14,"21 - 14","#86572C",1,2,"2029"
19,101,533,2029-07-03,1905,9,1,8,"ARM","Amarillo Armadillos","away",0,1,"West Division","MiLPBE",18,18,0,"18 - 18",2,135,162,335,26244,18225,36,0.590163934426229,21,15,"21 - 15","#86572C",1,2,"2029"
19,101,536,2029-07-04,1905,9,3,10,"ARM","Amarillo Armadillos","away",0,1,"West Division","MiLPBE",18,19,-1,"18 - 19",6,141,165,345,27225,19881,37,0.5779518532671,21,16,"21 - 16","#86572C",1,2,"2029"
19,101,539,2029-07-07,1905,9,7,8,"ARM","Amarillo Armadillos","away",1,0,"West Division","MiLPBE",19,19,0,"19 - 19",2,143,172,353,29584,20449,38,0.591289748765815,22,16,"22 - 16","#86572C",1,2,"2029"
19,101,542,2029-07-08,1905,9,0,3,"ARM","Amarillo Armadillos","away",0,1,"West Division","MiLPBE",19,20,-1,"19 - 20",4,147,172,356,29584,21609,39,0.577891508604692,23,16,"23 - 16","#86572C",1,2,"2029"
19,101,545,2029-07-09,1905,9,7,12,"ARM","Amarillo Armadillos","away",1,0,"West Division","MiLPBE",20,20,0,"20 - 20",3,150,179,368,32041,22500,40,0.587466309748629,23,17,"23 - 17","#86572C",1,2,"2029"
19,101,548,2029-07-10,1905,12,3,9,"ARM","Amarillo Armadillos","away",0,1,"West Division","MiLPBE",20,21,-1,"20 - 21",4,154,182,377,33124,23716,41,0.582758620689655,24,17,"24 - 17","#86572C",1,2,"2029"
19,101,551,2029-07-12,1905,9,4,13,"ARM","Amarillo Armadillos","away",0,1,"West Division","MiLPBE",20,22,-2,"20 - 22",5,159,186,390,34596,25281,42,0.577784458139185,24,18,"24 - 18","#86572C",1,2,"2029"
19,101,554,2029-07-13,1905,9,0,6,"ARM","Amarillo Armadillos","away",0,1,"West Division","MiLPBE",20,23,-3,"20 - 23",8,167,186,396,34596,27889,43,0.553668880531328,24,19,"24 - 19","#86572C",1,2,"2029"
19,101,557,2029-07-14,1905,9,4,13,"ARM","Amarillo Armadillos","away",1,0,"West Division","MiLPBE",21,23,-2,"21 - 23",2,169,190,409,36100,28561,44,0.558296345556054,25,19,"25 - 19","#86572C",1,2,"2029"
19,101,560,2029-07-18,1905,9,5,8,"ARM","Amarillo Armadillos","away",1,0,"West Division","MiLPBE",22,23,-1,"22 - 23",2,171,195,417,38025,29241,45,0.565293015788065,25,20,"25 - 20","#86572C",1,2,"2029"
19,101,563,2029-07-19,1905,9,9,14,"ARM","Amarillo Armadillos","away",1,0,"West Division","MiLPBE",23,23,0,"23 - 23",7,178,204,431,41616,31684,46,0.56774897680764,26,20,"26 - 20","#86572C",1,2,"2029"
19,101,566,2029-07-20,1905,10,5,13,"ARM","Amarillo Armadillos","away",1,0,"West Division","MiLPBE",24,23,1,"24 - 23",2,180,209,444,43681,32400,47,0.574138089667591,27,20,"27 - 20","#86572C",1,2,"2029"
19,101,569,2029-07-21,1905,9,15,15,"ARM","Amarillo Armadillos","away",1,0,"West Division","MiLPBE",25,23,2,"25 - 23",4,184,224,459,50176,33856,48,0.597105864432597,29,19,"29 - 19","#86572C",1,2,"2029"
19,101,572,2029-07-24,1905,9,6,10,"ARM","Amarillo Armadillos","away",1,0,"West Division","MiLPBE",26,23,3,"26 - 23",5,189,230,469,52900,35721,49,0.596923979643651,29,20,"29 - 20","#86572C",1,2,"2029"
19,101,575,2029-07-25,1905,9,1,4,"ARM","Amarillo Armadillos","away",0,1,"West Division","MiLPBE",26,24,2,"26 - 24",8,197,231,473,53361,38809,50,0.578941087121623,29,21,"29 - 21","#86572C",1,2,"2029"
19,101,578,2029-07-26,1905,9,5,8,"ARM","Amarillo Armadillos","away",1,0,"West Division","MiLPBE",27,24,3,"27 - 24",2,199,236,481,55696,39601,51,0.584446519827487,30,21,"30 - 21","#86572C",1,2,"2029"
19,101,581,2029-07-27,1905,10,2,9,"ARM","Amarillo Armadillos","away",1,0,"West Division","MiLPBE",28,24,4,"28 - 24",1,200,238,490,56644,40000,52,0.586109846446753,30,22,"30 - 22","#86572C",1,2,"2029"
19,101,584,2029-08-13,1905,11,9,18,"ARM","Amarillo Armadillos","home",1,0,"West Division","MiLPBE",29,24,5,"29 - 24",8,208,247,508,61009,43264,53,0.585089141004862,31,22,"31 - 22","#86572C",1,2,"2029"
19,101,587,2029-08-14,1905,13,1,6,"ARM","Amarillo Armadillos","home",1,0,"West Division","MiLPBE",30,24,6,"30 - 24",0,208,248,514,61504,43264,54,0.587049480757483,32,22,"32 - 22","#86572C",1,2,"2029"
19,101,590,2029-08-15,1905,9,3,8,"ARM","Amarillo Armadillos","home",0,1,"West Division","MiLPBE",30,25,5,"30 - 25",5,213,251,522,63001,45369,55,0.581350927378426,32,23,"32 - 23","#86572C",1,2,"2029"
19,101,593,2029-08-16,1905,9,5,12,"ARM","Amarillo Armadillos","home",1,0,"West Division","MiLPBE",31,25,6,"31 - 25",4,217,256,534,65536,47089,56,0.581895671476138,33,23,"33 - 23","#86572C",1,2,"2029"
19,101,596,2029-08-19,1905,9,4,9,"ARM","Amarillo Armadillos","home",1,0,"West Division","MiLPBE",32,25,7,"32 - 25",0,217,260,543,67600,47089,57,0.589420083879012,34,23,"34 - 23","#86572C",1,2,"2029"
19,101,599,2029-08-20,1905,9,1,8,"ARM","Amarillo Armadillos","home",0,1,"West Division","MiLPBE",32,26,6,"32 - 26",6,223,261,551,68121,49729,58,0.578031395842172,34,24,"34 - 24","#86572C",1,2,"2029"
19,101,602,2029-08-21,1905,9,3,9,"ARM","Amarillo Armadillos","home",1,0,"West Division","MiLPBE",33,26,7,"33 - 26",0,223,264,560,69696,49729,59,0.583596399413858,34,25,"34 - 25","#86572C",1,2,"2029"
19,101,605,2029-08-22,1905,9,4,9,"ARM","Amarillo Armadillos","home",0,1,"West Division","MiLPBE",33,27,6,"33 - 27",10,233,268,569,71824,54289,60,0.56952098514824,34,26,"34 - 26","#86572C",1,2,"2029"
19,101,608,2029-08-25,1905,9,9,14,"ARM","Amarillo Armadillos","home",1,0,"West Division","MiLPBE",34,27,7,"34 - 27",1,234,277,583,76729,54756,61,0.583557059740655,36,25,"36 - 25","#86572C",1,2,"2029"
19,101,611,2029-08-26,1905,9,7,9,"ARM","Amarillo Armadillos","home",1,0,"West Division","MiLPBE",35,27,8,"35 - 27",5,239,284,592,80656,57121,62,0.585409756345399,36,26,"36 - 26","#86572C",1,2,"2029"
19,101,614,2029-08-27,1905,9,0,3,"ARM","Amarillo Armadillos","home",0,1,"West Division","MiLPBE",35,28,7,"35 - 28",4,243,284,595,80656,59049,63,0.577330804194553,36,27,"36 - 27","#86572C",1,2,"2029"
19,101,617,2029-08-28,1905,9,4,7,"ARM","Amarillo Armadillos","home",0,1,"West Division","MiLPBE",35,29,6,"35 - 29",7,250,288,602,82944,62500,64,0.570281345397541,36,28,"36 - 28","#86572C",1,2,"2029"
19,101,620,2029-08-31,1905,9,13,18,"ARM","Amarillo Armadillos","home",1,0,"West Division","MiLPBE",36,29,7,"36 - 29",5,255,301,620,90601,65025,65,0.582171359541465,38,27,"38 - 27","#86572C",1,2,"2029"
19,101,623,2029-09-01,1905,9,1,4,"ARM","Amarillo Armadillos","home",0,1,"West Division","MiLPBE",36,30,6,"36 - 30",5,260,302,624,91204,67600,66,0.574318027253722,38,28,"38 - 28","#86572C",1,2,"2029"
19,101,626,2029-09-02,1905,9,14,17,"ARM","Amarillo Armadillos","home",1,0,"West Division","MiLPBE",37,30,7,"37 - 30",9,269,316,641,99856,72361,67,0.579826614097331,39,28,"39 - 28","#86572C",1,2,"2029"
19,101,949,2029-09-03,1905,9,0,9,"ARM","Amarillo Armadillos","home",0,1,"West Division","MiLPBE",37,31,6,"37 - 31",2,271,316,650,99856,73441,68,0.576213090820961,39,29,"39 - 29","#86572C",1,2,"2029"
19,101,952,2029-09-06,1905,9,5,11,"ARM","Amarillo Armadillos","home",1,0,"West Division","MiLPBE",38,31,7,"38 - 31",2,273,321,661,103041,74529,69,0.580283831728333,40,29,"40 - 29","#86572C",1,2,"2029"
19,101,955,2029-09-07,1905,9,5,11,"ARM","Amarillo Armadillos","home",1,0,"West Division","MiLPBE",39,31,8,"39 - 31",2,275,326,672,106276,75625,70,0.584251873271725,41,29,"41 - 29","#86572C",1,2,"2029"
19,101,958,2029-09-08,1905,9,1,9,"ARM","Amarillo Armadillos","home",0,1,"West Division","MiLPBE",39,32,7,"39 - 32",10,285,327,681,106929,81225,71,0.568305749545585,40,31,"40 - 31","#86572C",1,2,"2029"
19,101,961,2029-09-09,1905,9,1,5,"ARM","Amarillo Armadillos","home",0,1,"West Division","MiLPBE",39,33,6,"39 - 33",2,287,328,686,107584,82369,72,0.566371681415929,41,31,"41 - 31","#86572C",1,2,"2029"
19,101,964,2029-09-12,1905,9,2,10,"ARM","Amarillo Armadillos","away",0,1,"West Division","MiLPBE",39,34,5,"39 - 34",3,290,330,696,108900,84100,73,0.564248704663212,41,32,"41 - 32","#86572C",1,2,"2029"
19,101,967,2029-09-13,1905,9,15,20,"ARM","Amarillo Armadillos","away",1,0,"West Division","MiLPBE",40,34,6,"40 - 34",3,293,345,716,119025,85849,74,0.580966838154183,43,31,"43 - 31","#86572C",1,2,"2029"
19,101,970,2029-09-14,1905,12,8,16,"ARM","Amarillo Armadillos","away",1,0,"West Division","MiLPBE",41,34,7,"41 - 34",7,300,353,732,124609,90000,75,0.580632685488493,44,31,"44 - 31","#86572C",1,2,"2029"
19,101,973,2029-09-15,1905,9,4,13,"ARM","Amarillo Armadillos","away",0,1,"West Division","MiLPBE",41,35,6,"41 - 35",5,305,357,745,127449,93025,76,0.578068162232281,44,32,"44 - 32","#86572C",1,2,"2029"
19,101,976,2029-09-18,1905,9,0,2,"ARM","Amarillo Armadillos","away",0,1,"West Division","MiLPBE",41,36,5,"41 - 36",4,309,357,747,127449,95481,77,0.571699636657247,44,33,"44 - 33","#86572C",1,2,"2029"
19,101,979,2029-09-19,1905,9,8,11,"ARM","Amarillo Armadillos","away",1,0,"West Division","MiLPBE",42,36,6,"42 - 36",6,315,365,758,133225,99225,78,0.573134007313401,45,33,"45 - 33","#86572C",1,2,"2029"
19,101,982,2029-09-20,1905,9,1,7,"ARM","Amarillo Armadillos","home",0,1,"West Division","MiLPBE",42,37,5,"42 - 37",5,320,366,765,133956,102400,79,0.566755233630625,45,34,"45 - 34","#86572C",1,2,"2029"
19,101,985,2029-09-21,1905,12,1,8,"ARM","Amarillo Armadillos","home",1,0,"West Division","MiLPBE",43,37,6,"43 - 37",0,320,367,773,134689,102400,80,0.568094681743986,45,35,"45 - 35","#86572C",1,2,"2029"
19,101,988,2029-09-23,1905,9,8,13,"ARM","Amarillo Armadillos","away",1,0,"West Division","MiLPBE",44,37,7,"44 - 37",3,323,375,786,140625,104329,81,0.574087379671285,47,34,"47 - 34","#86572C",1,2,"2029"
19,101,991,2029-09-24,1905,9,1,9,"ARM","Amarillo Armadillos","away",0,1,"West Division","MiLPBE",44,38,6,"44 - 38",4,327,376,795,141376,106929,82,0.569364289885423,47,35,"47 - 35","#86572C",1,2,"2029"
19,101,994,2029-09-25,1905,9,4,14,"ARM","Amarillo Armadillos","home",0,1,"West Division","MiLPBE",44,39,5,"44 - 39",8,335,380,809,144400,112225,83,0.562688748173405,47,36,"47 - 36","#86572C",1,2,"2029"
19,101,997,2029-09-26,1905,9,8,13,"ARM","Amarillo Armadillos","home",1,0,"West Division","MiLPBE",45,39,6,"45 - 39",6,341,388,822,150544,116281,84,0.564205003279303,47,37,"47 - 37","#86572C",1,2,"2029"
19,101,1000,2029-09-29,1905,9,13,16,"ARM","Amarillo Armadillos","away",1,0,"West Division","MiLPBE",46,39,7,"46 - 39",7,348,401,838,160801,121104,85,0.570408470938791,48,37,"48 - 37","#86572C",1,2,"2029"
19,101,1003,2029-09-30,1905,12,13,19,"ARM","Amarillo Armadillos","away",1,0,"West Division","MiLPBE",47,39,8,"47 - 39",12,360,414,857,171396,129600,86,0.569429494079656,49,37,"49 - 37","#86572C",1,2,"2029"
19,101,1006,2029-10-01,1905,9,11,14,"ARM","Amarillo Armadillos","home",1,0,"West Division","MiLPBE",48,39,9,"48 - 39",2,362,425,871,180625,131044,87,0.579541115734962,50,37,"50 - 37","#86572C",1,2,"2029"
19,101,1009,2029-10-02,1905,9,5,11,"ARM","Amarillo Armadillos","home",0,1,"West Division","MiLPBE",48,40,8,"48 - 40",6,368,430,882,184900,135424,88,0.5772280565927,51,37,"51 - 37","#86572C",1,2,"2029"
19,101,1012,2029-10-05,1905,9,7,12,"ARM","Amarillo Armadillos","away",1,0,"West Division","MiLPBE",49,40,9,"49 - 40",1,369,437,894,190969,136161,89,0.583770977898695,52,37,"52 - 37","#86572C",1,2,"2029"
19,101,1015,2029-10-06,1905,11,4,15,"ARM","Amarillo Armadillos","away",0,1,"West Division","MiLPBE",49,41,8,"49 - 41",8,377,441,909,194481,142129,90,0.577763583969579,52,38,"52 - 38","#86572C",1,2,"2029"
19,101,1018,2029-10-07,1905,9,3,8,"ARM","Amarillo Armadillos","home",1,0,"West Division","MiLPBE",50,41,9,"50 - 41",0,377,444,917,197136,142129,91,0.581067896776856,53,38,"53 - 38","#86572C",1,2,"2029"
19,101,1021,2029-10-08,1905,9,4,15,"ARM","Amarillo Armadillos","home",0,1,"West Division","MiLPBE",50,42,8,"50 - 42",5,382,448,932,200704,145924,92,0.579018428978617,53,39,"53 - 39","#86572C",1,2,"2029"
19,101,1024,2029-10-11,1905,9,14,17,"ARM","Amarillo Armadillos","home",1,0,"West Division","MiLPBE",51,42,9,"51 - 42",7,389,462,949,213444,151321,93,0.585154825709704,54,39,"54 - 39","#86572C",1,2,"2029"
19,101,1027,2029-10-12,1905,9,1,7,"ARM","Amarillo Armadillos","home",0,1,"West Division","MiLPBE",51,43,8,"51 - 43",5,394,463,956,214369,155236,94,0.579994859376902,55,39,"55 - 39","#86572C",1,2,"2029"
19,101,1030,2029-10-13,1905,10,4,11,"ARM","Amarillo Armadillos","away",1,0,"West Division","MiLPBE",52,43,9,"52 - 43",3,397,467,967,218089,157609,95,0.580490180943204,55,40,"55 - 40","#86572C",1,2,"2029"
19,101,1033,2029-10-14,1905,9,4,12,"ARM","Amarillo Armadillos","away",1,0,"West Division","MiLPBE",53,43,10,"53 - 43",3,400,471,979,221841,160000,96,0.580977422539748,56,40,"56 - 40","#86572C",1,2,"2029"
19,101,1036,2029-10-17,1905,9,2,5,"ARM","Amarillo Armadillos","away",0,1,"West Division","MiLPBE",53,44,9,"53 - 44",4,404,473,984,223729,163216,97,0.578193283283154,56,41,"56 - 41","#86572C",1,2,"2029"
19,101,1039,2029-10-18,1905,9,4,10,"ARM","Amarillo Armadillos","away",0,1,"West Division","MiLPBE",53,45,8,"53 - 45",6,410,477,994,227529,168100,98,0.575106981540787,56,42,"56 - 42","#86572C",1,2,"2029"
19,101,1042,2029-10-19,1905,9,1,7,"ARM","Amarillo Armadillos","away",1,0,"West Division","MiLPBE",54,45,9,"54 - 45",0,410,478,1001,228484,168100,99,0.576130151493757,57,42,"57 - 42","#86572C",1,2,"2029"
19,101,1045,2029-10-20,1905,9,4,9,"ARM","Amarillo Armadillos","away",0,1,"West Division","MiLPBE",54,46,8,"54 - 46",9,419,482,1010,232324,175561,100,0.569582112605269,57,43,"57 - 43","#86572C",1,2,"2029"
24,100,1,2029-05-15,1905,9,2,5,"FL","Florida Space Rangers","away",0,1,"Eastern Division","PBE",0,1,-1,"0 - 1",4,4,2,5,4,16,1,0.2,0,1,"0 - 1","#D0D02B",1,2,"2029"
24,100,6,2029-05-16,1905,9,9,14,"FL","Florida Space Rangers","away",1,0,"Eastern Division","PBE",1,1,0,"1 - 1",2,6,11,19,121,36,2,0.770700636942675,2,0,"2 - 0","#D0D02B",1,2,"2029"
24,100,11,2029-05-17,1905,9,3,9,"FL","Florida Space Rangers","away",0,1,"Eastern Division","PBE",1,2,-1,"1 - 2",5,11,14,28,196,121,3,0.618296529968454,2,1,"2 - 1","#D0D02B",1,2,"2029"
24,100,16,2029-05-18,1905,9,4,7,"FL","Florida Space Rangers","away",1,0,"Eastern Division","PBE",2,2,0,"2 - 2",3,14,18,35,324,196,4,0.623076923076923,2,2,"2 - 2","#D0D02B",1,2,"2029"
24,100,22,2029-05-21,1905,9,11,14,"FL","Florida Space Rangers","home",1,0,"Eastern Division","PBE",3,2,1,"3 - 2",7,21,29,49,841,441,5,0.65600624024961,3,2,"3 - 2","#D0D02B",1,2,"2029"
24,100,27,2029-05-22,1905,9,4,6,"FL","Florida Space Rangers","home",1,0,"Eastern Division","PBE",4,2,2,"4 - 2",2,23,33,55,1089,529,6,0.673053152039555,4,2,"4 - 2","#D0D02B",1,2,"2029"
24,100,32,2029-05-23,1905,9,6,11,"FL","Florida Space Rangers","home",1,0,"Eastern Division","PBE",5,2,3,"5 - 2",0,23,39,66,1521,529,7,0.741951219512195,5,2,"5 - 2","#D0D02B",1,2,"2029"
24,100,36,2029-05-24,1905,9,5,8,"FL","Florida Space Rangers","home",1,0,"Eastern Division","PBE",6,2,4,"6 - 2",2,25,44,74,1936,625,8,0.755954705193284,6,2,"6 - 2","#D0D02B",1,2,"2029"
24,100,40,2029-05-26,1905,9,8,11,"FL","Florida Space Rangers","away",1,0,"Eastern Division","PBE",7,2,5,"7 - 2",4,29,52,85,2704,841,9,0.762764456981664,7,2,"7 - 2","#D0D02B",1,2,"2029"
24,100,44,2029-05-27,1905,9,1,5,"FL","Florida Space Rangers","away",0,1,"Eastern Division","PBE",7,3,4,"7 - 3",5,34,53,90,2809,1156,10,0.708448928121059,7,3,"7 - 3","#D0D02B",1,2,"2029"
24,100,49,2029-05-28,1905,9,6,8,"FL","Florida Space Rangers","away",1,0,"Eastern Division","PBE",8,3,5,"8 - 3",3,37,59,98,3481,1369,11,0.717731958762887,8,3,"8 - 3","#D0D02B",1,2,"2029"
24,100,54,2029-05-29,1905,9,3,4,"FL","Florida Space Rangers","away",0,1,"Eastern Division","PBE",8,4,4,"8 - 4",4,41,62,102,3844,1681,12,0.695746606334842,8,4,"8 - 4","#D0D02B",1,2,"2029"
24,100,59,2029-06-01,1905,9,3,5,"FL","Florida Space Rangers","away",1,0,"Eastern Division","PBE",9,4,5,"9 - 4",2,43,65,107,4225,1849,13,0.695587751070135,9,4,"9 - 4","#D0D02B",1,2,"2029"
24,100,64,2029-06-02,1905,9,4,11,"FL","Florida Space Rangers","away",0,1,"Eastern Division","PBE",9,5,4,"9 - 5",8,51,69,118,4761,2601,14,0.646699266503667,9,5,"9 - 5","#D0D02B",1,2,"2029"
24,100,69,2029-06-03,1905,9,12,14,"FL","Florida Space Rangers","away",1,0,"Eastern Division","PBE",10,5,5,"10 - 5",5,56,81,132,6561,3136,15,0.676601010621842,10,5,"10 - 5","#D0D02B",1,2,"2029"
24,100,74,2029-06-04,1905,9,13,17,"FL","Florida Space Rangers","away",1,0,"Eastern Division","PBE",11,5,6,"11 - 5",4,60,94,149,8836,3600,16,0.710517851399164,11,5,"11 - 5","#D0D02B",1,2,"2029"
24,100,81,2029-06-06,1905,9,3,9,"FL","Florida Space Rangers","home",1,0,"Eastern Division","PBE",12,5,7,"12 - 5",2,62,97,158,9409,3844,17,0.709952463593149,12,5,"12 - 5","#D0D02B",1,2,"2029"
24,100,85,2029-06-07,1905,9,1,3,"FL","Florida Space Rangers","home",1,0,"Eastern Division","PBE",13,5,8,"13 - 5",0,62,98,161,9604,3844,18,0.714158239143367,13,5,"13 - 5","#D0D02B",1,2,"2029"
24,100,90,2029-06-08,1905,9,11,13,"FL","Florida Space Rangers","home",1,0,"Eastern Division","PBE",14,5,9,"14 - 5",5,67,109,174,11881,4489,19,0.725778863775199,14,5,"14 - 5","#D0D02B",1,2,"2029"
24,100,94,2029-06-09,1905,9,0,2,"FL","Florida Space Rangers","home",0,1,"Eastern Division","PBE",14,6,8,"14 - 6",1,68,109,176,11881,4624,20,0.719842471978188,14,6,"14 - 6","#D0D02B",1,2,"2029"
24,100,97,2029-06-11,1905,12,6,11,"FL","Florida Space Rangers","home",1,0,"Eastern Division","PBE",15,6,9,"15 - 6",5,73,115,187,13225,5329,21,0.712784305271101,15,6,"15 - 6","#D0D02B",1,2,"2029"
24,100,102,2029-06-12,1905,9,1,4,"FL","Florida Space Rangers","home",0,1,"Eastern Division","PBE",15,7,8,"15 - 7",3,76,116,191,13456,5776,22,0.699667221297837,15,7,"15 - 7","#D0D02B",1,2,"2029"
24,100,107,2029-06-13,1905,9,6,6,"FL","Florida Space Rangers","home",1,0,"Eastern Division","PBE",16,7,9,"16 - 7",4,80,122,197,14884,6400,23,0.699304641984589,16,7,"16 - 7","#D0D02B",1,2,"2029"
24,100,121,2029-06-17,1905,9,5,6,"FL","Florida Space Rangers","away",1,0,"Eastern Division","PBE",17,7,10,"17 - 7",3,83,127,203,16129,6889,24,0.700712485880615,17,7,"17 - 7","#D0D02B",1,2,"2029"
24,100,126,2029-06-18,1905,9,8,11,"FL","Florida Space Rangers","away",1,0,"Eastern Division","PBE",18,7,11,"18 - 7",6,89,135,214,18225,7921,25,0.697047349498967,17,8,"17 - 8","#D0D02B",1,2,"2029"
24,100,131,2029-06-19,1905,9,3,11,"FL","Florida Space Rangers","away",0,1,"Eastern Division","PBE",18,8,10,"18 - 8",8,97,138,225,19044,9409,26,0.669314307805855,17,9,"17 - 9","#D0D02B",1,2,"2029"
24,100,137,2029-06-22,1905,9,5,7,"FL","Florida Space Rangers","home",1,0,"Eastern Division","PBE",19,8,11,"19 - 8",1,98,143,232,20449,9604,27,0.680431238145942,18,9,"18 - 9","#D0D02B",1,2,"2029"
24,100,142,2029-06-23,1905,9,3,8,"FL","Florida Space Rangers","home",1,0,"Eastern Division","PBE",20,8,12,"20 - 8",0,98,146,240,21316,9604,28,0.689391979301423,19,9,"19 - 9","#D0D02B",1,2,"2029"
24,100,147,2029-06-24,1905,9,0,5,"FL","Florida Space Rangers","home",0,1,"Eastern Division","PBE",20,9,11,"20 - 9",2,100,146,245,21316,10000,29,0.680674415634181,20,9,"20 - 9","#D0D02B",1,2,"2029"
24,100,152,2029-06-25,1905,9,5,11,"FL","Florida Space Rangers","home",1,0,"Eastern Division","PBE",21,9,12,"21 - 9",0,100,151,256,22801,10000,30,0.695131245998598,21,9,"21 - 9","#D0D02B",1,2,"2029"
24,100,160,2029-06-28,1905,9,9,13,"FL","Florida Space Rangers","home",1,0,"Eastern Division","PBE",22,9,13,"22 - 9",4,104,160,269,25600,10816,31,0.70298769771529,22,9,"22 - 9","#D0D02B",1,2,"2029"
24,100,165,2029-06-29,1905,9,3,9,"FL","Florida Space Rangers","home",0,1,"Eastern Division","PBE",22,10,12,"22 - 10",10,114,163,278,26569,12996,32,0.671527865537723,21,11,"21 - 11","#D0D02B",1,2,"2029"
24,100,170,2029-06-30,1905,9,1,10,"FL","Florida Space Rangers","home",0,1,"Eastern Division","PBE",22,11,11,"22 - 11",6,120,164,288,26896,14400,33,0.651297946532352,21,12,"21 - 12","#D0D02B",1,2,"2029"
24,100,177,2029-07-03,1905,9,11,14,"FL","Florida Space Rangers","away",1,0,"Eastern Division","PBE",23,11,12,"23 - 11",7,127,175,302,30625,16129,34,0.655024169055054,22,12,"22 - 12","#D0D02B",1,2,"2029"
24,100,182,2029-07-04,1905,9,6,6,"FL","Florida Space Rangers","away",1,0,"Eastern Division","PBE",24,11,13,"24 - 11",2,129,181,308,32761,16641,35,0.663151289421481,23,12,"23 - 12","#D0D02B",1,2,"2029"
24,100,187,2029-07-05,1905,9,2,6,"FL","Florida Space Rangers","away",1,0,"Eastern Division","PBE",25,11,14,"25 - 11",1,130,183,314,33489,16900,36,0.664609339339935,24,12,"24 - 12","#D0D02B",1,2,"2029"
24,100,192,2029-07-06,1905,9,7,12,"FL","Florida Space Rangers","away",1,0,"Eastern Division","PBE",26,11,15,"26 - 11",1,131,190,326,36100,17161,37,0.677794258463041,25,12,"25 - 12","#D0D02B",1,2,"2029"
24,100,194,2029-07-09,1905,9,2,5,"FL","Florida Space Rangers","home",1,0,"Eastern Division","PBE",27,11,16,"27 - 11",0,131,192,331,36864,17161,38,0.6823507635354,26,12,"26 - 12","#D0D02B",1,2,"2029"
24,100,199,2029-07-10,1905,9,6,10,"FL","Florida Space Rangers","home",0,1,"Eastern Division","PBE",27,12,15,"27 - 12",8,139,198,341,39204,19321,39,0.669867577958138,26,13,"26 - 13","#D0D02B",1,2,"2029"
24,100,204,2029-07-11,1905,9,0,4,"FL","Florida Space Rangers","home",0,1,"Eastern Division","PBE",27,13,14,"27 - 13",7,146,198,345,39204,21316,40,0.6477858559154,26,14,"26 - 14","#D0D02B",1,2,"2029"
24,100,209,2029-07-12,1905,9,5,7,"FL","Florida Space Rangers","home",1,0,"Eastern Division","PBE",28,13,15,"28 - 13",0,146,203,352,41209,21316,41,0.659080367852859,27,14,"27 - 14","#D0D02B",1,2,"2029"
24,100,216,2029-07-15,1905,9,3,4,"FL","Florida Space Rangers","away",1,0,"Eastern Division","PBE",29,13,16,"29 - 13",2,148,206,356,42436,21904,42,0.659558594964252,28,14,"28 - 14","#D0D02B",1,2,"2029"
24,100,221,2029-07-16,1905,9,10,12,"FL","Florida Space Rangers","away",1,0,"Eastern Division","PBE",30,13,17,"30 - 13",7,155,216,368,46656,24025,43,0.660092528402258,28,15,"28 - 15","#D0D02B",1,2,"2029"
24,100,226,2029-07-17,1905,9,0,5,"FL","Florida Space Rangers","away",0,1,"Eastern Division","PBE",30,14,16,"30 - 14",3,158,216,373,46656,24964,44,0.651438145769338,29,15,"29 - 15","#D0D02B",1,2,"2029"
24,100,231,2029-07-18,1905,9,3,6,"FL","Florida Space Rangers","away",0,1,"Eastern Division","PBE",30,15,15,"30 - 15",8,166,219,379,47961,27556,45,0.635102030006489,29,16,"29 - 16","#D0D02B",1,2,"2029"
24,100,234,2029-07-21,1905,9,1,7,"FL","Florida Space Rangers","away",0,1,"Eastern Division","PBE",30,16,14,"30 - 16",2,168,220,386,48400,28224,46,0.631655878053873,29,17,"29 - 17","#D0D02B",1,2,"2029"
24,100,239,2029-07-22,1905,9,9,15,"FL","Florida Space Rangers","away",1,0,"Eastern Division","PBE",31,16,15,"31 - 16",5,173,229,401,52441,29929,47,0.636651693577759,30,17,"30 - 17","#D0D02B",1,2,"2029"
24,100,244,2029-07-23,1905,9,4,7,"FL","Florida Space Rangers","away",1,0,"Eastern Division","PBE",32,16,16,"32 - 16",3,176,233,408,54289,30976,48,0.636709083445728,31,17,"31 - 17","#D0D02B",1,2,"2029"
24,100,249,2029-07-24,1905,9,5,12,"FL","Florida Space Rangers","away",1,0,"Eastern Division","PBE",33,16,17,"33 - 16",0,176,238,420,56644,30976,49,0.64647340789774,32,17,"32 - 17","#D0D02B",1,2,"2029"
24,100,257,2029-08-12,1905,9,4,10,"FL","Florida Space Rangers","home",1,0,"Eastern Division","PBE",34,16,18,"34 - 16",1,177,242,430,58564,31329,50,0.651485655167811,33,17,"33 - 17","#D0D02B",1,2,"2029"
24,100,262,2029-08-13,1905,9,8,11,"FL","Florida Space Rangers","home",1,0,"Eastern Division","PBE",35,16,19,"35 - 16",4,181,250,441,62500,32761,51,0.656092209823537,33,18,"33 - 18","#D0D02B",1,2,"2029"
24,100,267,2029-08-14,1905,9,8,9,"FL","Florida Space Rangers","home",1,0,"Eastern Division","PBE",36,16,20,"36 - 16",1,182,258,450,66564,33124,52,0.667723296685659,35,17,"35 - 17","#D0D02B",1,2,"2029"
24,100,272,2029-08-15,1905,9,3,9,"FL","Florida Space Rangers","home",0,1,"Eastern Division","PBE",36,17,19,"36 - 17",8,190,261,459,68121,36100,53,0.653620671457768,35,18,"35 - 18","#D0D02B",1,2,"2029"
24,100,274,2029-08-17,1905,9,6,14,"FL","Florida Space Rangers","away",1,0,"Eastern Division","PBE",37,17,20,"37 - 17",1,191,267,473,71289,36481,54,0.661492066437784,36,18,"36 - 18","#D0D02B",1,2,"2029"
24,100,278,2029-08-18,1905,9,5,8,"FL","Florida Space Rangers","away",0,1,"Eastern Division","PBE",37,18,19,"37 - 18",8,199,272,481,73984,39601,55,0.651353611832548,36,19,"36 - 19","#D0D02B",1,2,"2029"
24,100,283,2029-08-19,1905,9,7,10,"FL","Florida Space Rangers","away",1,0,"Eastern Division","PBE",38,18,20,"38 - 18",1,200,279,491,77841,40000,56,0.660559567552889,37,19,"37 - 19","#D0D02B",1,2,"2029"
24,100,288,2029-08-20,1905,9,2,9,"FL","Florida Space Rangers","away",0,1,"Eastern Division","PBE",38,19,19,"38 - 19",5,205,281,500,78961,42025,57,0.652645760666523,37,20,"37 - 20","#D0D02B",1,2,"2029"
24,100,295,2029-08-23,1905,9,5,5,"FL","Florida Space Rangers","away",0,1,"Eastern Division","PBE",38,20,18,"38 - 20",10,215,286,505,81796,46225,58,0.638926426133212,37,21,"37 - 21","#D0D02B",1,2,"2029"
24,100,300,2029-08-24,1905,9,9,16,"FL","Florida Space Rangers","away",1,0,"Eastern Division","PBE",39,20,19,"39 - 20",2,217,295,521,87025,47089,59,0.648888259242137,38,21,"38 - 21","#D0D02B",1,2,"2029"
24,100,631,2029-08-25,1905,9,2,3,"FL","Florida Space Rangers","away",0,1,"Eastern Division","PBE",39,21,18,"39 - 21",17,234,297,524,88209,54756,60,0.61699716713881,37,23,"37 - 23","#D0D02B",1,2,"2029"
24,100,635,2029-08-27,1905,9,11,13,"FL","Florida Space Rangers","away",1,0,"Eastern Division","PBE",40,21,19,"40 - 21",1,235,308,537,94864,55225,61,0.632051649354716,39,22,"39 - 22","#D0D02B",1,2,"2029"
24,100,640,2029-08-28,1905,10,4,8,"FL","Florida Space Rangers","away",0,1,"Eastern Division","PBE",40,22,18,"40 - 22",5,240,312,545,97344,57600,62,0.628252788104089,39,23,"39 - 23","#D0D02B",1,2,"2029"
24,100,645,2029-08-29,1905,9,6,7,"FL","Florida Space Rangers","away",1,0,"Eastern Division","PBE",41,22,19,"41 - 22",2,242,318,552,101124,58564,63,0.633259856720605,40,23,"40 - 23","#D0D02B",1,2,"2029"
24,100,650,2029-08-30,1905,9,7,12,"FL","Florida Space Rangers","away",1,0,"Eastern Division","PBE",42,22,20,"42 - 22",0,242,325,564,105625,58564,64,0.643313498468229,41,23,"41 - 23","#D0D02B",1,2,"2029"
24,100,658,2029-09-02,1905,9,3,7,"FL","Florida Space Rangers","home",1,0,"Eastern Division","PBE",43,22,21,"43 - 22",2,244,328,571,107584,59536,65,0.643752991862135,42,23,"42 - 23","#D0D02B",1,2,"2029"
24,100,663,2029-09-03,1905,12,6,13,"FL","Florida Space Rangers","home",0,1,"Eastern Division","PBE",43,23,20,"43 - 23",7,251,334,584,111556,63001,66,0.639080644144893,42,24,"42 - 24","#D0D02B",1,2,"2029"
24,100,668,2029-09-04,1905,9,4,7,"FL","Florida Space Rangers","home",1,0,"Eastern Division","PBE",44,23,21,"44 - 23",3,254,338,591,114244,64516,67,0.639091519355561,43,24,"43 - 24","#D0D02B",1,2,"2029"
24,100,673,2029-09-05,1905,9,3,10,"FL","Florida Space Rangers","home",0,1,"Eastern Division","PBE",44,24,20,"44 - 24",10,264,341,601,116281,69696,68,0.625243981782694,43,25,"43 - 25","#D0D02B",1,2,"2029"
24,100,675,2029-09-08,1905,9,5,12,"FL","Florida Space Rangers","home",1,0,"Eastern Division","PBE",45,24,21,"45 - 24",3,267,346,613,119716,71289,69,0.626768932750452,43,26,"43 - 26","#D0D02B",1,2,"2029"
24,100,680,2029-09-09,1905,9,6,10,"FL","Florida Space Rangers","home",1,0,"Eastern Division","PBE",46,24,22,"46 - 24",5,272,352,623,123904,73984,70,0.626131953428202,44,26,"44 - 26","#D0D02B",1,2,"2029"
24,100,685,2029-09-10,1905,9,20,20,"FL","Florida Space Rangers","home",1,0,"Eastern Division","PBE",47,24,23,"47 - 24",5,277,372,643,138384,76729,71,0.643308400701027,46,25,"46 - 25","#D0D02B",1,2,"2029"
24,100,690,2029-09-11,1905,9,9,13,"FL","Florida Space Rangers","home",0,1,"Eastern Division","PBE",47,25,22,"47 - 25",12,289,381,656,145161,83521,72,0.634772303897989,46,26,"46 - 26","#D0D02B",1,2,"2029"
24,100,696,2029-09-14,1905,9,3,5,"FL","Florida Space Rangers","home",1,0,"Eastern Division","PBE",48,25,23,"48 - 25",2,291,384,661,147456,84681,73,0.635211103787849,46,27,"46 - 27","#D0D02B",1,2,"2029"
24,100,701,2029-09-15,1905,9,3,5,"FL","Florida Space Rangers","home",1,0,"Eastern Division","PBE",49,25,24,"49 - 25",1,292,387,666,149769,85264,74,0.637225410899746,47,27,"47 - 27","#D0D02B",1,2,"2029"
24,100,706,2029-09-16,1905,9,1,7,"FL","Florida Space Rangers","home",0,1,"Eastern Division","PBE",49,26,23,"49 - 26",4,296,388,673,150544,87616,75,0.632112865300638,47,28,"47 - 28","#D0D02B",1,2,"2029"
24,100,711,2029-09-17,1905,9,1,3,"FL","Florida Space Rangers","home",0,1,"Eastern Division","PBE",49,27,22,"49 - 27",2,298,389,676,151321,88804,76,0.630175950026028,48,28,"48 - 28","#D0D02B",1,2,"2029"
24,100,714,2029-09-20,1905,9,8,11,"FL","Florida Space Rangers","away",1,0,"Eastern Division","PBE",50,27,23,"50 - 27",0,298,397,687,157609,88804,77,0.639613169759712,49,28,"49 - 28","#D0D02B",1,2,"2029"
24,100,719,2029-09-21,1905,9,2,7,"FL","Florida Space Rangers","away",0,1,"Eastern Division","PBE",50,28,22,"50 - 28",9,307,399,694,159201,94249,78,0.628135726967844,49,29,"49 - 29","#D0D02B",1,2,"2029"
24,100,724,2029-09-22,1905,9,6,8,"FL","Florida Space Rangers","away",1,0,"Eastern Division","PBE",51,28,23,"51 - 28",5,312,405,702,164025,97344,79,0.627561034399642,50,29,"50 - 29","#D0D02B",1,2,"2029"
24,100,730,2029-09-23,1905,10,11,20,"FL","Florida Space Rangers","away",1,0,"Eastern Division","PBE",52,28,24,"52 - 28",9,321,416,722,173056,103041,80,0.626794206383988,50,30,"50 - 30","#D0D02B",1,2,"2029"
24,100,734,2029-09-25,1905,9,12,13,"FL","Florida Space Rangers","away",1,0,"Eastern Division","PBE",53,28,25,"53 - 28",3,324,428,735,183184,104976,81,0.635702387562465,51,30,"51 - 30","#D0D02B",1,2,"2029"
24,100,739,2029-09-26,1905,9,4,8,"FL","Florida Space Rangers","away",1,0,"Eastern Division","PBE",54,28,26,"54 - 28",1,325,432,743,186624,105625,82,0.638578746206146,52,30,"52 - 30","#D0D02B",1,2,"2029"
24,100,744,2029-09-27,1905,9,5,9,"FL","Florida Space Rangers","away",0,1,"Eastern Division","PBE",54,29,25,"54 - 29",12,337,437,752,190969,113569,83,0.627077737425215,52,31,"52 - 31","#D0D02B",1,2,"2029"
24,100,749,2029-09-28,1905,9,8,14,"FL","Florida Space Rangers","away",1,0,"Eastern Division","PBE",55,29,26,"55 - 29",7,344,445,766,198025,118336,84,0.625946308173258,53,31,"53 - 31","#D0D02B",1,2,"2029"
24,100,753,2029-09-30,1905,9,4,6,"FL","Florida Space Rangers","home",1,0,"Eastern Division","PBE",56,29,27,"56 - 29",3,347,449,772,201601,120409,85,0.626070618924878,53,32,"53 - 32","#D0D02B",1,2,"2029"
24,100,758,2029-10-01,1905,9,9,12,"FL","Florida Space Rangers","home",1,0,"Eastern Division","PBE",57,29,28,"57 - 29",0,347,458,784,209764,120409,86,0.635315425549636,55,31,"55 - 31","#D0D02B",1,2,"2029"
24,100,763,2029-10-02,1905,9,8,11,"FL","Florida Space Rangers","home",1,0,"Eastern Division","PBE",58,29,29,"58 - 29",5,352,466,795,217156,123904,87,0.636709083445728,55,32,"55 - 32","#D0D02B",1,2,"2029"
24,100,768,2029-10-03,1905,9,5,11,"FL","Florida Space Rangers","home",0,1,"Eastern Division","PBE",58,30,28,"58 - 30",6,358,471,806,221841,128164,88,0.633822373966086,56,32,"56 - 32","#D0D02B",1,2,"2029"
24,100,774,2029-10-05,1905,9,4,11,"FL","Florida Space Rangers","home",0,1,"Eastern Division","PBE",58,31,27,"58 - 31",8,366,475,817,225625,133956,89,0.627466412296534,56,33,"56 - 33","#D0D02B",1,2,"2029"
24,100,778,2029-10-06,1905,9,3,7,"FL","Florida Space Rangers","home",1,0,"Eastern Division","PBE",59,31,28,"59 - 31",1,367,478,824,228484,134689,90,0.629132672307688,57,33,"57 - 33","#D0D02B",1,2,"2029"
24,100,783,2029-10-07,1905,9,6,8,"FL","Florida Space Rangers","home",1,0,"Eastern Division","PBE",60,31,29,"60 - 31",1,368,484,832,234256,135424,91,0.633672365288898,58,33,"58 - 33","#D0D02B",1,2,"2029"
24,100,788,2029-10-08,1905,9,4,9,"FL","Florida Space Rangers","home",1,0,"Eastern Division","PBE",61,31,30,"61 - 31",0,368,488,841,238144,135424,92,0.637485009422649,59,33,"59 - 33","#D0D02B",1,2,"2029"
24,100,791,2029-10-10,1905,9,3,6,"FL","Florida Space Rangers","home",0,1,"Eastern Division","PBE",61,32,29,"61 - 32",4,372,491,847,241081,138384,93,0.635318145283491,59,34,"59 - 34","#D0D02B",1,2,"2029"
24,100,795,2029-10-11,1905,9,2,11,"FL","Florida Space Rangers","home",0,1,"Eastern Division","PBE",61,33,28,"61 - 33",6,378,493,858,243049,142884,94,0.629769934159556,59,35,"59 - 35","#D0D02B",1,2,"2029"
24,100,800,2029-10-12,1905,12,4,11,"FL","Florida Space Rangers","home",1,0,"Eastern Division","PBE",62,33,29,"62 - 33",2,380,497,869,247009,144400,95,0.631076444333166,60,35,"60 - 35","#D0D02B",1,2,"2029"
24,100,805,2029-10-13,1905,9,2,5,"FL","Florida Space Rangers","home",1,0,"Eastern Division","PBE",63,33,30,"63 - 33",1,381,499,874,249001,145161,96,0.631722489737722,61,35,"61 - 35","#D0D02B",1,2,"2029"
24,100,810,2029-10-15,1905,11,3,10,"FL","Florida Space Rangers","away",0,1,"Eastern Division","PBE",63,34,29,"63 - 34",4,385,502,884,252004,148225,97,0.629649525646567,61,36,"61 - 36","#D0D02B",1,2,"2029"
24,100,814,2029-10-16,1905,9,12,16,"FL","Florida Space Rangers","away",1,0,"Eastern Division","PBE",64,34,30,"64 - 34",3,388,514,900,264196,150544,98,0.637015961807397,62,36,"62 - 36","#D0D02B",1,2,"2029"
24,100,819,2029-10-17,1905,9,8,12,"FL","Florida Space Rangers","away",1,0,"Eastern Division","PBE",65,34,31,"65 - 34",1,389,522,912,272484,151321,99,0.642946638194453,64,35,"64 - 35","#D0D02B",1,2,"2029"
24,100,824,2029-10-18,1905,9,5,13,"FL","Florida Space Rangers","away",1,0,"Eastern Division","PBE",66,34,32,"66 - 34",1,390,527,925,277729,152100,100,0.646138348040732,65,35,"65 - 35","#D0D02B",1,2,"2029"
25,100,5,2029-05-15,1905,9,1,4,"UTA","Utah Railroaders","home",0,1,"Western Division","PBE",0,1,-1,"0 - 1",4,4,1,4,1,16,1,0.0588235294117647,0,1,"0 - 1","#2C0060",4,8,"2029"
25,100,10,2029-05-16,1905,9,2,11,"UTA","Utah Railroaders","home",0,1,"Western Division","PBE",0,2,-2,"0 - 2",4,8,3,15,9,64,2,0.123287671232877,0,2,"0 - 2","#2C0060",4,8,"2029"
25,100,15,2029-05-17,1905,10,2,9,"UTA","Utah Railroaders","home",0,1,"Western Division","PBE",0,3,-3,"0 - 3",3,11,5,24,25,121,3,0.171232876712329,1,2,"1 - 2","#2C0060",4,8,"2029"
25,100,20,2029-05-18,1905,9,0,3,"UTA","Utah Railroaders","home",0,1,"Western Division","PBE",0,4,-4,"0 - 4",10,21,5,27,25,441,4,0.0536480686695279,0,4,"0 - 4","#2C0060",4,8,"2029"
25,100,25,2029-05-21,1905,9,8,12,"UTA","Utah Railroaders","away",1,0,"Western Division","PBE",1,4,-3,"1 - 4",6,27,13,39,169,729,5,0.188195991091314,1,4,"1 - 4","#2C0060",4,8,"2029"
25,100,30,2029-05-22,1905,9,7,7,"UTA","Utah Railroaders","away",1,0,"Western Division","PBE",2,4,-2,"2 - 4",4,31,20,46,400,961,6,0.293901542983101,2,4,"2 - 4","#2C0060",4,8,"2029"
25,100,35,2029-05-23,1905,9,4,10,"UTA","Utah Railroaders","away",0,1,"Western Division","PBE",2,5,-3,"2 - 5",6,37,24,56,576,1369,7,0.296143958868895,2,5,"2 - 5","#2C0060",4,8,"2029"
25,100,39,2029-05-24,1905,11,3,10,"UTA","Utah Railroaders","away",0,1,"Western Division","PBE",2,6,-4,"2 - 6",4,41,27,66,729,1681,8,0.302489626556017,2,6,"2 - 6","#2C0060",4,8,"2029"
25,100,43,2029-05-26,1905,9,9,10,"UTA","Utah Railroaders","home",1,0,"Western Division","PBE",3,6,-3,"3 - 6",1,42,36,76,1296,1764,9,0.423529411764706,4,5,"4 - 5","#2C0060",4,8,"2029"
25,100,48,2029-05-27,1905,9,6,7,"UTA","Utah Railroaders","home",1,0,"Western Division","PBE",4,6,-2,"4 - 6",2,44,42,83,1764,1936,10,0.476756756756757,5,5,"5 - 5","#2C0060",4,8,"2029"
25,100,53,2029-05-28,1905,9,2,4,"UTA","Utah Railroaders","home",0,1,"Western Division","PBE",4,7,-3,"4 - 7",4,48,44,87,1936,2304,11,0.456603773584906,5,6,"5 - 6","#2C0060",4,8,"2029"
25,100,58,2029-05-29,1905,9,5,5,"UTA","Utah Railroaders","home",1,0,"Western Division","PBE",5,7,-2,"5 - 7",2,50,49,92,2401,2500,12,0.489900020403999,6,6,"6 - 6","#2C0060",4,8,"2029"
25,100,61,2029-06-01,1905,9,7,9,"UTA","Utah Railroaders","home",1,0,"Western Division","PBE",6,7,-1,"6 - 7",5,55,56,101,3136,3025,13,0.509008277876968,7,6,"7 - 6","#2C0060",4,8,"2029"
25,100,66,2029-06-02,1905,9,3,8,"UTA","Utah Railroaders","home",0,1,"Western Division","PBE",6,8,-2,"6 - 8",8,63,59,109,3481,3969,14,0.467248322147651,7,7,"7 - 7","#2C0060",4,8,"2029"
25,100,71,2029-06-03,1905,9,1,6,"UTA","Utah Railroaders","home",0,1,"Western Division","PBE",6,9,-3,"6 - 9",11,74,60,115,3600,5476,15,0.396650506831203,6,9,"6 - 9","#2C0060",4,8,"2029"
25,100,76,2029-06-04,1905,9,4,7,"UTA","Utah Railroaders","home",0,1,"Western Division","PBE",6,10,-4,"6 - 10",8,82,64,122,4096,6724,16,0.378558225508318,6,10,"6 - 10","#2C0060",4,8,"2029"
25,100,87,2029-06-07,1905,9,4,8,"UTA","Utah Railroaders","home",1,0,"Western Division","PBE",7,10,-3,"7 - 10",2,84,68,130,4624,7056,17,0.395890410958904,7,10,"7 - 10","#2C0060",4,8,"2029"
25,100,92,2029-06-08,1905,10,4,10,"UTA","Utah Railroaders","home",0,1,"Western Division","PBE",7,11,-4,"7 - 11",5,89,72,140,5184,7921,18,0.395574208317436,7,11,"7 - 11","#2C0060",4,8,"2029"
25,100,96,2029-06-09,1905,9,2,8,"UTA","Utah Railroaders","home",0,1,"Western Division","PBE",7,12,-5,"7 - 12",9,98,74,148,5476,9604,19,0.363129973474801,7,12,"7 - 12","#2C0060",4,8,"2029"
25,100,101,2029-06-11,1905,9,9,9,"UTA","Utah Railroaders","away",1,0,"Western Division","PBE",8,12,-4,"8 - 12",2,100,83,157,6889,10000,20,0.40789863224584,8,12,"8 - 12","#2C0060",4,8,"2029"
25,100,106,2029-06-12,1905,9,2,7,"UTA","Utah Railroaders","away",0,1,"Western Division","PBE",8,13,-5,"8 - 13",3,103,85,164,7225,10609,21,0.405125042054503,9,12,"9 - 12","#2C0060",4,8,"2029"
25,100,111,2029-06-13,1905,9,7,13,"UTA","Utah Railroaders","away",1,0,"Western Division","PBE",9,13,-4,"9 - 13",3,106,92,177,8464,11236,22,0.429644670050761,9,13,"9 - 13","#2C0060",4,8,"2029"
25,100,115,2029-06-14,1905,9,2,7,"UTA","Utah Railroaders","away",0,1,"Western Division","PBE",9,14,-5,"9 - 14",4,110,94,184,8836,12100,23,0.4220481467329,10,13,"10 - 13","#2C0060",4,8,"2029"
25,100,117,2029-06-16,1905,9,3,3,"UTA","Utah Railroaders","home",0,1,"Western Division","PBE",9,15,-6,"9 - 15",13,123,97,187,9409,15129,24,0.383446083625397,9,15,"9 - 15","#2C0060",4,8,"2029"
25,100,122,2029-06-17,1905,9,5,9,"UTA","Utah Railroaders","home",1,0,"Western Division","PBE",10,15,-5,"10 - 15",3,126,102,196,10404,15876,25,0.395890410958904,10,15,"10 - 15","#2C0060",4,8,"2029"
25,100,127,2029-06-18,1905,9,0,5,"UTA","Utah Railroaders","home",0,1,"Western Division","PBE",10,16,-6,"10 - 16",5,131,102,201,10404,17161,26,0.377435153274079,10,16,"10 - 16","#2C0060",4,8,"2029"
25,100,132,2029-06-19,1905,13,7,13,"UTA","Utah Railroaders","home",0,1,"Western Division","PBE",10,17,-7,"10 - 17",9,140,109,214,11881,19600,27,0.377402242622534,10,17,"10 - 17","#2C0060",4,8,"2029"
25,100,139,2029-06-22,1905,9,5,8,"UTA","Utah Railroaders","away",0,1,"Western Division","PBE",10,18,-8,"10 - 18",7,147,114,222,12996,21609,28,0.37555266579974,11,17,"11 - 17","#2C0060",4,8,"2029"
25,100,144,2029-06-23,1905,9,6,13,"UTA","Utah Railroaders","away",1,0,"Western Division","PBE",11,18,-7,"11 - 18",4,151,120,235,14400,22801,29,0.387086368646004,11,18,"11 - 18","#2C0060",4,8,"2029"
25,100,149,2029-06-24,1905,9,6,10,"UTA","Utah Railroaders","away",0,1,"Western Division","PBE",11,19,-8,"11 - 19",9,160,126,245,15876,25600,30,0.382775581058926,11,19,"11 - 19","#2C0060",4,8,"2029"
25,100,154,2029-06-25,1905,12,7,12,"UTA","Utah Railroaders","away",1,0,"Western Division","PBE",12,19,-7,"12 - 19",6,166,133,257,17689,27556,31,0.390960327107968,12,19,"12 - 19","#2C0060",4,8,"2029"
25,100,157,2029-06-27,1905,9,3,9,"UTA","Utah Railroaders","away",1,0,"Western Division","PBE",13,19,-6,"13 - 19",2,168,136,266,18496,28224,32,0.395890410958904,13,19,"13 - 19","#2C0060",4,8,"2029"
25,100,162,2029-06-28,1905,9,11,15,"UTA","Utah Railroaders","away",1,0,"Western Division","PBE",14,19,-5,"14 - 19",3,171,147,281,21609,29241,33,0.424955752212389,14,19,"14 - 19","#2C0060",4,8,"2029"
25,100,167,2029-06-29,1905,9,3,5,"UTA","Utah Railroaders","away",0,1,"Western Division","PBE",14,20,-6,"14 - 20",6,177,150,286,22500,31329,34,0.417990302624979,14,20,"14 - 20","#2C0060",4,8,"2029"
25,100,172,2029-06-30,1905,9,2,5,"UTA","Utah Railroaders","away",0,1,"Western Division","PBE",14,21,-7,"14 - 21",3,180,152,291,23104,32400,35,0.416258287690977,15,20,"15 - 20","#2C0060",4,8,"2029"
25,100,177,2029-07-03,1905,9,7,10,"UTA","Utah Railroaders","home",0,1,"Western Division","PBE",14,22,-8,"14 - 22",11,191,159,301,25281,36481,36,0.409329361095819,15,21,"15 - 21","#2C0060",4,8,"2029"
25,100,182,2029-07-04,1905,9,2,8,"UTA","Utah Railroaders","home",0,1,"Western Division","PBE",14,23,-9,"14 - 23",6,197,161,309,25921,38809,37,0.400448014830836,15,22,"15 - 22","#2C0060",4,8,"2029"
25,100,187,2029-07-05,1905,9,1,3,"UTA","Utah Railroaders","home",0,1,"Western Division","PBE",14,24,-10,"14 - 24",2,199,162,312,26244,39601,38,0.398572404890273,15,23,"15 - 23","#2C0060",4,8,"2029"
25,100,192,2029-07-06,1905,9,1,8,"UTA","Utah Railroaders","home",0,1,"Western Division","PBE",14,25,-11,"14 - 25",7,206,163,320,26569,42436,39,0.385030070284762,15,24,"15 - 24","#2C0060",4,8,"2029"
25,100,198,2029-07-09,1905,9,4,8,"UTA","Utah Railroaders","home",1,0,"Western Division","PBE",15,25,-10,"15 - 25",3,209,167,328,27889,43681,40,0.389674444599693,16,24,"16 - 24","#2C0060",4,8,"2029"
25,100,203,2029-07-10,1905,9,2,6,"UTA","Utah Railroaders","home",1,0,"Western Division","PBE",16,25,-9,"16 - 25",1,210,169,334,28561,44100,41,0.393071936802411,16,25,"16 - 25","#2C0060",4,8,"2029"
25,100,208,2029-07-11,1905,9,4,9,"UTA","Utah Railroaders","home",0,1,"Western Division","PBE",16,26,-10,"16 - 26",6,216,173,343,29929,46656,42,0.390794542012143,16,26,"16 - 26","#2C0060",4,8,"2029"
25,100,213,2029-07-12,1905,9,10,14,"UTA","Utah Railroaders","home",1,0,"Western Division","PBE",17,26,-9,"17 - 26",0,216,183,357,33489,46656,43,0.417855137563167,18,25,"18 - 25","#2C0060",4,8,"2029"
25,100,215,2029-07-15,1905,9,9,13,"UTA","Utah Railroaders","away",1,0,"Western Division","PBE",18,26,-8,"18 - 26",2,218,192,370,36864,47524,44,0.436839361046594,19,25,"19 - 25","#2C0060",4,8,"2029"
25,100,220,2029-07-16,1905,9,7,14,"UTA","Utah Railroaders","away",1,0,"Western Division","PBE",19,26,-7,"19 - 26",4,222,199,384,39601,49284,45,0.445530741969961,20,25,"20 - 25","#2C0060",4,8,"2029"
25,100,225,2029-07-17,1905,9,2,7,"UTA","Utah Railroaders","away",0,1,"Western Division","PBE",19,27,-8,"19 - 27",5,227,201,391,40401,51529,46,0.439475688023496,20,26,"20 - 26","#2C0060",4,8,"2029"
25,100,230,2029-07-18,1905,9,3,6,"UTA","Utah Railroaders","away",0,1,"Western Division","PBE",19,28,-9,"19 - 28",4,231,204,397,41616,53361,47,0.438169240974131,21,26,"21 - 26","#2C0060",4,8,"2029"
25,100,236,2029-07-21,1905,10,7,10,"UTA","Utah Railroaders","away",1,0,"Western Division","PBE",20,28,-8,"20 - 28",6,237,211,407,44521,56169,48,0.442159102194855,21,27,"21 - 27","#2C0060",4,8,"2029"
25,100,241,2029-07-22,1905,10,5,13,"UTA","Utah Railroaders","away",0,1,"Western Division","PBE",20,29,-9,"20 - 29",6,243,216,420,46656,59049,49,0.441379310344828,22,27,"22 - 27","#2C0060",4,8,"2029"
25,100,246,2029-07-23,1905,12,4,7,"UTA","Utah Railroaders","away",0,1,"Western Division","PBE",20,30,-10,"20 - 30",7,250,220,427,48400,62500,50,0.436429215509468,22,28,"22 - 28","#2C0060",4,8,"2029"
25,100,251,2029-07-24,1905,9,3,9,"UTA","Utah Railroaders","away",1,0,"Western Division","PBE",21,30,-9,"21 - 30",1,251,223,436,49729,63001,51,0.441133682249623,22,29,"22 - 29","#2C0060",4,8,"2029"
25,100,257,2029-08-12,1905,9,1,7,"UTA","Utah Railroaders","away",0,1,"Western Division","PBE",21,31,-10,"21 - 31",4,255,224,443,50176,65025,52,0.435551774724178,23,29,"23 - 29","#2C0060",4,8,"2029"
25,100,262,2029-08-13,1905,9,4,10,"UTA","Utah Railroaders","away",0,1,"Western Division","PBE",21,32,-11,"21 - 32",8,263,228,453,51984,69169,53,0.429077282444512,23,30,"23 - 30","#2C0060",4,8,"2029"
25,100,267,2029-08-14,1905,9,1,9,"UTA","Utah Railroaders","away",0,1,"Western Division","PBE",21,33,-12,"21 - 33",8,271,229,462,52441,73441,54,0.416588551182854,22,32,"22 - 32","#2C0060",4,8,"2029"
25,100,272,2029-08-15,1905,9,8,7,"UTA","Utah Railroaders","away",1,0,"Western Division","PBE",22,33,-11,"22 - 33",3,274,237,469,56169,75076,55,0.427970589355785,24,31,"24 - 31","#2C0060",4,8,"2029"
25,100,281,2029-08-18,1905,9,2,5,"UTA","Utah Railroaders","away",0,1,"Western Division","PBE",22,34,-12,"22 - 34",6,280,239,474,57121,78400,56,0.421491872108382,24,32,"24 - 32","#2C0060",4,8,"2029"
25,100,286,2029-08-19,1905,9,3,6,"UTA","Utah Railroaders","away",1,0,"Western Division","PBE",23,34,-11,"23 - 34",2,282,242,480,58564,79524,57,0.424106366954406,24,33,"24 - 33","#2C0060",4,8,"2029"
25,100,291,2029-08-20,1905,9,4,11,"UTA","Utah Railroaders","away",0,1,"Western Division","PBE",23,35,-12,"23 - 35",7,289,246,491,60516,83521,58,0.420142046835188,24,34,"24 - 34","#2C0060",4,8,"2029"
25,100,294,2029-08-22,1905,10,2,6,"UTA","Utah Railroaders","home",0,1,"Western Division","PBE",23,36,-13,"23 - 36",3,292,248,497,61504,85264,59,0.419055924997275,25,34,"25 - 34","#2C0060",4,8,"2029"
25,100,299,2029-08-23,1905,9,2,7,"UTA","Utah Railroaders","home",0,1,"Western Division","PBE",23,37,-14,"23 - 37",11,303,250,504,62500,91809,60,0.405031462844034,24,36,"24 - 36","#2C0060",4,8,"2029"
25,100,630,2029-08-24,1905,9,7,11,"UTA","Utah Railroaders","home",1,0,"Western Division","PBE",24,37,-13,"24 - 37",4,307,257,515,66049,94249,61,0.41203882768344,25,36,"25 - 36","#2C0060",4,8,"2029"
25,100,638,2029-08-27,1905,9,9,9,"UTA","Utah Railroaders","away",1,0,"Western Division","PBE",25,37,-12,"25 - 37",3,310,266,524,70756,96100,62,0.424054274344345,26,36,"26 - 36","#2C0060",4,8,"2029"
25,100,643,2029-08-28,1905,9,2,8,"UTA","Utah Railroaders","away",0,1,"Western Division","PBE",25,38,-13,"25 - 38",14,324,268,532,71824,104976,63,0.406244343891403,26,37,"26 - 37","#2C0060",4,8,"2029"
25,100,648,2029-08-29,1905,9,4,10,"UTA","Utah Railroaders","away",0,1,"Western Division","PBE",25,39,-14,"25 - 39",6,330,272,542,73984,108900,64,0.404540583101857,26,38,"26 - 38","#2C0060",4,8,"2029"
25,100,653,2029-08-30,1905,12,7,10,"UTA","Utah Railroaders","away",1,0,"Western Division","PBE",26,39,-13,"26 - 39",6,336,279,552,77841,112896,65,0.408106450243005,27,38,"27 - 38","#2C0060",4,8,"2029"
25,100,654,2029-09-02,1905,9,4,3,"UTA","Utah Railroaders","home",1,0,"Western Division","PBE",27,39,-12,"27 - 39",3,339,283,555,80089,114921,66,0.410691759396954,27,39,"27 - 39","#2C0060",4,8,"2029"
25,100,659,2029-09-03,1905,9,4,4,"UTA","Utah Railroaders","home",1,0,"Western Division","PBE",28,39,-11,"28 - 39",1,340,287,559,82369,115600,67,0.416070192807965,28,39,"28 - 39","#2C0060",4,8,"2029"
25,100,664,2029-09-04,1905,9,4,8,"UTA","Utah Railroaders","home",1,0,"Western Division","PBE",29,39,-10,"29 - 39",3,343,291,567,84681,117649,68,0.418529135570603,28,40,"28 - 40","#2C0060",4,8,"2029"
25,100,669,2029-09-05,1905,9,5,9,"UTA","Utah Railroaders","home",1,0,"Western Division","PBE",30,39,-9,"30 - 39",3,346,296,576,87616,119716,69,0.422587926610461,29,40,"29 - 40","#2C0060",4,8,"2029"
25,100,677,2029-09-08,1905,9,3,7,"UTA","Utah Railroaders","away",0,1,"Western Division","PBE",30,40,-10,"30 - 40",7,353,299,583,89401,124609,70,0.417742161581235,29,41,"29 - 41","#2C0060",4,8,"2029"
25,100,682,2029-09-09,1905,9,3,7,"UTA","Utah Railroaders","away",1,0,"Western Division","PBE",31,40,-9,"31 - 40",0,353,302,590,91204,124609,71,0.422606608499025,30,41,"30 - 41","#2C0060",4,8,"2029"
25,100,687,2029-09-10,1905,9,10,10,"UTA","Utah Railroaders","away",1,0,"Western Division","PBE",32,40,-8,"32 - 40",5,358,312,600,97344,128164,72,0.431665395462689,31,41,"31 - 41","#2C0060",4,8,"2029"
25,100,692,2029-09-11,1905,9,2,11,"UTA","Utah Railroaders","away",0,1,"Western Division","PBE",32,41,-9,"32 - 41",5,363,314,611,98596,131769,73,0.427999044993814,31,42,"31 - 42","#2C0060",4,8,"2029"
25,100,695,2029-09-14,1905,9,5,10,"UTA","Utah Railroaders","home",0,1,"Western Division","PBE",32,42,-10,"32 - 42",14,377,319,621,101761,142129,74,0.417241379310345,31,43,"31 - 43","#2C0060",4,8,"2029"
25,100,700,2029-09-15,1905,9,3,6,"UTA","Utah Railroaders","home",0,1,"Western Division","PBE",32,43,-11,"32 - 43",7,384,322,627,103684,147456,75,0.41285338854822,31,44,"31 - 44","#2C0060",4,8,"2029"
25,100,705,2029-09-16,1905,9,6,9,"UTA","Utah Railroaders","home",1,0,"Western Division","PBE",33,43,-10,"33 - 43",1,385,328,636,107584,148225,76,0.42056378000774,32,44,"32 - 44","#2C0060",4,8,"2029"
25,100,710,2029-09-17,1905,9,4,11,"UTA","Utah Railroaders","home",1,0,"Western Division","PBE",34,43,-9,"34 - 43",2,387,332,647,110224,149769,77,0.423949875573573,33,44,"33 - 44","#2C0060",4,8,"2029"
25,100,717,2029-09-20,1905,9,13,16,"UTA","Utah Railroaders","home",1,0,"Western Division","PBE",35,43,-8,"35 - 43",3,390,345,663,119025,152100,78,0.439004149377593,34,44,"34 - 44","#2C0060",4,8,"2029"
25,100,722,2029-09-21,1905,9,5,7,"UTA","Utah Railroaders","home",1,0,"Western Division","PBE",36,43,-7,"36 - 43",1,391,350,670,122500,152881,79,0.444838242289773,35,44,"35 - 44","#2C0060",4,8,"2029"
25,100,727,2029-09-22,1905,9,5,10,"UTA","Utah Railroaders","home",1,0,"Western Division","PBE",37,43,-6,"37 - 43",4,395,355,680,126025,156025,80,0.446817940081546,36,44,"36 - 44","#2C0060",4,8,"2029"
25,100,732,2029-09-23,1905,11,4,13,"UTA","Utah Railroaders","home",0,1,"Western Division","PBE",37,44,-7,"37 - 44",5,400,359,693,128881,160000,81,0.446138721480471,36,45,"36 - 45","#2C0060",4,8,"2029"
25,100,738,2029-09-25,1905,9,1,4,"UTA","Utah Railroaders","away",0,1,"Western Division","PBE",37,45,-8,"37 - 45",13,413,360,697,129600,170569,82,0.431756777015615,35,47,"35 - 47","#2C0060",4,8,"2029"
25,100,743,2029-09-26,1905,9,2,7,"UTA","Utah Railroaders","away",0,1,"Western Division","PBE",37,46,-9,"37 - 46",4,417,362,704,131044,173889,83,0.429746862425516,36,47,"36 - 47","#2C0060",4,8,"2029"
25,100,748,2029-09-27,1905,9,3,4,"UTA","Utah Railroaders","away",0,1,"Western Division","PBE",37,47,-10,"37 - 47",5,422,365,708,133225,178084,84,0.427951006877411,36,48,"36 - 48","#2C0060",4,8,"2029"
25,100,752,2029-09-28,1905,9,6,9,"UTA","Utah Railroaders","away",1,0,"Western Division","PBE",38,47,-9,"38 - 47",2,424,371,717,137641,179776,85,0.433628318584071,37,48,"37 - 48","#2C0060",4,8,"2029"
25,100,757,2029-09-30,1905,9,2,7,"UTA","Utah Railroaders","home",0,1,"Western Division","PBE",38,48,-10,"38 - 48",5,429,373,724,139129,184041,86,0.430513352105703,37,49,"37 - 49","#2C0060",4,8,"2029"
25,100,762,2029-10-01,1905,9,5,7,"UTA","Utah Railroaders","home",0,1,"Western Division","PBE",38,49,-11,"38 - 49",6,435,378,731,142884,189225,87,0.430232243028644,37,50,"37 - 50","#2C0060",4,8,"2029"
25,100,767,2029-10-02,1905,9,9,9,"UTA","Utah Railroaders","home",1,0,"Western Division","PBE",39,49,-10,"39 - 49",8,443,387,740,149769,196249,88,0.432835864030195,38,50,"38 - 50","#2C0060",4,8,"2029"
25,100,772,2029-10-03,1905,9,2,10,"UTA","Utah Railroaders","home",0,1,"Western Division","PBE",39,50,-11,"39 - 50",5,448,389,750,151321,200704,89,0.429858674810028,38,51,"38 - 51","#2C0060",4,8,"2029"
25,100,775,2029-10-05,1905,9,2,9,"UTA","Utah Railroaders","away",1,0,"Western Division","PBE",40,50,-10,"40 - 50",0,448,391,759,152881,200704,90,0.432374110892713,39,51,"39 - 51","#2C0060",4,8,"2029"
25,100,780,2029-10-06,1905,9,7,11,"UTA","Utah Railroaders","away",0,1,"Western Division","PBE",40,51,-11,"40 - 51",8,456,398,770,158404,207936,91,0.432396134738221,39,52,"39 - 52","#2C0060",4,8,"2029"
25,100,785,2029-10-07,1905,9,4,10,"UTA","Utah Railroaders","away",1,0,"Western Division","PBE",41,51,-10,"41 - 51",2,458,402,780,161604,209764,92,0.435158656642468,40,52,"40 - 52","#2C0060",4,8,"2029"
25,100,790,2029-10-08,1905,10,1,5,"UTA","Utah Railroaders","away",0,1,"Western Division","PBE",41,52,-11,"41 - 52",2,460,403,785,162409,211600,93,0.434238213518926,40,53,"40 - 53","#2C0060",4,8,"2029"
25,100,799,2029-10-11,1905,9,6,12,"UTA","Utah Railroaders","away",1,0,"Western Division","PBE",42,52,-10,"42 - 52",2,462,409,797,167281,213444,94,0.439374876879638,41,53,"41 - 53","#2C0060",4,8,"2029"
25,100,804,2029-10-12,1905,9,3,4,"UTA","Utah Railroaders","away",0,1,"Western Division","PBE",42,53,-11,"42 - 53",4,466,412,801,169744,217156,95,0.438728353579736,42,53,"42 - 53","#2C0060",4,8,"2029"
25,100,809,2029-10-13,1905,9,4,8,"UTA","Utah Railroaders","away",1,0,"Western Division","PBE",43,53,-10,"43 - 53",3,469,416,809,173056,219961,96,0.440327008755346,42,54,"42 - 54","#2C0060",4,8,"2029"
25,100,812,2029-10-15,1905,9,12,15,"UTA","Utah Railroaders","home",1,0,"Western Division","PBE",44,53,-9,"44 - 53",7,476,428,824,183184,226576,97,0.447051932838735,43,54,"43 - 54","#2C0060",4,8,"2029"
25,100,817,2029-10-16,1905,9,4,6,"UTA","Utah Railroaders","home",1,0,"Western Division","PBE",45,53,-8,"45 - 53",3,479,432,830,186624,229441,98,0.448545299412351,44,54,"44 - 54","#2C0060",4,8,"2029"
25,100,822,2029-10-17,1905,9,5,9,"UTA","Utah Railroaders","home",0,1,"Western Division","PBE",45,54,-9,"45 - 54",10,489,437,839,190969,239121,99,0.444021018856518,44,55,"44 - 55","#2C0060",4,8,"2029"
25,100,827,2029-10-18,1905,9,2,7,"UTA","Utah Railroaders","home",0,1,"Western Division","PBE",45,55,-10,"45 - 55",9,498,439,846,192721,248004,100,0.437281751659198,44,56,"44 - 56","#2C0060",4,8,"2029"
26,100,1,2029-05-15,1905,9,4,9,"CUN","Cancun Toros","home",1,0,"Eastern Division","PBE",1,0,1,"1 - 0",2,2,4,9,16,4,1,0.8,1,0,"1 - 0","#0090D4",4,5,"2029"
26,100,6,2029-05-16,1905,9,2,4,"CUN","Cancun Toros","home",0,1,"Eastern Division","PBE",1,1,0,"1 - 1",9,11,6,13,36,121,2,0.229299363057325,0,2,"0 - 2","#0090D4",4,5,"2029"
26,100,11,2029-05-17,1905,9,5,9,"CUN","Cancun Toros","home",1,0,"Eastern Division","PBE",2,1,1,"2 - 1",3,14,11,22,121,196,3,0.381703470031546,1,2,"1 - 2","#0090D4",4,5,"2029"
26,100,16,2029-05-18,1905,9,3,11,"CUN","Cancun Toros","home",0,1,"Eastern Division","PBE",2,2,0,"2 - 2",4,18,14,33,196,324,4,0.376923076923077,2,2,"2 - 2","#0090D4",4,5,"2029"
26,100,21,2029-05-21,1905,9,2,6,"CUN","Cancun Toros","home",1,0,"Eastern Division","PBE",3,2,1,"3 - 2",1,19,16,39,256,361,5,0.414910858995138,2,3,"2 - 3","#0090D4",4,5,"2029"
26,100,26,2029-05-22,1905,9,1,8,"CUN","Cancun Toros","home",0,1,"Eastern Division","PBE",3,3,0,"3 - 3",11,30,17,47,289,900,6,0.243061396131203,1,5,"1 - 5","#0090D4",4,5,"2029"
26,100,31,2029-05-23,1905,10,7,14,"CUN","Cancun Toros","home",0,1,"Eastern Division","PBE",3,4,-1,"3 - 4",8,38,24,61,576,1444,7,0.285148514851485,2,5,"2 - 5","#0090D4",4,5,"2029"
26,100,42,2029-05-26,1905,13,0,7,"CUN","Cancun Toros","away",0,1,"Eastern Division","PBE",3,5,-2,"3 - 5",1,39,24,68,576,1521,8,0.274678111587983,2,6,"2 - 6","#0090D4",4,5,"2029"
26,100,46,2029-05-27,1905,9,7,11,"CUN","Cancun Toros","away",1,0,"Eastern Division","PBE",4,5,-1,"4 - 5",2,41,31,79,961,1681,9,0.363739591218774,3,6,"3 - 6","#0090D4",4,5,"2029"
26,100,51,2029-05-28,1905,10,0,3,"CUN","Cancun Toros","away",0,1,"Eastern Division","PBE",4,6,-2,"4 - 6",1,42,31,82,961,1764,10,0.352660550458716,4,6,"4 - 6","#0090D4",4,5,"2029"
26,100,56,2029-05-29,1905,9,3,10,"CUN","Cancun Toros","away",0,1,"Eastern Division","PBE",4,7,-3,"4 - 7",10,52,34,92,1156,2704,11,0.299481865284974,3,8,"3 - 8","#0090D4",4,5,"2029"
26,100,60,2029-06-01,1905,9,7,9,"CUN","Cancun Toros","home",1,0,"Eastern Division","PBE",5,7,-2,"5 - 7",4,56,41,101,1681,3136,12,0.348972389454017,4,8,"4 - 8","#0090D4",4,5,"2029"
26,100,65,2029-06-02,1905,9,6,11,"CUN","Cancun Toros","home",1,0,"Eastern Division","PBE",6,7,-1,"6 - 7",0,56,47,112,2209,3136,13,0.413283442469598,5,8,"5 - 8","#0090D4",4,5,"2029"
26,100,70,2029-06-03,1905,9,3,7,"CUN","Cancun Toros","home",1,0,"Eastern Division","PBE",7,7,0,"7 - 7",0,56,50,119,2500,3136,14,0.443577004968062,6,8,"6 - 8","#0090D4",4,5,"2029"
26,100,75,2029-06-04,1905,9,2,4,"CUN","Cancun Toros","home",0,1,"Eastern Division","PBE",7,8,-1,"7 - 8",4,60,52,123,2704,3600,15,0.428934010152284,6,9,"6 - 9","#0090D4",4,5,"2029"
26,100,80,2029-06-06,1905,9,1,3,"CUN","Cancun Toros","away",0,1,"Eastern Division","PBE",7,9,-2,"7 - 9",4,64,53,126,2809,4096,16,0.406806661839247,7,9,"7 - 9","#0090D4",4,5,"2029"
26,100,84,2029-06-07,1905,10,2,9,"CUN","Cancun Toros","away",0,1,"Eastern Division","PBE",7,10,-3,"7 - 10",3,67,55,135,3025,4489,17,0.402581847218525,7,10,"7 - 10","#0090D4",4,5,"2029"
26,100,89,2029-06-08,1905,9,3,10,"CUN","Cancun Toros","away",0,1,"Eastern Division","PBE",7,11,-4,"7 - 11",4,71,58,145,3364,5041,18,0.400237953599048,7,11,"7 - 11","#0090D4",4,5,"2029"
26,100,98,2029-06-11,1905,9,8,10,"CUN","Cancun Toros","away",0,1,"Eastern Division","PBE",7,12,-5,"7 - 12",11,82,66,155,4356,6724,19,0.393140794223827,7,12,"7 - 12","#0090D4",4,5,"2029"
26,100,103,2029-06-12,1905,9,6,9,"CUN","Cancun Toros","away",0,1,"Eastern Division","PBE",7,13,-6,"7 - 13",8,90,72,164,5184,8100,20,0.390243902439024,8,12,"8 - 12","#0090D4",4,5,"2029"
26,100,108,2029-06-13,1905,9,0,4,"CUN","Cancun Toros","away",0,1,"Eastern Division","PBE",7,14,-7,"7 - 14",8,98,72,168,5184,9604,21,0.350554503651609,7,14,"7 - 14","#0090D4",4,5,"2029"
26,100,112,2029-06-14,1905,9,2,3,"CUN","Cancun Toros","away",0,1,"Eastern Division","PBE",7,15,-8,"7 - 15",10,108,74,171,5476,11664,22,0.319486581096849,7,15,"7 - 15","#0090D4",4,5,"2029"
26,100,116,2029-06-16,1905,9,7,13,"CUN","Cancun Toros","away",1,0,"Eastern Division","PBE",8,15,-7,"8 - 15",2,110,81,184,6561,12100,23,0.351588875194255,8,15,"8 - 15","#0090D4",4,5,"2029"
26,100,120,2029-06-17,1905,9,1,5,"CUN","Cancun Toros","away",0,1,"Eastern Division","PBE",8,16,-8,"8 - 16",9,119,82,189,6724,14161,24,0.321953555183146,8,16,"8 - 16","#0090D4",4,5,"2029"
26,100,125,2029-06-18,1905,9,2,6,"CUN","Cancun Toros","away",0,1,"Eastern Division","PBE",8,17,-9,"8 - 17",4,123,84,195,7056,15129,25,0.318052738336714,8,17,"8 - 17","#0090D4",4,5,"2029"
26,100,130,2029-06-19,1905,9,10,14,"CUN","Cancun Toros","away",1,0,"Eastern Division","PBE",9,17,-8,"9 - 17",4,127,94,209,8836,16129,26,0.353935509713599,9,17,"9 - 17","#0090D4",4,5,"2029"
26,100,135,2029-06-22,1905,9,6,10,"CUN","Cancun Toros","away",1,0,"Eastern Division","PBE",10,17,-7,"10 - 17",2,129,100,219,10000,16641,27,0.375361285237041,10,17,"10 - 17","#0090D4",4,5,"2029"
26,100,140,2029-06-23,1905,9,8,12,"CUN","Cancun Toros","away",1,0,"Eastern Division","PBE",11,17,-6,"11 - 17",5,134,108,231,11664,17956,28,0.393787981093855,11,17,"11 - 17","#0090D4",4,5,"2029"
26,100,145,2029-06-24,1905,9,5,10,"CUN","Cancun Toros","away",1,0,"Eastern Division","PBE",12,17,-5,"12 - 17",0,134,113,241,12769,17956,29,0.415589910496338,12,17,"12 - 17","#0090D4",4,5,"2029"
26,100,150,2029-06-25,1905,9,8,12,"CUN","Cancun Toros","away",1,0,"Eastern Division","PBE",13,17,-4,"13 - 17",5,139,121,253,14641,19321,30,0.431099464106943,13,17,"13 - 17","#0090D4",4,5,"2029"
26,100,155,2029-06-27,1905,9,11,13,"CUN","Cancun Toros","home",1,0,"Eastern Division","PBE",14,17,-3,"14 - 17",7,146,132,266,17424,21316,31,0.449767681982447,14,17,"14 - 17","#0090D4",4,5,"2029"
26,100,159,2029-06-28,1905,9,9,18,"CUN","Cancun Toros","home",1,0,"Eastern Division","PBE",15,17,-2,"15 - 17",0,146,141,284,19881,21316,32,0.482583683277909,15,17,"15 - 17","#0090D4",4,5,"2029"
26,100,164,2029-06-29,1905,9,5,7,"CUN","Cancun Toros","home",0,1,"Eastern Division","PBE",15,18,-3,"15 - 18",7,153,146,291,21316,23409,33,0.47660145332588,16,17,"16 - 17","#0090D4",4,5,"2029"
26,100,169,2029-06-30,1905,9,2,5,"CUN","Cancun Toros","home",0,1,"Eastern Division","PBE",15,19,-4,"15 - 19",6,159,148,296,21904,25281,34,0.464215322666101,16,18,"16 - 18","#0090D4",4,5,"2029"
26,100,175,2029-07-03,1905,9,6,6,"CUN","Cancun Toros","home",1,0,"Eastern Division","PBE",16,19,-3,"16 - 19",3,162,154,302,23716,26244,35,0.474699759807846,17,18,"17 - 18","#0090D4",4,5,"2029"
26,100,180,2029-07-04,1905,9,4,17,"CUN","Cancun Toros","home",0,1,"Eastern Division","PBE",16,20,-4,"16 - 20",12,174,158,319,24964,30276,36,0.451918899348298,16,20,"16 - 20","#0090D4",4,5,"2029"
26,100,185,2029-07-05,1905,9,8,13,"CUN","Cancun Toros","home",1,0,"Eastern Division","PBE",17,20,-3,"17 - 20",3,177,166,332,27556,31329,37,0.467962978687272,17,20,"17 - 20","#0090D4",4,5,"2029"
26,100,190,2029-07-06,1905,9,12,14,"CUN","Cancun Toros","home",1,0,"Eastern Division","PBE",18,20,-2,"18 - 20",3,180,178,346,31684,32400,38,0.494413582173397,19,19,"19 - 19","#0090D4",4,5,"2029"
26,100,194,2029-07-09,1905,9,0,6,"CUN","Cancun Toros","away",0,1,"Eastern Division","PBE",18,21,-3,"18 - 21",2,182,178,352,31684,33124,39,0.488890260461671,19,20,"19 - 20","#0090D4",4,5,"2029"
26,100,199,2029-07-10,1905,9,8,8,"CUN","Cancun Toros","away",1,0,"Eastern Division","PBE",19,21,-2,"19 - 21",6,188,186,360,34596,35344,40,0.494652559336574,20,20,"20 - 20","#0090D4",4,5,"2029"
26,100,204,2029-07-11,1905,9,7,7,"CUN","Cancun Toros","away",1,0,"Eastern Division","PBE",20,21,-1,"20 - 21",0,188,193,367,37249,35344,41,0.513121099830562,21,20,"21 - 20","#0090D4",4,5,"2029"
26,100,209,2029-07-12,1905,9,0,3,"CUN","Cancun Toros","away",0,1,"Eastern Division","PBE",20,22,-2,"20 - 22",5,193,193,370,37249,37249,42,0.5,21,21,"21 - 21","#0090D4",4,5,"2029"
26,100,214,2029-07-15,1905,9,6,8,"CUN","Cancun Toros","home",1,0,"Eastern Division","PBE",21,22,-1,"21 - 22",3,196,199,378,39601,38416,43,0.507594498634913,22,21,"22 - 21","#0090D4",4,5,"2029"
26,100,219,2029-07-16,1905,9,13,15,"CUN","Cancun Toros","home",1,0,"Eastern Division","PBE",22,22,0,"22 - 22",3,199,212,393,44944,39601,44,0.531598556981489,23,21,"23 - 21","#0090D4",4,5,"2029"
26,100,224,2029-07-17,1905,9,10,18,"CUN","Cancun Toros","home",1,0,"Eastern Division","PBE",23,22,1,"23 - 22",0,199,222,411,49284,39601,45,0.554469258030039,25,20,"25 - 20","#0090D4",4,5,"2029"
26,100,229,2029-07-18,1905,9,6,10,"CUN","Cancun Toros","home",1,0,"Eastern Division","PBE",24,22,2,"24 - 22",1,200,228,421,51984,40000,46,0.565141763785006,26,20,"26 - 20","#0090D4",4,5,"2029"
26,100,236,2029-07-21,1905,10,6,7,"CUN","Cancun Toros","home",0,1,"Eastern Division","PBE",24,23,1,"24 - 23",7,207,234,428,54756,42849,47,0.560995850622407,26,21,"26 - 21","#0090D4",4,5,"2029"
26,100,241,2029-07-22,1905,10,6,10,"CUN","Cancun Toros","home",1,0,"Eastern Division","PBE",25,23,2,"25 - 23",5,212,240,438,57600,44944,48,0.561710095178655,27,21,"27 - 21","#0090D4",4,5,"2029"
26,100,246,2029-07-23,1905,12,7,13,"CUN","Cancun Toros","home",1,0,"Eastern Division","PBE",26,23,3,"26 - 23",4,216,247,451,61009,46656,49,0.566655830585613,28,21,"28 - 21","#0090D4",4,5,"2029"
26,100,251,2029-07-24,1905,9,1,5,"CUN","Cancun Toros","home",0,1,"Eastern Division","PBE",26,24,2,"26 - 24",3,219,248,456,61504,47961,50,0.561859955236834,28,22,"28 - 22","#0090D4",4,5,"2029"
26,100,256,2029-08-12,1905,9,8,9,"CUN","Cancun Toros","away",1,0,"Eastern Division","PBE",27,24,3,"27 - 24",3,222,256,465,65536,49284,51,0.570771642570981,29,22,"29 - 22","#0090D4",4,5,"2029"
26,100,261,2029-08-13,1905,9,1,6,"CUN","Cancun Toros","away",0,1,"Eastern Division","PBE",27,25,2,"27 - 25",5,227,257,471,66049,51529,52,0.561746245045842,29,23,"29 - 23","#0090D4",4,5,"2029"
26,100,266,2029-08-14,1905,9,4,9,"CUN","Cancun Toros","away",1,0,"Eastern Division","PBE",28,25,3,"28 - 25",2,229,261,480,68121,52441,53,0.565028781871568,30,23,"30 - 23","#0090D4",4,5,"2029"
26,100,271,2029-08-15,1905,9,13,13,"CUN","Cancun Toros","away",1,0,"Eastern Division","PBE",29,25,4,"29 - 25",2,231,274,493,75076,53361,54,0.584535608897748,32,22,"32 - 22","#0090D4",4,5,"2029"
26,100,273,2029-08-17,1905,9,8,10,"CUN","Cancun Toros","away",1,0,"Eastern Division","PBE",30,25,5,"30 - 25",6,237,282,503,79524,56169,55,0.586058234396763,32,23,"32 - 23","#0090D4",4,5,"2029"
26,100,277,2029-08-18,1905,9,5,5,"CUN","Cancun Toros","away",0,1,"Eastern Division","PBE",30,26,4,"30 - 26",7,244,287,508,82369,59536,56,0.580451710651492,33,23,"33 - 23","#0090D4",4,5,"2029"
26,100,282,2029-08-19,1905,9,0,4,"CUN","Cancun Toros","away",0,1,"Eastern Division","PBE",30,27,3,"30 - 27",11,255,287,512,82369,65025,57,0.55883550212356,32,25,"32 - 25","#0090D4",4,5,"2029"
26,100,287,2029-08-20,1905,9,1,4,"CUN","Cancun Toros","away",0,1,"Eastern Division","PBE",30,28,2,"30 - 28",2,257,288,516,82944,66049,58,0.556697294503769,32,26,"32 - 26","#0090D4",4,5,"2029"
26,100,295,2029-08-23,1905,9,10,10,"CUN","Cancun Toros","home",1,0,"Eastern Division","PBE",31,28,3,"31 - 28",5,262,298,526,88804,68644,59,0.564021137137341,33,26,"33 - 26","#0090D4",4,5,"2029"
26,100,300,2029-08-24,1905,9,2,8,"CUN","Cancun Toros","home",0,1,"Eastern Division","PBE",31,29,2,"31 - 29",9,271,300,534,90000,73441,60,0.550657423779835,33,27,"33 - 27","#0090D4",4,5,"2029"
26,100,631,2029-08-25,1905,9,17,17,"CUN","Cancun Toros","home",1,0,"Eastern Division","PBE",32,29,3,"32 - 29",2,273,317,551,100489,74529,61,0.574163800294827,35,26,"35 - 26","#0090D4",4,5,"2029"
26,100,634,2029-08-27,1905,9,11,13,"CUN","Cancun Toros","home",1,0,"Eastern Division","PBE",33,29,4,"33 - 29",4,277,328,564,107584,76729,62,0.583702723085187,36,26,"36 - 26","#0090D4",4,5,"2029"
26,100,639,2029-08-28,1905,9,9,8,"CUN","Cancun Toros","home",1,0,"Eastern Division","PBE",34,29,5,"34 - 29",1,278,337,572,113569,77284,63,0.595060072411751,37,26,"37 - 26","#0090D4",4,5,"2029"
26,100,644,2029-08-29,1905,9,2,6,"CUN","Cancun Toros","home",0,1,"Eastern Division","PBE",34,30,4,"34 - 30",4,282,339,578,114921,79524,64,0.591020597084008,38,26,"38 - 26","#0090D4",4,5,"2029"
26,100,649,2029-08-30,1905,9,7,10,"CUN","Cancun Toros","home",1,0,"Eastern Division","PBE",35,30,5,"35 - 30",4,286,346,588,119716,81796,65,0.594088689507325,39,26,"39 - 26","#0090D4",4,5,"2029"
26,100,654,2029-09-02,1905,9,3,7,"CUN","Cancun Toros","away",0,1,"Eastern Division","PBE",35,31,4,"35 - 31",4,290,349,595,121801,84100,66,0.5915512794984,39,27,"39 - 27","#0090D4",4,5,"2029"
26,100,659,2029-09-03,1905,9,1,6,"CUN","Cancun Toros","away",0,1,"Eastern Division","PBE",35,32,3,"35 - 32",4,294,350,601,122500,86436,67,0.586303939962477,39,28,"39 - 28","#0090D4",4,5,"2029"
26,100,664,2029-09-04,1905,9,3,8,"CUN","Cancun Toros","away",0,1,"Eastern Division","PBE",35,33,2,"35 - 33",4,298,353,609,124609,88804,68,0.583886642332004,40,28,"40 - 28","#0090D4",4,5,"2029"
26,100,669,2029-09-05,1905,9,3,7,"CUN","Cancun Toros","away",0,1,"Eastern Division","PBE",35,34,1,"35 - 34",5,303,356,616,126736,91809,69,0.5799080280949,40,29,"40 - 29","#0090D4",4,5,"2029"
26,100,674,2029-09-08,1905,9,6,7,"CUN","Cancun Toros","home",1,0,"Eastern Division","PBE",36,34,2,"36 - 34",4,307,362,623,131044,94249,70,0.581660326774467,41,29,"41 - 29","#0090D4",4,5,"2029"
26,100,679,2029-09-09,1905,12,3,5,"CUN","Cancun Toros","home",1,0,"Eastern Division","PBE",37,34,3,"37 - 34",2,309,365,628,133225,95481,71,0.582516418458632,41,30,"41 - 30","#0090D4",4,5,"2029"
26,100,684,2029-09-10,1905,9,5,10,"CUN","Cancun Toros","home",1,0,"Eastern Division","PBE",38,34,4,"38 - 34",1,310,370,638,136900,96100,72,0.587553648068669,42,30,"42 - 30","#0090D4",4,5,"2029"
26,100,689,2029-09-11,1905,9,2,3,"CUN","Cancun Toros","home",1,0,"Eastern Division","PBE",39,34,5,"39 - 34",0,310,372,641,138384,96100,73,0.590163934426229,43,30,"43 - 30","#0090D4",4,5,"2029"
26,100,694,2029-09-14,1905,9,5,8,"CUN","Cancun Toros","away",1,0,"Eastern Division","PBE",40,34,6,"40 - 34",2,312,377,649,142129,97344,74,0.593507410021171,44,30,"44 - 30","#0090D4",4,5,"2029"
26,100,699,2029-09-15,1905,9,8,9,"CUN","Cancun Toros","away",1,0,"Eastern Division","PBE",41,34,7,"41 - 34",4,316,385,658,148225,99856,75,0.59748630487623,45,30,"45 - 30","#0090D4",4,5,"2029"
26,100,704,2029-09-16,1905,9,7,13,"CUN","Cancun Toros","away",1,0,"Eastern Division","PBE",42,34,8,"42 - 34",2,318,392,671,153664,101124,76,0.603105326781481,46,30,"46 - 30","#0090D4",4,5,"2029"
26,100,709,2029-09-17,1905,9,15,21,"CUN","Cancun Toros","away",1,0,"Eastern Division","PBE",43,34,9,"43 - 34",4,322,407,692,165649,103684,77,0.615034177022496,47,30,"47 - 30","#0090D4",4,5,"2029"
26,100,718,2029-09-20,1905,9,4,6,"CUN","Cancun Toros","home",1,0,"Eastern Division","PBE",44,34,10,"44 - 34",1,323,411,698,168921,104329,78,0.618192131747484,48,30,"48 - 30","#0090D4",4,5,"2029"
26,100,723,2029-09-21,1905,9,6,15,"CUN","Cancun Toros","home",1,0,"Eastern Division","PBE",45,34,11,"45 - 34",5,328,417,713,173889,107584,79,0.617782167383728,49,30,"49 - 30","#0090D4",4,5,"2029"
26,100,728,2029-09-22,1905,9,3,4,"CUN","Cancun Toros","home",0,1,"Eastern Division","PBE",45,35,10,"45 - 35",7,335,420,717,176400,112225,80,0.611173668254656,49,31,"49 - 31","#0090D4",4,5,"2029"
26,100,733,2029-09-23,1905,9,1,6,"CUN","Cancun Toros","home",0,1,"Eastern Division","PBE",45,36,9,"45 - 36",7,342,421,723,177241,116964,81,0.602440475178872,49,32,"49 - 32","#0090D4",4,5,"2029"
26,100,735,2029-09-25,1905,9,8,9,"CUN","Cancun Toros","away",1,0,"Eastern Division","PBE",46,36,10,"46 - 36",3,345,429,732,184041,119025,82,0.607263764328562,50,32,"50 - 32","#0090D4",4,5,"2029"
26,100,740,2029-09-26,1905,9,5,10,"CUN","Cancun Toros","away",1,0,"Eastern Division","PBE",47,36,11,"47 - 36",4,349,434,742,188356,121801,83,0.607292435766402,50,33,"50 - 33","#0090D4",4,5,"2029"
26,100,745,2029-09-27,1905,9,6,11,"CUN","Cancun Toros","away",1,0,"Eastern Division","PBE",48,36,12,"48 - 36",3,352,440,753,193600,123904,84,0.609756097560976,51,33,"51 - 33","#0090D4",4,5,"2029"
26,100,753,2029-09-30,1905,9,3,4,"CUN","Cancun Toros","away",0,1,"Eastern Division","PBE",48,37,11,"48 - 37",4,356,443,757,196249,126736,85,0.607610260538415,52,33,"52 - 33","#0090D4",4,5,"2029"
26,100,758,2029-10-01,1905,9,0,7,"CUN","Cancun Toros","away",0,1,"Eastern Division","PBE",48,38,10,"48 - 38",9,365,443,764,196249,133225,86,0.595643358808282,51,35,"51 - 35","#0090D4",4,5,"2029"
26,100,763,2029-10-02,1905,9,5,10,"CUN","Cancun Toros","away",0,1,"Eastern Division","PBE",48,39,9,"48 - 39",8,373,448,774,200704,139129,87,0.590595969196635,51,36,"51 - 36","#0090D4",4,5,"2029"
26,100,768,2029-10-03,1905,9,6,12,"CUN","Cancun Toros","away",1,0,"Eastern Division","PBE",49,39,10,"49 - 39",5,378,454,786,206116,142884,88,0.590590257879656,52,36,"52 - 36","#0090D4",4,5,"2029"
26,100,773,2029-10-05,1905,9,3,6,"CUN","Cancun Toros","home",0,1,"Eastern Division","PBE",49,40,9,"49 - 40",8,386,457,792,208849,148996,89,0.583629783844961,52,37,"52 - 37","#0090D4",4,5,"2029"
26,100,777,2029-10-06,1905,9,14,16,"CUN","Cancun Toros","home",1,0,"Eastern Division","PBE",50,40,10,"50 - 40",6,392,471,808,221841,153664,90,0.590780415706848,53,37,"53 - 37","#0090D4",4,5,"2029"
26,100,782,2029-10-07,1905,9,3,7,"CUN","Cancun Toros","home",1,0,"Eastern Division","PBE",51,40,11,"51 - 40",0,392,474,815,224676,153664,91,0.593846804461595,54,37,"54 - 37","#0090D4",4,5,"2029"
26,100,787,2029-10-08,1905,9,5,6,"CUN","Cancun Toros","home",0,1,"Eastern Division","PBE",51,41,10,"51 - 41",7,399,479,821,229441,159201,92,0.590365940891617,54,38,"54 - 38","#0090D4",4,5,"2029"
26,100,793,2029-10-10,1905,9,2,9,"CUN","Cancun Toros","home",0,1,"Eastern Division","PBE",51,42,9,"51 - 42",3,402,481,830,231361,161604,93,0.588757268459023,55,38,"55 - 38","#0090D4",4,5,"2029"
26,100,797,2029-10-11,1905,10,4,9,"CUN","Cancun Toros","home",0,1,"Eastern Division","PBE",51,43,8,"51 - 43",6,408,485,839,235225,166464,94,0.585589846871585,55,39,"55 - 39","#0090D4",4,5,"2029"
26,100,802,2029-10-12,1905,9,3,7,"CUN","Cancun Toros","home",0,1,"Eastern Division","PBE",51,44,7,"51 - 44",5,413,488,846,238144,170569,95,0.582668033559001,55,40,"55 - 40","#0090D4",4,5,"2029"
26,100,807,2029-10-13,1905,9,15,17,"CUN","Cancun Toros","home",1,0,"Eastern Division","PBE",52,44,8,"52 - 44",1,414,503,863,253009,171396,96,0.596149903983224,57,39,"57 - 39","#0090D4",4,5,"2029"
26,100,811,2029-10-15,1905,15,6,15,"CUN","Cancun Toros","away",0,1,"Eastern Division","PBE",52,45,7,"52 - 45",7,421,509,878,259081,177241,97,0.593783948551758,58,39,"58 - 39","#0090D4",4,5,"2029"
26,100,816,2029-10-16,1905,9,1,4,"CUN","Cancun Toros","away",0,1,"Eastern Division","PBE",52,46,6,"52 - 46",7,428,510,882,260100,183184,98,0.586757022585972,58,40,"58 - 40","#0090D4",4,5,"2029"
26,100,821,2029-10-17,1905,9,9,17,"CUN","Cancun Toros","away",1,0,"Eastern Division","PBE",53,46,7,"53 - 46",3,431,519,899,269361,185761,99,0.591843505697373,59,40,"59 - 40","#0090D4",4,5,"2029"
26,100,826,2029-10-18,1905,9,2,6,"CUN","Cancun Toros","away",0,1,"Eastern Division","PBE",53,47,6,"53 - 47",6,437,521,905,271441,190969,100,0.587013689150321,59,41,"59 - 41","#0090D4",4,5,"2029"
27,100,4,2029-05-15,1905,9,2,5,"NSH","Nashville Stars","home",0,1,"Western Division","PBE",0,1,-1,"0 - 1",7,7,2,5,4,49,1,0.0754716981132075,0,1,"0 - 1","#AC0000",5,10,"2029"
27,100,9,2029-05-16,1905,9,1,5,"NSH","Nashville Stars","home",0,1,"Western Division","PBE",0,2,-2,"0 - 2",5,12,3,10,9,144,2,0.0588235294117647,0,2,"0 - 2","#AC0000",5,10,"2029"
27,100,14,2029-05-17,1905,9,7,6,"NSH","Nashville Stars","home",1,0,"Western Division","PBE",1,2,-1,"1 - 2",5,17,10,16,100,289,3,0.25706940874036,1,2,"1 - 2","#AC0000",5,10,"2029"
27,100,19,2029-05-18,1905,9,6,9,"NSH","Nashville Stars","home",1,0,"Western Division","PBE",2,2,0,"2 - 2",1,18,16,25,256,324,4,0.441379310344828,2,2,"2 - 2","#AC0000",5,10,"2029"
27,100,23,2029-05-21,1905,9,4,9,"NSH","Nashville Stars","away",0,1,"Western Division","PBE",2,3,-1,"2 - 3",6,24,20,34,400,576,5,0.409836065573771,2,3,"2 - 3","#AC0000",5,10,"2029"
27,100,28,2029-05-22,1905,9,5,10,"NSH","Nashville Stars","away",1,0,"Western Division","PBE",3,3,0,"3 - 3",3,27,25,44,625,729,6,0.461595273264402,3,3,"3 - 3","#AC0000",5,10,"2029"
27,100,33,2029-05-23,1905,9,6,9,"NSH","Nashville Stars","away",0,1,"Western Division","PBE",3,4,-1,"3 - 4",7,34,31,53,961,1156,7,0.453944260746339,3,4,"3 - 4","#AC0000",5,10,"2029"
27,100,37,2029-05-24,1905,11,3,6,"NSH","Nashville Stars","away",1,0,"Western Division","PBE",4,4,0,"4 - 4",2,36,34,59,1156,1296,8,0.471451876019576,4,4,"4 - 4","#AC0000",5,10,"2029"
27,100,43,2029-05-26,1905,9,1,6,"NSH","Nashville Stars","away",0,1,"Western Division","PBE",4,5,-1,"4 - 5",9,45,35,65,1225,2025,9,0.376923076923077,3,6,"3 - 6","#AC0000",5,10,"2029"
27,100,48,2029-05-27,1905,9,2,4,"NSH","Nashville Stars","away",0,1,"Western Division","PBE",4,6,-2,"4 - 6",6,51,37,69,1369,2601,10,0.344836272040302,3,7,"3 - 7","#AC0000",5,10,"2029"
27,100,53,2029-05-28,1905,9,4,7,"NSH","Nashville Stars","away",1,0,"Western Division","PBE",5,6,-1,"5 - 6",2,53,41,76,1681,2809,11,0.374387527839644,4,7,"4 - 7","#AC0000",5,10,"2029"
27,100,58,2029-05-29,1905,9,2,9,"NSH","Nashville Stars","away",0,1,"Western Division","PBE",5,7,-2,"5 - 7",5,58,43,85,1849,3364,12,0.354690197582966,4,8,"4 - 8","#AC0000",5,10,"2029"
27,100,62,2029-06-01,1905,9,2,7,"NSH","Nashville Stars","home",0,1,"Western Division","PBE",5,8,-3,"5 - 8",9,67,45,92,2025,4489,13,0.310868897758674,4,9,"4 - 9","#AC0000",5,10,"2029"
27,100,67,2029-06-02,1905,10,7,9,"NSH","Nashville Stars","home",1,0,"Western Division","PBE",6,8,-2,"6 - 8",6,73,52,101,2704,5329,14,0.336611477654674,5,9,"5 - 9","#AC0000",5,10,"2029"
27,100,72,2029-06-03,1905,9,4,10,"NSH","Nashville Stars","home",0,1,"Western Division","PBE",6,9,-3,"6 - 9",13,86,56,111,3136,7396,15,0.297759210026586,4,11,"4 - 11","#AC0000",5,10,"2029"
27,100,77,2029-06-04,1905,9,0,2,"NSH","Nashville Stars","home",0,1,"Western Division","PBE",6,10,-4,"6 - 10",4,90,56,113,3136,8100,16,0.279102883588466,4,12,"4 - 12","#AC0000",5,10,"2029"
27,100,82,2029-06-06,1905,13,1,5,"NSH","Nashville Stars","away",0,1,"Western Division","PBE",6,11,-5,"6 - 11",2,92,57,118,3249,8464,17,0.277384103133271,5,12,"5 - 12","#AC0000",5,10,"2029"
27,100,86,2029-06-07,1905,9,5,7,"NSH","Nashville Stars","away",0,1,"Western Division","PBE",6,12,-6,"6 - 12",13,105,62,125,3844,11025,18,0.258524446835698,5,13,"5 - 13","#AC0000",5,10,"2029"
27,100,91,2029-06-08,1905,9,2,12,"NSH","Nashville Stars","away",0,1,"Western Division","PBE",6,13,-7,"6 - 13",3,108,64,137,4096,11664,19,0.25989847715736,5,14,"5 - 14","#AC0000",5,10,"2029"
27,100,95,2029-06-09,1905,9,7,7,"NSH","Nashville Stars","away",1,0,"Western Division","PBE",7,13,-6,"7 - 13",1,109,71,144,5041,11881,20,0.297896229760076,6,14,"6 - 14","#AC0000",5,10,"2029"
27,100,101,2029-06-11,1905,9,2,10,"NSH","Nashville Stars","home",0,1,"Western Division","PBE",7,14,-7,"7 - 14",9,118,73,154,5329,13924,21,0.276788033033813,6,15,"6 - 15","#AC0000",5,10,"2029"
27,100,106,2029-06-12,1905,9,3,5,"NSH","Nashville Stars","home",1,0,"Western Division","PBE",8,14,-6,"8 - 14",2,120,76,159,5776,14400,22,0.286280729579699,6,16,"6 - 16","#AC0000",5,10,"2029"
27,100,111,2029-06-13,1905,9,3,8,"NSH","Nashville Stars","home",0,1,"Western Division","PBE",8,15,-7,"8 - 15",7,127,79,167,6241,16129,23,0.278989718372821,6,17,"6 - 17","#AC0000",5,10,"2029"
27,100,115,2029-06-14,1905,9,4,10,"NSH","Nashville Stars","home",1,0,"Western Division","PBE",9,15,-6,"9 - 15",2,129,83,177,6889,16641,24,0.292775180620484,7,17,"7 - 17","#AC0000",5,10,"2029"
27,100,118,2029-06-16,1905,9,4,7,"NSH","Nashville Stars","away",1,0,"Western Division","PBE",10,15,-5,"10 - 15",3,132,87,184,7569,17424,25,0.302844796543032,8,17,"8 - 17","#AC0000",5,10,"2029"
27,100,123,2029-06-17,1905,9,1,6,"NSH","Nashville Stars","away",0,1,"Western Division","PBE",10,16,-6,"10 - 16",11,143,88,190,7744,20449,26,0.274678111587983,7,19,"7 - 19","#AC0000",5,10,"2029"
27,100,128,2029-06-18,1905,9,0,6,"NSH","Nashville Stars","away",0,1,"Western Division","PBE",10,17,-7,"10 - 17",4,147,88,196,7744,21609,27,0.263823118590945,7,20,"7 - 20","#AC0000",5,10,"2029"
27,100,133,2029-06-19,1905,9,0,1,"NSH","Nashville Stars","away",0,1,"Western Division","PBE",10,18,-8,"10 - 18",6,153,88,197,7744,23409,28,0.248579591050621,7,21,"7 - 21","#AC0000",5,10,"2029"
27,100,137,2029-06-22,1905,9,1,4,"NSH","Nashville Stars","away",0,1,"Western Division","PBE",10,19,-9,"10 - 19",5,158,89,201,7921,24964,29,0.240869697430439,7,22,"7 - 22","#AC0000",5,10,"2029"
27,100,142,2029-06-23,1905,9,0,5,"NSH","Nashville Stars","away",0,1,"Western Division","PBE",10,20,-10,"10 - 20",3,161,89,206,7921,25921,30,0.234058270787778,7,23,"7 - 23","#AC0000",5,10,"2029"
27,100,147,2029-06-24,1905,9,2,8,"NSH","Nashville Stars","away",1,0,"Western Division","PBE",11,20,-9,"11 - 20",0,161,91,214,8281,25921,31,0.242120343839542,8,23,"8 - 23","#AC0000",5,10,"2029"
27,100,152,2029-06-25,1905,9,0,4,"NSH","Nashville Stars","away",0,1,"Western Division","PBE",11,21,-10,"11 - 21",5,166,91,218,8281,27556,32,0.231074029634177,7,25,"7 - 25","#AC0000",5,10,"2029"
27,100,158,2029-06-27,1905,9,5,7,"NSH","Nashville Stars","away",1,0,"Western Division","PBE",12,21,-9,"12 - 21",2,168,96,225,9216,28224,33,0.246153846153846,8,25,"8 - 25","#AC0000",5,10,"2029"
27,100,163,2029-06-28,1905,9,0,5,"NSH","Nashville Stars","away",0,1,"Western Division","PBE",12,22,-10,"12 - 22",1,169,96,230,9216,28561,34,0.243957963840432,8,26,"8 - 26","#AC0000",5,10,"2029"
27,100,168,2029-06-29,1905,9,2,4,"NSH","Nashville Stars","away",0,1,"Western Division","PBE",12,23,-11,"12 - 23",6,175,98,234,9604,30625,35,0.238733252131547,8,27,"8 - 27","#AC0000",5,10,"2029"
27,100,173,2029-06-30,1905,9,3,8,"NSH","Nashville Stars","away",1,0,"Western Division","PBE",13,23,-10,"13 - 23",1,176,101,242,10201,30976,36,0.24773538625932,9,27,"9 - 27","#AC0000",5,10,"2029"
27,100,176,2029-07-03,1905,9,2,5,"NSH","Nashville Stars","home",0,1,"Western Division","PBE",13,24,-11,"13 - 24",6,182,103,247,10609,33124,37,0.242585690439714,9,28,"9 - 28","#AC0000",5,10,"2029"
27,100,181,2029-07-04,1905,9,3,8,"NSH","Nashville Stars","home",0,1,"Western Division","PBE",13,25,-12,"13 - 25",10,192,106,255,11236,36864,38,0.233596673596674,9,29,"9 - 29","#AC0000",5,10,"2029"
27,100,186,2029-07-05,1905,13,5,8,"NSH","Nashville Stars","home",0,1,"Western Division","PBE",13,26,-13,"13 - 26",9,201,111,263,12321,40401,39,0.233697507681803,9,30,"9 - 30","#AC0000",5,10,"2029"
27,100,191,2029-07-06,1905,9,1,5,"NSH","Nashville Stars","home",0,1,"Western Division","PBE",13,27,-14,"13 - 27",7,208,112,268,12544,43264,40,0.224770642201835,9,31,"9 - 31","#AC0000",5,10,"2029"
27,100,197,2029-07-09,1905,15,3,8,"NSH","Nashville Stars","home",0,1,"Western Division","PBE",13,28,-15,"13 - 28",8,216,115,276,13225,46656,41,0.220854695145372,9,32,"9 - 32","#AC0000",5,10,"2029"
27,100,202,2029-07-10,1905,9,7,8,"NSH","Nashville Stars","home",1,0,"Western Division","PBE",14,28,-14,"14 - 28",6,222,122,284,14884,49284,42,0.231953621742925,10,32,"10 - 32","#AC0000",5,10,"2029"
27,100,207,2029-07-11,1905,9,7,7,"NSH","Nashville Stars","home",1,0,"Western Division","PBE",15,28,-13,"15 - 28",5,227,129,291,16641,51529,43,0.244110312454159,10,33,"10 - 33","#AC0000",5,10,"2029"
27,100,212,2029-07-12,1905,9,4,7,"NSH","Nashville Stars","home",1,0,"Western Division","PBE",16,28,-12,"16 - 28",3,230,133,298,17689,52900,44,0.250591451925937,11,33,"11 - 33","#AC0000",5,10,"2029"
27,100,214,2029-07-15,1905,9,3,6,"NSH","Nashville Stars","away",0,1,"Western Division","PBE",16,29,-13,"16 - 29",6,236,136,304,18496,55696,45,0.249299115807634,11,34,"11 - 34","#AC0000",5,10,"2029"
27,100,219,2029-07-16,1905,9,3,9,"NSH","Nashville Stars","away",0,1,"Western Division","PBE",16,30,-14,"16 - 30",13,249,139,313,19321,62001,46,0.237586384988072,11,35,"11 - 35","#AC0000",5,10,"2029"
27,100,224,2029-07-17,1905,9,0,1,"NSH","Nashville Stars","away",0,1,"Western Division","PBE",16,31,-15,"16 - 31",10,259,139,314,19321,67081,47,0.223617508853962,11,36,"11 - 36","#AC0000",5,10,"2029"
27,100,229,2029-07-18,1905,9,1,5,"NSH","Nashville Stars","away",0,1,"Western Division","PBE",16,32,-16,"16 - 32",6,265,140,319,19600,70225,48,0.218202059560256,10,38,"10 - 38","#AC0000",5,10,"2029"
27,100,238,2029-07-21,1905,9,3,5,"NSH","Nashville Stars","home",0,1,"Western Division","PBE",16,33,-17,"16 - 33",4,269,143,324,20449,72361,49,0.220331860790863,11,38,"11 - 38","#AC0000",5,10,"2029"
27,100,243,2029-07-22,1905,12,3,9,"NSH","Nashville Stars","home",1,0,"Western Division","PBE",17,33,-16,"17 - 33",2,271,146,333,21316,73441,50,0.224954356934052,11,39,"11 - 39","#AC0000",5,10,"2029"
27,100,248,2029-07-23,1905,9,5,10,"NSH","Nashville Stars","home",0,1,"Western Division","PBE",17,34,-17,"17 - 34",10,281,151,343,22801,78961,51,0.224062027082801,11,40,"11 - 40","#AC0000",5,10,"2029"
27,100,253,2029-07-24,1905,9,4,12,"NSH","Nashville Stars","home",1,0,"Western Division","PBE",18,34,-16,"18 - 34",2,283,155,355,24025,80089,52,0.230756670572642,12,40,"12 - 40","#AC0000",5,10,"2029"
27,100,255,2029-08-12,1905,10,4,9,"NSH","Nashville Stars","away",1,0,"Western Division","PBE",19,34,-15,"19 - 34",2,285,159,364,25281,81225,53,0.23736690890654,13,40,"13 - 40","#AC0000",5,10,"2029"
27,100,260,2029-08-13,1905,9,3,7,"NSH","Nashville Stars","away",0,1,"Western Division","PBE",19,35,-16,"19 - 35",7,292,162,371,26244,85264,54,0.235355310829716,13,41,"13 - 41","#AC0000",5,10,"2029"
27,100,265,2029-08-14,1905,11,2,11,"NSH","Nashville Stars","away",0,1,"Western Division","PBE",19,36,-17,"19 - 36",3,295,164,382,26896,87025,55,0.236093433168599,13,42,"13 - 42","#AC0000",5,10,"2029"
27,100,270,2029-08-15,1905,9,2,9,"NSH","Nashville Stars","away",0,1,"Western Division","PBE",19,37,-18,"19 - 37",7,302,166,391,27556,91204,56,0.232030986864264,13,43,"13 - 43","#AC0000",5,10,"2029"
27,100,275,2029-08-17,1905,9,2,7,"NSH","Nashville Stars","home",1,0,"Western Division","PBE",20,37,-17,"20 - 37",1,303,168,398,28224,91809,57,0.23513533778211,13,44,"13 - 44","#AC0000",5,10,"2029"
27,100,279,2029-08-18,1905,9,2,6,"NSH","Nashville Stars","home",1,0,"Western Division","PBE",21,37,-16,"21 - 37",1,304,170,404,28900,92416,58,0.238220844736061,14,44,"14 - 44","#AC0000",5,10,"2029"
27,100,284,2029-08-19,1905,9,5,10,"NSH","Nashville Stars","home",0,1,"Western Division","PBE",21,38,-17,"21 - 38",6,310,175,414,30625,96100,59,0.24166502268692,14,45,"14 - 45","#AC0000",5,10,"2029"
27,100,289,2029-08-20,1905,9,3,4,"NSH","Nashville Stars","home",0,1,"Western Division","PBE",21,39,-18,"21 - 39",7,317,178,418,31684,100489,60,0.239716129618001,14,46,"14 - 46","#AC0000",5,10,"2029"
27,100,298,2029-08-23,1905,11,3,9,"NSH","Nashville Stars","home",0,1,"Western Division","PBE",21,40,-19,"21 - 40",4,321,181,427,32761,103041,61,0.241240924286829,15,46,"15 - 46","#AC0000",5,10,"2029"
27,100,629,2029-08-24,1905,9,2,7,"NSH","Nashville Stars","home",0,1,"Western Division","PBE",21,41,-20,"21 - 41",4,325,183,434,33489,105625,62,0.240730623804937,15,47,"15 - 47","#AC0000",5,10,"2029"
27,100,633,2029-08-25,1905,11,6,8,"NSH","Nashville Stars","home",0,1,"Western Division","PBE",21,42,-21,"21 - 42",7,332,189,442,35721,110224,63,0.244756586385282,15,48,"15 - 48","#AC0000",5,10,"2029"
27,100,635,2029-08-27,1905,9,1,5,"NSH","Nashville Stars","home",0,1,"Western Division","PBE",21,43,-22,"21 - 43",11,343,190,447,36100,117649,64,0.234798275110732,15,49,"15 - 49","#AC0000",5,10,"2029"
27,100,640,2029-08-28,1905,10,5,12,"NSH","Nashville Stars","home",1,0,"Western Division","PBE",22,43,-21,"22 - 43",4,347,195,459,38025,120409,65,0.240005301892271,16,49,"16 - 49","#AC0000",5,10,"2029"
27,100,645,2029-08-29,1905,9,2,7,"NSH","Nashville Stars","home",0,1,"Western Division","PBE",22,44,-22,"22 - 44",6,353,197,466,38809,124609,66,0.237483019006474,16,50,"16 - 50","#AC0000",5,10,"2029"
27,100,650,2029-08-30,1905,9,0,4,"NSH","Nashville Stars","home",0,1,"Western Division","PBE",22,45,-23,"22 - 45",7,360,197,470,38809,129600,67,0.230444928715211,15,52,"15 - 52","#AC0000",5,10,"2029"
27,100,657,2029-09-02,1905,9,7,12,"NSH","Nashville Stars","away",0,1,"Western Division","PBE",22,46,-24,"22 - 46",9,369,204,482,41616,136161,68,0.234091024148231,16,52,"16 - 52","#AC0000",5,10,"2029"
27,100,662,2029-09-03,1905,9,1,5,"NSH","Nashville Stars","away",0,1,"Western Division","PBE",22,47,-25,"22 - 47",7,376,205,487,42025,141376,69,0.229142698240468,16,53,"16 - 53","#AC0000",5,10,"2029"
27,100,667,2029-09-04,1905,9,0,3,"NSH","Nashville Stars","away",0,1,"Western Division","PBE",22,48,-26,"22 - 48",2,378,205,490,42025,142884,70,0.227273956378543,16,54,"16 - 54","#AC0000",5,10,"2029"
27,100,672,2029-09-05,1905,9,2,9,"NSH","Nashville Stars","away",1,0,"Western Division","PBE",23,48,-25,"23 - 48",1,379,207,499,42849,143641,71,0.229765671081559,16,55,"16 - 55","#AC0000",5,10,"2029"
27,100,678,2029-09-08,1905,9,2,6,"NSH","Nashville Stars","away",0,1,"Western Division","PBE",23,49,-26,"23 - 49",8,387,209,505,43681,149769,72,0.225799948307056,16,56,"16 - 56","#AC0000",5,10,"2029"
27,100,683,2029-09-09,1905,9,1,4,"NSH","Nashville Stars","away",0,1,"Western Division","PBE",23,50,-27,"23 - 50",2,389,210,509,44100,151321,73,0.225666637669442,16,57,"16 - 57","#AC0000",5,10,"2029"
27,100,688,2029-09-10,1905,9,4,12,"NSH","Nashville Stars","away",0,1,"Western Division","PBE",23,51,-28,"23 - 51",10,399,214,521,45796,159201,74,0.223398391195969,17,57,"17 - 57","#AC0000",5,10,"2029"
27,100,693,2029-09-11,1905,9,1,4,"NSH","Nashville Stars","away",0,1,"Western Division","PBE",23,52,-29,"23 - 52",3,402,215,525,46225,161604,75,0.222418430536643,17,58,"17 - 58","#AC0000",5,10,"2029"
27,100,694,2029-09-14,1905,9,2,3,"NSH","Nashville Stars","home",0,1,"Western Division","PBE",23,53,-30,"23 - 53",5,407,217,528,47089,165649,76,0.221347385046395,17,59,"17 - 59","#AC0000",5,10,"2029"
27,100,699,2029-09-15,1905,9,4,8,"NSH","Nashville Stars","home",0,1,"Western Division","PBE",23,54,-31,"23 - 54",8,415,221,536,48841,172225,77,0.220934019704523,17,60,"17 - 60","#AC0000",5,10,"2029"
27,100,704,2029-09-16,1905,9,2,6,"NSH","Nashville Stars","home",0,1,"Western Division","PBE",23,55,-32,"23 - 55",7,422,223,542,49729,178084,78,0.218288684140062,17,61,"17 - 61","#AC0000",5,10,"2029"
27,100,709,2029-09-17,1905,9,4,11,"NSH","Nashville Stars","home",0,1,"Western Division","PBE",23,56,-33,"23 - 56",15,437,227,553,51529,190969,79,0.212492474164735,17,62,"17 - 62","#AC0000",5,10,"2029"
27,100,717,2029-09-20,1905,9,3,9,"NSH","Nashville Stars","away",0,1,"Western Division","PBE",23,57,-34,"23 - 57",13,450,230,562,52900,202500,80,0.207126076742365,17,63,"17 - 63","#AC0000",5,10,"2029"
27,100,722,2029-09-21,1905,9,1,4,"NSH","Nashville Stars","away",0,1,"Western Division","PBE",23,58,-35,"23 - 58",5,455,231,566,53361,207025,81,0.204930372600677,17,64,"17 - 64","#AC0000",5,10,"2029"
27,100,727,2029-09-22,1905,9,4,9,"NSH","Nashville Stars","away",0,1,"Western Division","PBE",23,59,-36,"23 - 59",5,460,235,575,55225,211600,82,0.206970861051251,17,65,"17 - 65","#AC0000",5,10,"2029"
27,100,732,2029-09-23,1905,11,5,5,"NSH","Nashville Stars","away",1,0,"Western Division","PBE",24,59,-35,"24 - 59",4,464,240,580,57600,215296,83,0.211069418386492,18,65,"18 - 65","#AC0000",5,10,"2029"
27,100,736,2029-09-25,1905,9,1,3,"NSH","Nashville Stars","home",0,1,"Western Division","PBE",24,60,-36,"24 - 60",9,473,241,583,58081,223729,84,0.206099854511905,17,67,"17 - 67","#AC0000",5,10,"2029"
27,100,741,2029-09-26,1905,9,2,9,"NSH","Nashville Stars","home",0,1,"Western Division","PBE",24,61,-37,"24 - 61",9,482,243,592,59049,232324,85,0.202657761700638,17,68,"17 - 68","#AC0000",5,10,"2029"
27,100,746,2029-09-27,1905,9,6,9,"NSH","Nashville Stars","home",0,1,"Western Division","PBE",24,62,-38,"24 - 62",23,505,249,601,62001,255025,86,0.195570710288746,17,69,"17 - 69","#AC0000",5,10,"2029"
27,100,750,2029-09-28,1905,9,3,4,"NSH","Nashville Stars","home",0,1,"Western Division","PBE",24,63,-39,"24 - 63",6,511,252,605,63504,261121,87,0.195622641509434,17,70,"17 - 70","#AC0000",5,10,"2029"
27,100,756,2029-09-30,1905,9,2,4,"NSH","Nashville Stars","home",1,0,"Western Division","PBE",25,63,-38,"25 - 63",1,512,254,609,64516,262144,88,0.197501989836527,17,71,"17 - 71","#AC0000",5,10,"2029"
27,100,761,2029-10-01,1905,9,1,3,"NSH","Nashville Stars","home",0,1,"Western Division","PBE",25,64,-39,"25 - 64",18,530,255,612,65025,280900,89,0.187974271879743,17,72,"17 - 72","#AC0000",5,10,"2029"
27,100,766,2029-10-02,1905,9,2,6,"NSH","Nashville Stars","home",0,1,"Western Division","PBE",25,65,-40,"25 - 65",8,538,257,618,66049,289444,90,0.185795500895939,17,73,"17 - 73","#AC0000",5,10,"2029"
27,100,771,2029-10-03,1905,9,1,5,"NSH","Nashville Stars","home",0,1,"Western Division","PBE",25,66,-41,"25 - 66",5,543,258,623,66564,294849,91,0.184177104863411,17,74,"17 - 74","#AC0000",5,10,"2029"
27,100,779,2029-10-06,1905,9,0,2,"NSH","Nashville Stars","away",0,1,"Western Division","PBE",25,67,-42,"25 - 67",9,552,258,625,66564,304704,92,0.179288276932028,16,76,"16 - 76","#AC0000",5,10,"2029"
27,100,784,2029-10-07,1905,9,4,10,"NSH","Nashville Stars","away",1,0,"Western Division","PBE",26,67,-41,"26 - 67",3,555,262,635,68644,308025,93,0.182239579046855,17,76,"17 - 76","#AC0000",5,10,"2029"
27,100,789,2029-10-08,1905,9,2,4,"NSH","Nashville Stars","away",0,1,"Western Division","PBE",26,68,-42,"26 - 68",4,559,264,639,69696,312481,94,0.182365762460849,17,77,"17 - 77","#AC0000",5,10,"2029"
27,100,799,2029-10-11,1905,9,2,9,"NSH","Nashville Stars","home",0,1,"Western Division","PBE",26,69,-43,"26 - 69",6,565,266,648,70756,319225,95,0.18143448014134,17,78,"17 - 78","#AC0000",5,10,"2029"
27,100,804,2029-10-12,1905,9,4,7,"NSH","Nashville Stars","home",1,0,"Western Division","PBE",27,69,-42,"27 - 69",3,568,270,655,72900,322624,96,0.18431245638697,18,78,"18 - 78","#AC0000",5,10,"2029"
27,100,809,2029-10-13,1905,9,3,6,"NSH","Nashville Stars","home",0,1,"Western Division","PBE",27,70,-43,"27 - 70",4,572,273,661,74529,327184,97,0.185527976440892,18,79,"18 - 79","#AC0000",5,10,"2029"
27,100,813,2029-10-15,1905,9,2,9,"NSH","Nashville Stars","away",0,1,"Western Division","PBE",27,71,-44,"27 - 71",10,582,275,670,75625,338724,98,0.182515222674605,18,80,"18 - 80","#AC0000",5,10,"2029"
27,100,818,2029-10-16,1905,9,3,8,"NSH","Nashville Stars","away",0,1,"Western Division","PBE",27,72,-45,"27 - 72",10,592,278,678,77284,350464,99,0.180676473063579,18,81,"18 - 81","#AC0000",5,10,"2029"
27,100,823,2029-10-17,1905,9,5,8,"NSH","Nashville Stars","away",0,1,"Western Division","PBE",27,73,-46,"27 - 73",8,600,283,686,80089,360000,100,0.18198364421742,18,82,"18 - 82","#AC0000",5,10,"2029"
28,101,304,2029-05-16,1905,9,4,8,"KC","Kansas City Hepcats","home",1,0,"West Division","MiLPBE",1,0,1,"1 - 0",2,2,4,8,16,4,1,0.8,1,0,"1 - 0","#6595E3",2,4,"2029"
28,101,307,2029-05-17,1905,9,5,7,"KC","Kansas City Hepcats","home",1,0,"West Division","MiLPBE",2,0,2,"2 - 0",4,6,9,15,81,36,2,0.692307692307692,1,1,"1 - 1","#6595E3",2,4,"2029"
28,101,310,2029-05-18,1905,9,4,18,"KC","Kansas City Hepcats","home",0,1,"West Division","MiLPBE",2,1,1,"2 - 1",9,15,13,33,169,225,3,0.428934010152284,1,2,"1 - 2","#6595E3",2,4,"2029"
28,101,313,2029-05-19,1905,14,6,13,"KC","Kansas City Hepcats","home",0,1,"West Division","MiLPBE",2,2,0,"2 - 2",7,22,19,46,361,484,4,0.427218934911243,2,2,"2 - 2","#6595E3",2,4,"2029"
28,101,315,2029-05-21,1905,9,7,14,"KC","Kansas City Hepcats","away",1,0,"West Division","MiLPBE",3,2,1,"3 - 2",4,26,26,60,676,676,5,0.5,2,3,"2 - 3","#6595E3",2,4,"2029"
28,101,318,2029-05-22,1905,9,10,15,"KC","Kansas City Hepcats","away",1,0,"West Division","MiLPBE",4,2,2,"4 - 2",7,33,36,75,1296,1089,6,0.543396226415094,3,3,"3 - 3","#6595E3",2,4,"2029"
28,101,321,2029-05-23,1905,9,4,8,"KC","Kansas City Hepcats","away",1,0,"West Division","MiLPBE",5,2,3,"5 - 2",3,36,40,83,1600,1296,7,0.552486187845304,4,3,"4 - 3","#6595E3",2,4,"2029"
28,101,324,2029-05-24,1905,9,7,13,"KC","Kansas City Hepcats","away",1,0,"West Division","MiLPBE",6,2,4,"6 - 2",1,37,47,96,2209,1369,8,0.617384013415316,5,3,"5 - 3","#6595E3",2,4,"2029"
28,101,326,2029-05-27,1905,10,4,10,"KC","Kansas City Hepcats","away",1,0,"West Division","MiLPBE",7,2,5,"7 - 2",3,40,51,106,2601,1600,9,0.619138300404666,6,3,"6 - 3","#6595E3",2,4,"2029"
28,101,329,2029-05-28,1905,9,0,5,"KC","Kansas City Hepcats","away",0,1,"West Division","MiLPBE",7,3,4,"7 - 3",10,50,51,111,2601,2500,10,0.509900019603999,5,5,"5 - 5","#6595E3",2,4,"2029"
28,101,332,2029-05-29,1905,9,4,5,"KC","Kansas City Hepcats","away",0,1,"West Division","MiLPBE",7,4,3,"7 - 4",6,56,55,116,3025,3136,11,0.490991722123032,5,6,"5 - 6","#6595E3",2,4,"2029"
28,101,335,2029-05-30,1905,9,2,7,"KC","Kansas City Hepcats","away",0,1,"West Division","MiLPBE",7,5,2,"7 - 5",7,63,57,123,3249,3969,12,0.450124688279302,5,7,"5 - 7","#6595E3",2,4,"2029"
28,101,339,2029-06-02,1905,9,4,13,"KC","Kansas City Hepcats","home",1,0,"West Division","MiLPBE",8,5,3,"8 - 5",0,63,61,136,3721,3969,13,0.483875162548765,6,7,"6 - 7","#6595E3",2,4,"2029"
28,101,342,2029-06-03,1905,9,2,7,"KC","Kansas City Hepcats","home",0,1,"West Division","MiLPBE",8,6,2,"8 - 6",3,66,63,143,3969,4356,14,0.476756756756757,7,7,"7 - 7","#6595E3",2,4,"2029"
28,101,345,2029-06-04,1905,9,8,10,"KC","Kansas City Hepcats","home",1,0,"West Division","MiLPBE",9,6,3,"9 - 6",3,69,71,153,5041,4761,15,0.514282799428688,8,7,"8 - 7","#6595E3",2,4,"2029"
28,101,348,2029-06-05,1905,9,0,5,"KC","Kansas City Hepcats","home",0,1,"West Division","MiLPBE",9,7,2,"9 - 7",5,74,71,158,5041,5476,16,0.479319197489778,8,8,"8 - 8","#6595E3",2,4,"2029"
28,101,352,2029-06-08,1905,9,4,11,"KC","Kansas City Hepcats","away",0,1,"West Division","MiLPBE",9,8,1,"9 - 8",8,82,75,169,5625,6724,17,0.455502469835614,8,9,"8 - 9","#6595E3",2,4,"2029"
28,101,355,2029-06-09,1905,9,5,9,"KC","Kansas City Hepcats","away",1,0,"West Division","MiLPBE",10,8,2,"10 - 8",2,84,80,178,6400,7056,18,0.475624256837099,9,9,"9 - 9","#6595E3",2,4,"2029"
28,101,358,2029-06-10,1905,9,3,5,"KC","Kansas City Hepcats","away",1,0,"West Division","MiLPBE",11,8,3,"11 - 8",2,86,83,183,6889,7396,19,0.482254112705635,9,10,"9 - 10","#6595E3",2,4,"2029"
28,101,361,2029-06-11,1905,9,4,8,"KC","Kansas City Hepcats","away",0,1,"West Division","MiLPBE",11,9,2,"11 - 9",5,91,87,191,7569,8281,20,0.477539432176656,10,10,"10 - 10","#6595E3",2,4,"2029"
28,101,364,2029-06-14,1905,9,0,6,"KC","Kansas City Hepcats","away",0,1,"West Division","MiLPBE",11,10,1,"11 - 10",8,99,87,197,7569,9801,21,0.435751295336788,9,12,"9 - 12","#6595E3",2,4,"2029"
28,101,367,2029-06-15,1905,10,5,12,"KC","Kansas City Hepcats","away",0,1,"West Division","MiLPBE",11,11,0,"11 - 11",6,105,92,209,8464,11025,22,0.434296269690595,10,12,"10 - 12","#6595E3",2,4,"2029"
28,101,370,2029-06-16,1905,9,5,7,"KC","Kansas City Hepcats","away",1,0,"West Division","MiLPBE",12,11,1,"12 - 11",3,108,97,216,9409,11664,23,0.446495515588668,10,13,"10 - 13","#6595E3",2,4,"2029"
28,101,373,2029-06-17,1905,9,4,11,"KC","Kansas City Hepcats","away",0,1,"West Division","MiLPBE",12,12,0,"12 - 12",7,115,101,227,10201,13225,24,0.435456330572868,10,14,"10 - 14","#6595E3",2,4,"2029"
28,101,375,2029-06-20,1905,9,2,10,"KC","Kansas City Hepcats","home",0,1,"West Division","MiLPBE",12,13,-1,"12 - 13",3,118,103,237,10609,13924,25,0.43243794073289,11,14,"11 - 14","#6595E3",2,4,"2029"
28,101,378,2029-06-21,1905,9,2,6,"KC","Kansas City Hepcats","home",1,0,"West Division","MiLPBE",13,13,0,"13 - 13",0,118,105,243,11025,13924,26,0.441901479017195,11,15,"11 - 15","#6595E3",2,4,"2029"
28,101,381,2029-06-22,1905,9,5,7,"KC","Kansas City Hepcats","home",1,0,"West Division","MiLPBE",14,13,1,"14 - 13",4,122,110,250,12100,14884,27,0.448413874888823,12,15,"12 - 15","#6595E3",2,4,"2029"
28,101,510,2029-06-23,1905,9,4,11,"KC","Kansas City Hepcats","home",1,0,"West Division","MiLPBE",15,13,2,"15 - 13",3,125,114,261,12996,15625,28,0.454072184759442,13,15,"13 - 15","#6595E3",2,4,"2029"
28,101,512,2029-07-15,1405,9,2,5,"KC","Kansas City Hepcats","home",0,1,"West Division","MiLPBE",15,14,1,"15 - 14",10,135,116,266,13456,18225,29,0.424734067737761,12,17,"12 - 17","#6595E3",2,4,"2029"
28,101,515,2029-06-25,1905,9,4,6,"KC","Kansas City Hepcats","home",0,1,"West Division","MiLPBE",15,15,0,"15 - 15",6,141,120,272,14400,19881,30,0.420057757941717,13,17,"13 - 17","#6595E3",2,4,"2029"
28,101,518,2029-06-26,1905,9,3,6,"KC","Kansas City Hepcats","home",0,1,"West Division","MiLPBE",15,16,-1,"15 - 16",8,149,123,278,15129,22201,31,0.405277256897937,13,18,"13 - 18","#6595E3",2,4,"2029"
28,101,521,2029-06-27,1905,9,1,9,"KC","Kansas City Hepcats","home",0,1,"West Division","MiLPBE",15,17,-2,"15 - 17",8,157,124,287,15376,24649,32,0.384159900062461,12,20,"12 - 20","#6595E3",2,4,"2029"
28,101,524,2029-06-28,1905,9,3,13,"KC","Kansas City Hepcats","home",1,0,"West Division","MiLPBE",16,17,-1,"16 - 17",0,157,127,300,16129,24649,33,0.395531904458286,13,20,"13 - 20","#6595E3",2,4,"2029"
28,101,528,2029-07-01,1905,9,5,11,"KC","Kansas City Hepcats","away",0,1,"West Division","MiLPBE",16,18,-2,"16 - 18",11,168,132,311,17424,28224,34,0.381703470031546,13,21,"13 - 21","#6595E3",2,4,"2029"
28,101,531,2029-07-02,1905,9,5,9,"KC","Kansas City Hepcats","away",0,1,"West Division","MiLPBE",16,19,-3,"16 - 19",6,174,137,320,18769,30276,35,0.382689366907942,13,22,"13 - 22","#6595E3",2,4,"2029"
28,101,534,2029-07-03,1905,9,1,6,"KC","Kansas City Hepcats","away",0,1,"West Division","MiLPBE",16,20,-4,"16 - 20",10,184,138,326,19044,33856,36,0.36,13,23,"13 - 23","#6595E3",2,4,"2029"
28,101,537,2029-07-04,1905,9,7,11,"KC","Kansas City Hepcats","away",0,1,"West Division","MiLPBE",16,21,-5,"16 - 21",8,192,145,337,21025,36864,37,0.363195080239769,13,24,"13 - 24","#6595E3",2,4,"2029"
28,101,541,2029-07-07,1905,9,0,5,"KC","Kansas City Hepcats","home",0,1,"West Division","MiLPBE",16,22,-6,"16 - 22",5,197,145,342,21025,38809,38,0.351388842464151,13,25,"13 - 25","#6595E3",2,4,"2029"
28,101,544,2029-07-08,1905,9,5,8,"KC","Kansas City Hepcats","home",1,0,"West Division","MiLPBE",17,22,-5,"17 - 22",4,201,150,350,22500,40401,39,0.357704964944913,14,25,"14 - 25","#6595E3",2,4,"2029"
28,101,547,2029-07-09,1905,9,6,11,"KC","Kansas City Hepcats","home",1,0,"West Division","MiLPBE",18,22,-4,"18 - 22",3,204,156,361,24336,41616,40,0.368995633187773,15,25,"15 - 25","#6595E3",2,4,"2029"
28,101,550,2029-07-10,1905,9,5,18,"KC","Kansas City Hepcats","home",1,0,"West Division","MiLPBE",19,22,-3,"19 - 22",4,208,161,379,25921,43264,41,0.374662137746621,15,26,"15 - 26","#6595E3",2,4,"2029"
28,101,553,2029-07-12,1905,9,3,6,"KC","Kansas City Hepcats","home",0,1,"West Division","MiLPBE",19,23,-4,"19 - 23",4,212,164,385,26896,44944,42,0.374387527839644,16,26,"16 - 26","#6595E3",2,4,"2029"
28,101,556,2029-07-13,1905,9,6,8,"KC","Kansas City Hepcats","home",1,0,"West Division","MiLPBE",20,23,-3,"20 - 23",4,216,170,393,28900,46656,43,0.382497750013235,16,27,"16 - 27","#6595E3",2,4,"2029"
28,101,559,2029-07-14,1905,9,3,8,"KC","Kansas City Hepcats","home",0,1,"West Division","MiLPBE",20,24,-4,"20 - 24",11,227,173,401,29929,51529,44,0.367416337253554,16,28,"16 - 28","#6595E3",2,4,"2029"
28,101,561,2029-07-18,1905,9,9,15,"KC","Kansas City Hepcats","away",1,0,"West Division","MiLPBE",21,24,-3,"21 - 24",1,228,182,416,33124,51984,45,0.389199605207501,18,27,"18 - 27","#6595E3",2,4,"2029"
28,101,564,2029-07-19,1905,9,5,9,"KC","Kansas City Hepcats","away",0,1,"West Division","MiLPBE",21,25,-4,"21 - 25",10,238,187,425,34969,56644,46,0.381703470031546,18,28,"18 - 28","#6595E3",2,4,"2029"
28,101,567,2029-07-20,1905,9,3,7,"KC","Kansas City Hepcats","away",0,1,"West Division","MiLPBE",21,26,-5,"21 - 26",6,244,190,432,36100,59536,47,0.377472918147978,18,29,"18 - 29","#6595E3",2,4,"2029"
28,101,570,2029-07-21,1905,9,4,10,"KC","Kansas City Hepcats","away",0,1,"West Division","MiLPBE",21,27,-6,"21 - 27",8,252,194,442,37636,63504,48,0.372117856436622,18,30,"18 - 30","#6595E3",2,4,"2029"
28,101,574,2029-07-24,1905,9,2,6,"KC","Kansas City Hepcats","home",0,1,"West Division","MiLPBE",21,28,-7,"21 - 28",9,261,196,448,38416,68121,49,0.360588340201057,18,31,"18 - 31","#6595E3",2,4,"2029"
28,101,577,2029-07-25,1905,9,9,18,"KC","Kansas City Hepcats","home",1,0,"West Division","MiLPBE",22,28,-6,"22 - 28",3,264,205,466,42025,69696,50,0.376160256352879,19,31,"19 - 31","#6595E3",2,4,"2029"
28,101,580,2029-07-26,1905,9,2,8,"KC","Kansas City Hepcats","home",0,1,"West Division","MiLPBE",22,29,-7,"22 - 29",7,271,207,474,42849,73441,51,0.368466764124172,19,32,"19 - 32","#6595E3",2,4,"2029"
28,101,583,2029-07-27,1905,9,3,6,"KC","Kansas City Hepcats","home",0,1,"West Division","MiLPBE",22,30,-8,"22 - 30",4,275,210,480,44100,75625,52,0.368344121946127,19,33,"19 - 33","#6595E3",2,4,"2029"
28,101,584,2029-08-13,1905,11,8,14,"KC","Kansas City Hepcats","away",0,1,"West Division","MiLPBE",22,31,-9,"22 - 31",9,284,218,494,47524,80656,53,0.370759868934311,20,33,"20 - 33","#6595E3",2,4,"2029"
28,101,587,2029-08-14,1905,13,0,5,"KC","Kansas City Hepcats","away",0,1,"West Division","MiLPBE",22,32,-10,"22 - 32",1,285,218,499,47524,81225,54,0.369121313563601,20,34,"20 - 34","#6595E3",2,4,"2029"
28,101,590,2029-08-15,1905,9,5,11,"KC","Kansas City Hepcats","away",1,0,"West Division","MiLPBE",23,32,-9,"23 - 32",3,288,223,510,49729,82944,55,0.374823814943508,21,34,"21 - 34","#6595E3",2,4,"2029"
28,101,593,2029-08-16,1905,9,4,9,"KC","Kansas City Hepcats","away",0,1,"West Division","MiLPBE",23,33,-10,"23 - 33",5,293,227,519,51529,85849,56,0.375089170027224,21,35,"21 - 35","#6595E3",2,4,"2029"
28,101,597,2029-08-19,1905,9,2,8,"KC","Kansas City Hepcats","home",0,1,"West Division","MiLPBE",23,34,-11,"23 - 34",8,301,229,527,52441,90601,57,0.366612603291341,21,36,"21 - 36","#6595E3",2,4,"2029"
28,101,600,2029-08-20,1905,9,5,7,"KC","Kansas City Hepcats","home",0,1,"West Division","MiLPBE",23,35,-12,"23 - 35",6,307,234,534,54756,94249,58,0.367477601422771,21,37,"21 - 37","#6595E3",2,4,"2029"
28,101,603,2029-08-21,1905,9,9,15,"KC","Kansas City Hepcats","home",1,0,"West Division","MiLPBE",24,35,-11,"24 - 35",8,315,243,549,59049,99225,59,0.373080859774821,22,37,"22 - 37","#6595E3",2,4,"2029"
28,101,606,2029-08-22,1905,9,11,15,"KC","Kansas City Hepcats","home",1,0,"West Division","MiLPBE",25,35,-10,"25 - 35",3,318,254,564,64516,101124,60,0.389495290992514,23,37,"23 - 37","#6595E3",2,4,"2029"
28,101,610,2029-08-25,1905,9,5,10,"KC","Kansas City Hepcats","away",1,0,"West Division","MiLPBE",26,35,-9,"26 - 35",2,320,259,574,67081,102400,61,0.395802479333967,24,37,"24 - 37","#6595E3",2,4,"2029"
28,101,613,2029-08-26,1905,9,9,13,"KC","Kansas City Hepcats","away",1,0,"West Division","MiLPBE",27,35,-8,"27 - 35",3,323,268,587,71824,104329,62,0.407736456375991,25,37,"25 - 37","#6595E3",2,4,"2029"
28,101,616,2029-08-27,1905,10,8,17,"KC","Kansas City Hepcats","away",1,0,"West Division","MiLPBE",28,35,-7,"28 - 35",7,330,276,604,76176,108900,63,0.411593075277183,26,37,"26 - 37","#6595E3",2,4,"2029"
28,101,619,2029-08-28,1905,9,1,8,"KC","Kansas City Hepcats","away",0,1,"West Division","MiLPBE",28,36,-8,"28 - 36",2,332,277,612,76729,110224,64,0.410418661374784,26,38,"26 - 38","#6595E3",2,4,"2029"
28,101,622,2029-08-31,1905,9,10,15,"KC","Kansas City Hepcats","away",1,0,"West Division","MiLPBE",29,36,-7,"29 - 36",7,339,287,627,82369,114921,65,0.417502154189265,27,38,"27 - 38","#6595E3",2,4,"2029"
28,101,625,2029-09-01,1905,9,5,10,"KC","Kansas City Hepcats","away",1,0,"West Division","MiLPBE",30,36,-6,"30 - 36",3,342,292,637,85264,116964,66,0.421623118460352,28,38,"28 - 38","#6595E3",2,4,"2029"
28,101,829,2029-09-02,1905,9,4,10,"KC","Kansas City Hepcats","away",0,1,"West Division","MiLPBE",30,37,-7,"30 - 37",6,348,296,647,87616,121104,67,0.41977769260253,28,39,"28 - 39","#6595E3",2,4,"2029"
28,101,951,2029-09-03,1905,9,2,8,"KC","Kansas City Hepcats","away",0,1,"West Division","MiLPBE",30,38,-8,"30 - 38",6,354,298,655,88804,125316,68,0.414739398468149,28,40,"28 - 40","#6595E3",2,4,"2029"
28,101,953,2029-09-06,1905,9,6,9,"KC","Kansas City Hepcats","home",1,0,"West Division","MiLPBE",31,38,-7,"31 - 38",2,356,304,664,92416,126736,69,0.421698182083668,29,40,"29 - 40","#6595E3",2,4,"2029"
28,101,956,2029-09-07,1905,9,3,8,"KC","Kansas City Hepcats","home",1,0,"West Division","MiLPBE",32,38,-6,"32 - 38",2,358,307,672,94249,128164,70,0.42375670486887,30,40,"30 - 40","#6595E3",2,4,"2029"
28,101,959,2029-09-08,1905,9,2,8,"KC","Kansas City Hepcats","home",0,1,"West Division","MiLPBE",32,39,-7,"32 - 39",7,365,309,680,95481,133225,71,0.417483581541367,30,41,"30 - 41","#6595E3",2,4,"2029"
28,101,962,2029-09-09,1905,9,14,17,"KC","Kansas City Hepcats","home",1,0,"West Division","MiLPBE",33,39,-6,"33 - 39",7,372,323,697,104329,138384,72,0.429845125724621,31,41,"31 - 41","#6595E3",2,4,"2029"
28,101,964,2029-09-12,1905,9,3,9,"KC","Kansas City Hepcats","home",1,0,"West Division","MiLPBE",34,39,-5,"34 - 39",2,374,326,706,106276,139876,73,0.431749488121161,32,41,"32 - 41","#6595E3",2,4,"2029"
28,101,967,2029-09-13,1905,9,3,8,"KC","Kansas City Hepcats","home",0,1,"West Division","MiLPBE",34,40,-6,"34 - 40",15,389,329,714,108241,151321,74,0.417014046740278,31,43,"31 - 43","#6595E3",2,4,"2029"
28,101,970,2029-09-14,1905,12,7,11,"KC","Kansas City Hepcats","home",0,1,"West Division","MiLPBE",34,41,-7,"34 - 41",8,397,336,725,112896,157609,75,0.417352729154729,31,44,"31 - 44","#6595E3",2,4,"2029"
28,101,973,2029-09-15,1905,9,5,8,"KC","Kansas City Hepcats","home",1,0,"West Division","MiLPBE",35,41,-6,"35 - 41",4,401,341,733,116281,160801,76,0.419662771309576,32,44,"32 - 44","#6595E3",2,4,"2029"
28,101,977,2029-09-18,1905,9,2,9,"KC","Kansas City Hepcats","away",1,0,"West Division","MiLPBE",36,41,-5,"36 - 41",0,401,343,742,117649,160801,77,0.4225139163225,33,44,"33 - 44","#6595E3",2,4,"2029"
28,101,980,2029-09-19,1905,9,5,12,"KC","Kansas City Hepcats","away",1,0,"West Division","MiLPBE",37,41,-4,"37 - 41",3,404,348,754,121104,163216,78,0.425942599887451,33,45,"33 - 45","#6595E3",2,4,"2029"
28,101,983,2029-09-20,1905,9,2,4,"KC","Kansas City Hepcats","home",0,1,"West Division","MiLPBE",37,42,-5,"37 - 42",5,409,350,758,122500,167281,79,0.42273302942567,33,46,"33 - 46","#6595E3",2,4,"2029"
28,101,986,2029-09-21,1905,9,4,7,"KC","Kansas City Hepcats","home",1,0,"West Division","MiLPBE",38,42,-4,"38 - 42",1,410,354,765,125316,168100,80,0.427093273713772,34,46,"34 - 46","#6595E3",2,4,"2029"
28,101,990,2029-09-23,1905,9,9,10,"KC","Kansas City Hepcats","home",1,0,"West Division","MiLPBE",39,42,-3,"39 - 42",1,411,363,775,131769,168921,81,0.438222089194852,35,46,"35 - 46","#6595E3",2,4,"2029"
28,101,993,2029-09-24,1905,14,7,17,"KC","Kansas City Hepcats","home",1,0,"West Division","MiLPBE",40,42,-2,"40 - 42",6,417,370,792,136900,173889,82,0.440491780597125,36,46,"36 - 46","#6595E3",2,4,"2029"
28,101,996,2029-09-25,1905,9,11,18,"KC","Kansas City Hepcats","away",0,1,"West Division","MiLPBE",40,43,-3,"40 - 43",13,430,381,810,145161,184900,83,0.439800521721742,37,46,"37 - 46","#6595E3",2,4,"2029"
28,101,999,2029-09-26,1905,9,6,8,"KC","Kansas City Hepcats","away",1,0,"West Division","MiLPBE",41,43,-2,"41 - 43",0,430,387,818,149769,184900,84,0.447513812154696,38,46,"38 - 46","#6595E3",2,4,"2029"
28,101,1002,2029-09-29,1905,9,0,4,"KC","Kansas City Hepcats","home",0,1,"West Division","MiLPBE",41,44,-3,"41 - 44",7,437,387,822,149769,190969,85,0.43954299197624,37,48,"37 - 48","#6595E3",2,4,"2029"
28,101,1005,2029-09-30,1905,9,10,10,"KC","Kansas City Hepcats","home",1,0,"West Division","MiLPBE",42,44,-2,"42 - 44",3,440,397,832,157609,193600,86,0.448761278896611,39,47,"39 - 47","#6595E3",2,4,"2029"
28,101,1008,2029-10-01,1905,9,5,10,"KC","Kansas City Hepcats","away",1,0,"West Division","MiLPBE",43,44,-1,"43 - 44",3,443,402,842,161604,196249,87,0.451593251977767,39,48,"39 - 48","#6595E3",2,4,"2029"
28,101,1011,2029-10-02,1905,9,8,9,"KC","Kansas City Hepcats","away",1,0,"West Division","MiLPBE",44,44,0,"44 - 44",7,450,410,851,168100,202500,88,0.453588774959525,40,48,"40 - 48","#6595E3",2,4,"2029"
28,101,1013,2029-10-05,1905,9,12,20,"KC","Kansas City Hepcats","away",1,0,"West Division","MiLPBE",45,44,1,"45 - 44",4,454,422,871,178084,206116,89,0.463519000520562,41,48,"41 - 48","#6595E3",2,4,"2029"
28,101,1016,2029-10-06,1905,9,3,9,"KC","Kansas City Hepcats","away",1,0,"West Division","MiLPBE",46,44,2,"46 - 44",2,456,425,880,180625,207936,90,0.464856225920769,42,48,"42 - 48","#6595E3",2,4,"2029"
28,101,1019,2029-10-07,1905,9,7,11,"KC","Kansas City Hepcats","home",1,0,"West Division","MiLPBE",47,44,3,"47 - 44",5,461,432,891,186624,212521,91,0.467559408235103,43,48,"43 - 48","#6595E3",2,4,"2029"
28,101,1022,2029-10-08,1905,9,16,20,"KC","Kansas City Hepcats","home",1,0,"West Division","MiLPBE",48,44,4,"48 - 44",1,462,448,911,200704,213444,92,0.484619025082821,45,47,"45 - 47","#6595E3",2,4,"2029"
28,101,1024,2029-10-11,1905,9,7,11,"KC","Kansas City Hepcats","away",0,1,"West Division","MiLPBE",48,45,3,"48 - 45",14,476,455,922,207025,226576,93,0.477455079670019,44,49,"44 - 49","#6595E3",2,4,"2029"
28,101,1027,2029-10-12,1905,9,5,10,"KC","Kansas City Hepcats","away",1,0,"West Division","MiLPBE",49,45,4,"49 - 45",1,477,460,932,211600,227529,94,0.481862960542346,45,49,"45 - 49","#6595E3",2,4,"2029"
28,101,1030,2029-10-13,1905,10,3,7,"KC","Kansas City Hepcats","home",0,1,"West Division","MiLPBE",49,46,3,"49 - 46",4,481,463,939,214369,231361,95,0.480939133556189,46,49,"46 - 49","#6595E3",2,4,"2029"
28,101,1033,2029-10-14,1905,9,3,7,"KC","Kansas City Hepcats","home",0,1,"West Division","MiLPBE",49,47,2,"49 - 47",4,485,466,946,217156,235225,96,0.48002900210221,46,50,"46 - 50","#6595E3",2,4,"2029"
28,101,1037,2029-10-17,1905,9,0,5,"KC","Kansas City Hepcats","away",0,1,"West Division","MiLPBE",49,48,1,"49 - 48",3,488,466,951,217156,238144,97,0.476951460575445,46,51,"46 - 51","#6595E3",2,4,"2029"
28,101,1040,2029-10-18,1905,9,5,7,"KC","Kansas City Hepcats","away",0,1,"West Division","MiLPBE",49,49,0,"49 - 49",6,494,471,958,221841,244036,98,0.476179334888823,47,51,"47 - 51","#6595E3",2,4,"2029"
28,101,1043,2029-10-19,1905,9,4,8,"KC","Kansas City Hepcats","away",0,1,"West Division","MiLPBE",49,50,-1,"49 - 50",6,500,475,966,225625,250000,99,0.474375821287779,47,52,"47 - 52","#6595E3",2,4,"2029"
28,101,1046,2029-10-20,1905,11,5,13,"KC","Kansas City Hepcats","away",0,1,"West Division","MiLPBE",49,51,-2,"49 - 51",6,506,480,979,230400,256036,100,0.473649154256675,47,53,"47 - 53","#6595E3",2,4,"2029"
29,101,302,2029-05-16,1905,9,1,7,"DAL","Dallas Dynamos","home",0,1,"East Division","MiLPBE",0,1,-1,"0 - 1",5,5,1,7,1,25,1,0.0384615384615385,0,1,"0 - 1","#00FFFF",3,6,"2029"
29,101,305,2029-05-17,1905,9,2,6,"DAL","Dallas Dynamos","home",1,0,"East Division","MiLPBE",1,1,0,"1 - 1",0,5,3,13,9,25,2,0.264705882352941,1,1,"1 - 1","#00FFFF",3,6,"2029"
29,101,308,2029-05-18,1905,9,8,9,"DAL","Dallas Dynamos","home",1,0,"East Division","MiLPBE",2,1,1,"2 - 1",2,7,11,22,121,49,3,0.711764705882353,2,1,"2 - 1","#00FFFF",3,6,"2029"
29,101,311,2029-05-19,1905,9,4,10,"DAL","Dallas Dynamos","home",0,1,"East Division","MiLPBE",2,2,0,"2 - 2",9,16,15,32,225,256,4,0.467775467775468,2,2,"2 - 2","#00FFFF",3,6,"2029"
29,101,315,2029-05-21,1905,9,4,11,"DAL","Dallas Dynamos","home",0,1,"East Division","MiLPBE",2,3,-1,"2 - 3",7,23,19,43,361,529,5,0.40561797752809,2,3,"2 - 3","#00FFFF",3,6,"2029"
29,101,318,2029-05-22,1905,9,7,15,"DAL","Dallas Dynamos","home",0,1,"East Division","MiLPBE",2,4,-2,"2 - 4",10,33,26,58,676,1089,6,0.38300283286119,2,4,"2 - 4","#00FFFF",3,6,"2029"
29,101,321,2029-05-23,1905,9,3,8,"DAL","Dallas Dynamos","home",0,1,"East Division","MiLPBE",2,5,-3,"2 - 5",4,37,29,66,841,1369,7,0.380542986425339,3,4,"3 - 4","#00FFFF",3,6,"2029"
29,101,324,2029-05-24,1905,9,1,8,"DAL","Dallas Dynamos","home",0,1,"East Division","MiLPBE",2,6,-4,"2 - 6",7,44,30,74,900,1936,8,0.317348377997179,3,5,"3 - 5","#00FFFF",3,6,"2029"
29,101,328,2029-05-27,1905,9,1,3,"DAL","Dallas Dynamos","away",0,1,"East Division","MiLPBE",2,7,-5,"2 - 7",4,48,31,77,961,2304,9,0.294333843797856,3,6,"3 - 6","#00FFFF",3,6,"2029"
29,101,331,2029-05-28,1905,9,8,13,"DAL","Dallas Dynamos","away",1,0,"East Division","MiLPBE",3,7,-4,"3 - 7",4,52,39,90,1521,2704,10,0.36,4,6,"4 - 6","#00FFFF",3,6,"2029"
29,101,334,2029-05-29,1905,9,1,4,"DAL","Dallas Dynamos","away",0,1,"East Division","MiLPBE",3,8,-5,"3 - 8",2,54,40,94,1600,2916,11,0.354295837023915,4,7,"4 - 7","#00FFFF",3,6,"2029"
29,101,337,2029-05-30,1905,9,4,5,"DAL","Dallas Dynamos","away",1,0,"East Division","MiLPBE",4,8,-4,"4 - 8",3,57,44,99,1936,3249,12,0.373384763741562,4,8,"4 - 8","#00FFFF",3,6,"2029"
29,101,340,2029-06-02,1905,9,2,9,"DAL","Dallas Dynamos","home",0,1,"East Division","MiLPBE",4,9,-5,"4 - 9",5,62,46,108,2116,3844,13,0.35503355704698,5,8,"5 - 8","#00FFFF",3,6,"2029"
29,101,343,2029-06-03,1905,9,0,7,"DAL","Dallas Dynamos","home",0,1,"East Division","MiLPBE",4,10,-6,"4 - 10",5,67,46,115,2116,4489,14,0.320363361090083,4,10,"4 - 10","#00FFFF",3,6,"2029"
29,101,346,2029-06-04,1905,9,7,12,"DAL","Dallas Dynamos","home",0,1,"East Division","MiLPBE",4,11,-7,"4 - 11",12,79,53,127,2809,6241,15,0.310386740331492,5,10,"5 - 10","#00FFFF",3,6,"2029"
29,101,349,2029-06-05,1905,9,6,6,"DAL","Dallas Dynamos","home",0,1,"East Division","MiLPBE",4,12,-8,"4 - 12",7,86,59,133,3481,7396,16,0.320033097361405,5,11,"5 - 11","#00FFFF",3,6,"2029"
29,101,351,2029-06-08,1905,9,4,10,"DAL","Dallas Dynamos","home",1,0,"East Division","MiLPBE",5,12,-7,"5 - 12",2,88,63,143,3969,7744,17,0.338854264492444,6,11,"6 - 11","#00FFFF",3,6,"2029"
29,101,354,2029-06-09,1905,9,4,11,"DAL","Dallas Dynamos","home",0,1,"East Division","MiLPBE",5,13,-8,"5 - 13",7,95,67,154,4489,9025,18,0.332174041734498,6,12,"6 - 12","#00FFFF",3,6,"2029"
29,101,357,2029-06-10,1905,9,4,13,"DAL","Dallas Dynamos","home",0,1,"East Division","MiLPBE",5,14,-9,"5 - 14",16,111,71,167,5041,12321,19,0.290346734247207,6,13,"6 - 13","#00FFFF",3,6,"2029"
29,101,360,2029-06-11,1905,9,1,7,"DAL","Dallas Dynamos","home",0,1,"East Division","MiLPBE",5,15,-10,"5 - 15",10,121,72,174,5184,14641,20,0.261488020176545,5,15,"5 - 15","#00FFFF",3,6,"2029"
29,101,362,2029-06-14,1905,9,1,2,"DAL","Dallas Dynamos","away",0,1,"East Division","MiLPBE",5,16,-11,"5 - 16",5,126,73,176,5329,15876,21,0.251308653619429,5,16,"5 - 16","#00FFFF",3,6,"2029"
29,101,365,2029-06-15,1905,9,1,7,"DAL","Dallas Dynamos","away",0,1,"East Division","MiLPBE",5,17,-12,"5 - 17",3,129,74,183,5476,16641,22,0.24759234977619,5,17,"5 - 17","#00FFFF",3,6,"2029"
29,101,368,2029-06-16,1905,9,5,12,"DAL","Dallas Dynamos","away",1,0,"East Division","MiLPBE",6,17,-11,"6 - 17",1,130,79,195,6241,16900,23,0.269694481655935,6,17,"6 - 17","#00FFFF",3,6,"2029"
29,101,371,2029-06-17,1905,9,3,8,"DAL","Dallas Dynamos","away",0,1,"East Division","MiLPBE",6,18,-12,"6 - 18",11,141,82,203,6724,19881,24,0.252734448411953,6,18,"6 - 18","#00FFFF",3,6,"2029"
29,101,375,2029-06-20,1905,9,3,8,"DAL","Dallas Dynamos","away",1,0,"East Division","MiLPBE",7,18,-11,"7 - 18",2,143,85,211,7225,20449,25,0.261075377610754,7,18,"7 - 18","#00FFFF",3,6,"2029"
29,101,378,2029-06-21,1905,9,0,5,"DAL","Dallas Dynamos","away",0,1,"East Division","MiLPBE",7,19,-12,"7 - 19",2,145,85,216,7225,21025,26,0.255752212389381,7,19,"7 - 19","#00FFFF",3,6,"2029"
29,101,381,2029-06-22,1905,9,4,12,"DAL","Dallas Dynamos","away",0,1,"East Division","MiLPBE",7,20,-13,"7 - 20",5,150,89,228,7921,22500,27,0.260379343216857,7,20,"7 - 20","#00FFFF",3,6,"2029"
29,101,510,2029-06-23,1905,9,3,10,"DAL","Dallas Dynamos","away",0,1,"East Division","MiLPBE",7,21,-14,"7 - 21",4,154,92,238,8464,23716,28,0.263020509633313,7,21,"7 - 21","#00FFFF",3,6,"2029"
29,101,513,2029-07-15,1905,10,6,13,"DAL","Dallas Dynamos","home",0,1,"East Division","MiLPBE",7,22,-15,"7 - 22",8,162,98,251,9604,26244,29,0.267908948895336,8,21,"8 - 21","#00FFFF",3,6,"2029"
29,101,517,2029-06-25,1905,9,5,11,"DAL","Dallas Dynamos","home",1,0,"East Division","MiLPBE",8,22,-14,"8 - 22",2,164,103,262,10609,26896,30,0.282868950806559,8,22,"8 - 22","#00FFFF",3,6,"2029"
29,101,520,2029-06-26,1905,9,4,13,"DAL","Dallas Dynamos","home",1,0,"East Division","MiLPBE",9,22,-13,"9 - 22",2,166,107,275,11449,27556,31,0.293526470965261,9,22,"9 - 22","#00FFFF",3,6,"2029"
29,101,523,2029-06-27,1905,9,5,10,"DAL","Dallas Dynamos","home",0,1,"East Division","MiLPBE",9,23,-14,"9 - 23",8,174,112,285,12544,30276,32,0.292947220924802,9,23,"9 - 23","#00FFFF",3,6,"2029"
29,101,526,2029-06-28,1905,9,3,11,"DAL","Dallas Dynamos","home",0,1,"East Division","MiLPBE",9,24,-15,"9 - 24",7,181,115,296,13225,32761,33,0.287587526638542,9,24,"9 - 24","#00FFFF",3,6,"2029"
29,101,529,2029-07-01,1905,9,5,8,"DAL","Dallas Dynamos","away",0,1,"East Division","MiLPBE",9,25,-16,"9 - 25",6,187,120,304,14400,34969,34,0.29168101440175,10,24,"10 - 24","#00FFFF",3,6,"2029"
29,101,532,2029-07-02,1905,9,0,3,"DAL","Dallas Dynamos","away",0,1,"East Division","MiLPBE",9,26,-17,"9 - 26",12,199,120,307,14400,39601,35,0.266661728486509,9,26,"9 - 26","#00FFFF",3,6,"2029"
29,101,535,2029-07-03,1905,9,3,9,"DAL","Dallas Dynamos","away",0,1,"East Division","MiLPBE",9,27,-18,"9 - 27",6,205,123,316,15129,42025,36,0.264705882352941,10,26,"10 - 26","#00FFFF",3,6,"2029"
29,101,538,2029-07-04,1905,9,6,11,"DAL","Dallas Dynamos","away",0,1,"East Division","MiLPBE",9,28,-19,"9 - 28",15,220,129,327,16641,48400,37,0.255853999784751,9,28,"9 - 28","#00FFFF",3,6,"2029"
29,101,540,2029-07-07,1905,9,5,13,"DAL","Dallas Dynamos","away",1,0,"East Division","MiLPBE",10,28,-18,"10 - 28",2,222,134,340,17956,49284,38,0.267043426531826,10,28,"10 - 28","#00FFFF",3,6,"2029"
29,101,543,2029-07-08,1905,9,14,17,"DAL","Dallas Dynamos","away",1,0,"East Division","MiLPBE",11,28,-17,"11 - 28",5,227,148,357,21904,51529,39,0.298285511963286,12,27,"12 - 27","#00FFFF",3,6,"2029"
29,101,546,2029-07-09,1905,9,4,6,"DAL","Dallas Dynamos","away",0,1,"East Division","MiLPBE",11,29,-18,"11 - 29",9,236,152,363,23104,55696,40,0.293197969543147,12,28,"12 - 28","#00FFFF",3,6,"2029"
29,101,549,2029-07-10,1905,9,5,11,"DAL","Dallas Dynamos","away",0,1,"East Division","MiLPBE",11,30,-19,"11 - 30",11,247,157,374,24649,61009,41,0.287760629480025,12,29,"12 - 29","#00FFFF",3,6,"2029"
29,101,551,2029-07-12,1905,9,5,7,"DAL","Dallas Dynamos","home",1,0,"East Division","MiLPBE",12,30,-18,"12 - 30",4,251,162,381,26244,63001,42,0.294066894503894,12,30,"12 - 30","#00FFFF",3,6,"2029"
29,101,554,2029-07-13,1905,9,8,10,"DAL","Dallas Dynamos","home",1,0,"East Division","MiLPBE",13,30,-17,"13 - 30",0,251,170,391,28900,63001,43,0.314468830589439,14,29,"14 - 29","#00FFFF",3,6,"2029"
29,101,557,2029-07-14,1905,9,2,6,"DAL","Dallas Dynamos","home",0,1,"East Division","MiLPBE",13,31,-18,"13 - 31",4,255,172,397,29584,65025,44,0.312697523491423,14,30,"14 - 30","#00FFFF",3,6,"2029"
29,101,561,2029-07-18,1905,9,1,8,"DAL","Dallas Dynamos","home",0,1,"East Division","MiLPBE",13,32,-19,"13 - 32",9,264,173,405,29929,69696,45,0.300416562107905,14,31,"14 - 31","#00FFFF",3,6,"2029"
29,101,564,2029-07-19,1905,9,10,12,"DAL","Dallas Dynamos","home",1,0,"East Division","MiLPBE",14,32,-18,"14 - 32",5,269,183,417,33489,72361,46,0.31638167217761,15,31,"15 - 31","#00FFFF",3,6,"2029"
29,101,567,2029-07-20,1905,9,6,14,"DAL","Dallas Dynamos","home",1,0,"East Division","MiLPBE",15,32,-17,"15 - 32",3,272,189,431,35721,73984,47,0.325609589353266,15,32,"15 - 32","#00FFFF",3,6,"2029"
29,101,570,2029-07-21,1905,9,8,11,"DAL","Dallas Dynamos","home",1,0,"East Division","MiLPBE",16,32,-16,"16 - 32",4,276,197,442,38809,76176,48,0.337513588728965,16,32,"16 - 32","#00FFFF",3,6,"2029"
29,101,573,2029-07-24,1905,9,2,5,"DAL","Dallas Dynamos","away",0,1,"East Division","MiLPBE",16,33,-17,"16 - 33",6,282,199,447,39601,79524,49,0.332432318992655,16,33,"16 - 33","#00FFFF",3,6,"2029"
29,101,576,2029-07-25,1905,9,6,10,"DAL","Dallas Dynamos","away",1,0,"East Division","MiLPBE",17,33,-16,"17 - 33",5,287,205,457,42025,82369,50,0.337837837837838,17,33,"17 - 33","#00FFFF",3,6,"2029"
29,101,579,2029-07-26,1905,9,7,8,"DAL","Dallas Dynamos","away",0,1,"East Division","MiLPBE",17,34,-17,"17 - 34",9,296,212,465,44944,87616,51,0.339046469523235,17,34,"17 - 34","#00FFFF",3,6,"2029"
29,101,582,2029-07-27,1905,9,5,12,"DAL","Dallas Dynamos","away",0,1,"East Division","MiLPBE",17,35,-18,"17 - 35",6,302,217,477,47089,91204,52,0.340501688444101,18,34,"18 - 34","#00FFFF",3,6,"2029"
29,101,586,2029-08-13,1905,9,2,6,"DAL","Dallas Dynamos","away",0,1,"East Division","MiLPBE",17,36,-19,"17 - 36",5,307,219,483,47961,94249,53,0.337254764081288,18,35,"18 - 35","#00FFFF",3,6,"2029"
29,101,589,2029-08-14,1905,9,1,5,"DAL","Dallas Dynamos","away",0,1,"East Division","MiLPBE",17,37,-20,"17 - 37",3,310,220,488,48400,96100,54,0.334948096885813,18,36,"18 - 36","#00FFFF",3,6,"2029"
29,101,592,2029-08-15,1905,9,1,5,"DAL","Dallas Dynamos","away",0,1,"East Division","MiLPBE",17,38,-21,"17 - 38",3,313,221,493,48841,97969,55,0.332681697432055,18,37,"18 - 37","#00FFFF",3,6,"2029"
29,101,595,2029-08-16,1905,9,1,7,"DAL","Dallas Dynamos","away",0,1,"East Division","MiLPBE",17,39,-22,"17 - 39",8,321,222,500,49284,103041,56,0.323545051698671,18,38,"18 - 38","#00FFFF",3,6,"2029"
29,101,598,2029-08-19,1905,9,6,9,"DAL","Dallas Dynamos","home",0,1,"East Division","MiLPBE",17,40,-23,"17 - 40",10,331,228,509,51984,109561,57,0.321792689343527,18,39,"18 - 39","#00FFFF",3,6,"2029"
29,101,601,2029-08-20,1905,9,9,13,"DAL","Dallas Dynamos","home",1,0,"East Division","MiLPBE",18,40,-22,"18 - 40",8,339,237,522,56169,114921,58,0.328300894266176,19,39,"19 - 39","#00FFFF",3,6,"2029"
29,101,604,2029-08-21,1905,9,3,8,"DAL","Dallas Dynamos","home",0,1,"East Division","MiLPBE",18,41,-23,"18 - 41",12,351,240,530,57600,123201,59,0.318582308726169,19,40,"19 - 40","#00FFFF",3,6,"2029"
29,101,607,2029-08-22,1905,9,1,8,"DAL","Dallas Dynamos","home",0,1,"East Division","MiLPBE",18,42,-24,"18 - 42",14,365,241,538,58081,133225,60,0.303602605250227,18,42,"18 - 42","#00FFFF",3,6,"2029"
29,101,609,2029-08-25,1905,9,10,12,"DAL","Dallas Dynamos","home",1,0,"East Division","MiLPBE",19,42,-23,"19 - 42",7,372,251,550,63001,138384,61,0.312838592745239,19,42,"19 - 42","#00FFFF",3,6,"2029"
29,101,612,2029-08-26,1905,10,10,15,"DAL","Dallas Dynamos","home",0,1,"East Division","MiLPBE",19,43,-24,"19 - 43",11,383,261,565,68121,146689,62,0.317122107909315,20,42,"20 - 42","#00FFFF",3,6,"2029"
29,101,615,2029-08-27,1905,9,2,10,"DAL","Dallas Dynamos","home",0,1,"East Division","MiLPBE",19,44,-25,"19 - 44",4,387,263,575,69169,149769,63,0.315929623911792,20,43,"20 - 43","#00FFFF",3,6,"2029"
29,101,618,2029-08-28,1905,9,2,9,"DAL","Dallas Dynamos","home",0,1,"East Division","MiLPBE",19,45,-26,"19 - 45",9,396,265,584,70225,156816,64,0.309305367752961,20,44,"20 - 44","#00FFFF",3,6,"2029"
29,101,620,2029-08-31,1905,9,5,9,"DAL","Dallas Dynamos","away",0,1,"East Division","MiLPBE",19,46,-27,"19 - 46",13,409,270,593,72900,167281,65,0.303521094507892,20,45,"20 - 45","#00FFFF",3,6,"2029"
29,101,623,2029-09-01,1905,9,5,6,"DAL","Dallas Dynamos","away",1,0,"East Division","MiLPBE",20,46,-26,"20 - 46",1,410,275,599,75625,168100,66,0.310288234690738,20,46,"20 - 46","#00FFFF",3,6,"2029"
29,101,626,2029-09-02,1905,9,9,14,"DAL","Dallas Dynamos","away",0,1,"East Division","MiLPBE",20,47,-27,"20 - 47",14,424,284,613,80656,179776,67,0.309700804816612,21,46,"21 - 46","#00FFFF",3,6,"2029"
29,101,949,2029-09-03,1905,9,2,7,"DAL","Dallas Dynamos","away",1,0,"East Division","MiLPBE",21,47,-26,"21 - 47",0,424,286,620,81796,179776,68,0.312709311394186,21,47,"21 - 47","#00FFFF",3,6,"2029"
29,101,953,2029-09-06,1905,9,2,6,"DAL","Dallas Dynamos","away",0,1,"East Division","MiLPBE",21,48,-27,"21 - 48",6,430,288,626,82944,184900,69,0.309672794611789,21,48,"21 - 48","#00FFFF",3,6,"2029"
29,101,956,2029-09-07,1905,9,2,6,"DAL","Dallas Dynamos","away",0,1,"East Division","MiLPBE",21,49,-28,"21 - 49",3,433,290,632,84100,187489,70,0.309659080448766,22,48,"22 - 48","#00FFFF",3,6,"2029"
29,101,959,2029-09-08,1905,9,7,13,"DAL","Dallas Dynamos","away",1,0,"East Division","MiLPBE",22,49,-27,"22 - 49",2,435,297,645,88209,189225,71,0.317945889833258,23,48,"23 - 48","#00FFFF",3,6,"2029"
29,101,962,2029-09-09,1905,9,7,16,"DAL","Dallas Dynamos","away",0,1,"East Division","MiLPBE",22,50,-28,"22 - 50",14,449,304,661,92416,201601,72,0.314321960975046,23,49,"23 - 49","#00FFFF",3,6,"2029"
29,101,966,2029-09-12,1905,9,8,11,"DAL","Dallas Dynamos","home",1,0,"East Division","MiLPBE",23,50,-27,"23 - 50",2,451,312,672,97344,203401,73,0.323676204093169,24,49,"24 - 49","#00FFFF",3,6,"2029"
29,101,969,2029-09-13,1905,9,11,17,"DAL","Dallas Dynamos","home",1,0,"East Division","MiLPBE",24,50,-26,"24 - 50",5,456,323,689,104329,207936,74,0.334104046242775,25,49,"25 - 49","#00FFFF",3,6,"2029"
29,101,972,2029-09-14,1905,9,10,12,"DAL","Dallas Dynamos","home",1,0,"East Division","MiLPBE",25,50,-25,"25 - 50",3,459,333,701,110889,210681,75,0.344836272040302,26,49,"26 - 49","#00FFFF",3,6,"2029"
29,101,975,2029-09-15,1905,9,0,7,"DAL","Dallas Dynamos","home",0,1,"East Division","MiLPBE",25,51,-26,"25 - 51",6,465,333,708,110889,216225,76,0.338991911076872,26,50,"26 - 50","#00FFFF",3,6,"2029"
29,101,978,2029-09-18,1905,9,11,15,"DAL","Dallas Dynamos","away",1,0,"East Division","MiLPBE",26,51,-25,"26 - 51",6,471,344,723,118336,221841,77,0.347865963895266,27,50,"27 - 50","#00FFFF",3,6,"2029"
29,101,981,2029-09-19,1905,9,4,10,"DAL","Dallas Dynamos","away",1,0,"East Division","MiLPBE",27,51,-24,"27 - 51",2,473,348,733,121104,223729,78,0.351196086221446,27,51,"27 - 51","#00FFFF",3,6,"2029"
29,101,984,2029-09-20,1905,9,0,6,"DAL","Dallas Dynamos","home",0,1,"East Division","MiLPBE",27,52,-25,"27 - 52",10,483,348,739,121104,233289,79,0.341722325215227,27,52,"27 - 52","#00FFFF",3,6,"2029"
29,101,987,2029-09-21,1905,9,7,10,"DAL","Dallas Dynamos","home",1,0,"East Division","MiLPBE",28,52,-24,"28 - 52",4,487,355,749,126025,237169,80,0.346990864386526,28,52,"28 - 52","#00FFFF",3,6,"2029"
29,101,989,2029-09-23,1905,9,5,8,"DAL","Dallas Dynamos","away",0,1,"East Division","MiLPBE",28,53,-25,"28 - 53",7,494,360,757,129600,244036,81,0.346861651446863,28,53,"28 - 53","#00FFFF",3,6,"2029"
29,101,992,2029-09-24,1905,9,4,3,"DAL","Dallas Dynamos","away",0,1,"East Division","MiLPBE",28,54,-26,"28 - 54",7,501,364,760,132496,251001,82,0.345494228116517,28,54,"28 - 54","#00FFFF",3,6,"2029"
29,101,995,2029-09-25,1905,9,1,6,"DAL","Dallas Dynamos","home",1,0,"East Division","MiLPBE",29,54,-25,"29 - 54",0,501,365,766,133225,251001,83,0.346736035562403,29,54,"29 - 54","#00FFFF",3,6,"2029"
29,101,998,2029-09-26,1905,9,8,11,"DAL","Dallas Dynamos","home",1,0,"East Division","MiLPBE",30,54,-24,"30 - 54",6,507,373,777,139129,257049,84,0.351178005845857,29,55,"29 - 55","#00FFFF",3,6,"2029"
29,101,1000,2029-09-29,1905,9,7,9,"DAL","Dallas Dynamos","home",0,1,"East Division","MiLPBE",30,55,-25,"30 - 55",13,520,380,786,144400,270400,85,0.348119575699132,30,55,"30 - 55","#00FFFF",3,6,"2029"
29,101,1003,2029-09-30,1905,12,12,18,"DAL","Dallas Dynamos","home",0,1,"East Division","MiLPBE",30,56,-26,"30 - 56",13,533,392,804,153664,284089,86,0.351029004941143,30,56,"30 - 56","#00FFFF",3,6,"2029"
29,101,1006,2029-10-01,1905,9,2,9,"DAL","Dallas Dynamos","away",0,1,"East Division","MiLPBE",30,57,-27,"30 - 57",11,544,394,813,155236,295936,87,0.344072770473345,30,57,"30 - 57","#00FFFF",3,6,"2029"
29,101,1009,2029-10-02,1905,9,6,8,"DAL","Dallas Dynamos","away",1,0,"East Division","MiLPBE",31,57,-26,"31 - 57",5,549,400,821,160000,301401,88,0.346769946315678,31,57,"31 - 57","#00FFFF",3,6,"2029"
29,101,1013,2029-10-05,1905,9,4,5,"DAL","Dallas Dynamos","home",0,1,"East Division","MiLPBE",31,58,-27,"31 - 58",12,561,404,826,163216,314721,89,0.341501076501715,30,59,"30 - 59","#00FFFF",3,6,"2029"
29,101,1016,2029-10-06,1905,9,2,9,"DAL","Dallas Dynamos","home",0,1,"East Division","MiLPBE",31,59,-28,"31 - 59",3,564,406,835,164836,318096,90,0.34132341613312,31,59,"31 - 59","#00FFFF",3,6,"2029"
29,101,1019,2029-10-07,1905,9,5,7,"DAL","Dallas Dynamos","away",0,1,"East Division","MiLPBE",31,60,-29,"31 - 60",7,571,411,842,168921,326041,91,0.341280744784448,31,60,"31 - 60","#00FFFF",3,6,"2029"
29,101,1022,2029-10-08,1905,9,1,8,"DAL","Dallas Dynamos","away",0,1,"East Division","MiLPBE",31,61,-30,"31 - 61",16,587,412,850,169744,344569,92,0.33004026730804,30,62,"30 - 62","#00FFFF",3,6,"2029"
29,101,1026,2029-10-11,1905,9,2,6,"DAL","Dallas Dynamos","away",1,0,"East Division","MiLPBE",32,61,-29,"32 - 61",0,587,414,856,171396,344569,93,0.332185322647854,31,62,"31 - 62","#00FFFF",3,6,"2029"
29,101,1029,2029-10-12,1905,9,5,6,"DAL","Dallas Dynamos","away",1,0,"East Division","MiLPBE",33,61,-28,"33 - 61",2,589,419,862,175561,346921,94,0.336013489459924,32,62,"32 - 62","#00FFFF",3,6,"2029"
29,101,1032,2029-10-13,1905,9,2,7,"DAL","Dallas Dynamos","home",0,1,"East Division","MiLPBE",33,62,-29,"33 - 62",3,592,421,869,177241,350464,95,0.335871367525417,32,63,"32 - 63","#00FFFF",3,6,"2029"
29,101,1035,2029-10-14,1905,9,7,10,"DAL","Dallas Dynamos","home",1,0,"East Division","MiLPBE",34,62,-28,"34 - 62",4,596,428,879,183184,355216,96,0.340237741456166,33,63,"33 - 63","#00FFFF",3,6,"2029"
29,101,1038,2029-10-17,1905,9,3,11,"DAL","Dallas Dynamos","away",0,1,"East Division","MiLPBE",34,63,-29,"34 - 63",11,607,431,890,185761,368449,97,0.335181609859079,33,64,"33 - 64","#00FFFF",3,6,"2029"
29,101,1041,2029-10-18,1905,9,3,6,"DAL","Dallas Dynamos","away",0,1,"East Division","MiLPBE",34,64,-30,"34 - 64",10,617,434,896,188356,380689,98,0.331003699180205,32,66,"32 - 66","#00FFFF",3,6,"2029"
29,101,1044,2029-10-19,1905,10,6,15,"DAL","Dallas Dynamos","away",1,0,"East Division","MiLPBE",35,64,-29,"35 - 64",4,621,440,911,193600,385641,99,0.334230484375243,33,66,"33 - 66","#00FFFF",3,6,"2029"
29,101,1047,2029-10-20,1905,9,7,10,"DAL","Dallas Dynamos","away",1,0,"East Division","MiLPBE",36,64,-28,"36 - 64",5,626,447,921,199809,391876,100,0.337694888327404,34,66,"34 - 66","#00FFFF",3,6,"2029"
