"team_id","league_id","game_id","date","time","innings","runs","hits","team_abbr","team_name","home/away","win","loss","division","league_abbr","ttl_wins","ttl_losses","below.500","winloss","RA","ttl_ra","ttl_runs","ttl_hits","ttl_rs_sq","ttl_ra_sq","gp","wp","pythag_win","pythag_loss","pythag_record","Primary Color","Division Standing","League Standing","season"
1,100,2,2029-05-15,1905,9,5,7,"NYV","New York Voyagers","home",1,0,"Eastern Division","PBE",1,0,1,"1 - 0",3,3,5,7,25,9,1,0.735294117647059,1,0,"1 - 0","#0E1540",3,4,"2029"
1,100,7,2029-05-16,1905,11,5,5,"NYV","New York Voyagers","home",1,0,"Eastern Division","PBE",2,0,2,"2 - 0",4,7,10,12,100,49,2,0.671140939597315,1,1,"1 - 1","#0E1540",3,4,"2029"
1,100,12,2029-05-17,1905,9,5,9,"NYV","New York Voyagers","home",1,0,"Eastern Division","PBE",3,0,3,"3 - 0",4,11,15,21,225,121,3,0.65028901734104,2,1,"2 - 1","#0E1540",3,4,"2029"
1,100,17,2029-05-18,1905,9,4,10,"NYV","New York Voyagers","home",0,1,"Eastern Division","PBE",3,1,2,"3 - 1",7,18,19,31,361,324,4,0.527007299270073,2,2,"2 - 2","#0E1540",3,4,"2029"
1,100,21,2029-05-21,1905,9,1,6,"NYV","New York Voyagers","away",0,1,"Eastern Division","PBE",3,2,1,"3 - 2",2,20,20,37,400,400,5,0.5,2,3,"2 - 3","#0E1540",3,4,"2029"
1,100,26,2029-05-22,1905,9,11,12,"NYV","New York Voyagers","away",1,0,"Eastern Division","PBE",4,2,2,"4 - 2",1,21,31,49,961,441,6,0.685449358059914,4,2,"4 - 2","#0E1540",3,4,"2029"
1,100,31,2029-05-23,1905,10,8,9,"NYV","New York Voyagers","away",1,0,"Eastern Division","PBE",5,2,3,"5 - 2",7,28,39,58,1521,784,7,0.659869848156182,5,2,"5 - 2","#0E1540",3,4,"2029"
1,100,40,2029-05-26,1905,9,4,6,"NYV","New York Voyagers","home",0,1,"Eastern Division","PBE",5,3,2,"5 - 3",8,36,43,64,1849,1296,8,0.5879173290938,5,3,"5 - 3","#0E1540",3,4,"2029"
1,100,44,2029-05-27,1905,9,5,9,"NYV","New York Voyagers","home",1,0,"Eastern Division","PBE",6,3,3,"6 - 3",1,37,48,73,2304,1369,9,0.627280152463926,6,3,"6 - 3","#0E1540",3,4,"2029"
1,100,49,2029-05-28,1905,9,3,6,"NYV","New York Voyagers","home",0,1,"Eastern Division","PBE",6,4,2,"6 - 4",6,43,51,79,2601,1849,10,0.584494382022472,6,4,"6 - 4","#0E1540",3,4,"2029"
1,100,54,2029-05-29,1905,9,4,7,"NYV","New York Voyagers","home",1,0,"Eastern Division","PBE",7,4,3,"7 - 4",3,46,55,86,3025,2116,11,0.588406924722817,6,5,"6 - 5","#0E1540",3,4,"2029"
1,100,61,2029-06-01,1905,9,5,9,"NYV","New York Voyagers","away",0,1,"Eastern Division","PBE",7,5,2,"7 - 5",7,53,60,95,3600,2809,12,0.561710095178655,7,5,"7 - 5","#0E1540",3,4,"2029"
1,100,66,2029-06-02,1905,9,8,9,"NYV","New York Voyagers","away",1,0,"Eastern Division","PBE",8,5,3,"8 - 5",3,56,68,104,4624,3136,13,0.595876288659794,8,5,"8 - 5","#0E1540",3,4,"2029"
1,100,71,2029-06-03,1905,9,11,12,"NYV","New York Voyagers","away",1,0,"Eastern Division","PBE",9,5,4,"9 - 5",1,57,79,116,6241,3249,14,0.657639620653319,9,5,"9 - 5","#0E1540",3,4,"2029"
1,100,76,2029-06-04,1905,9,8,10,"NYV","New York Voyagers","away",1,0,"Eastern Division","PBE",10,5,5,"10 - 5",4,61,87,126,7569,3721,15,0.670416297608503,10,5,"10 - 5","#0E1540",3,4,"2029"
1,100,79,2029-06-06,1905,9,3,10,"NYV","New York Voyagers","away",0,1,"Eastern Division","PBE",10,6,4,"10 - 6",8,69,90,136,8100,4761,16,0.629811056682995,10,6,"10 - 6","#0E1540",3,4,"2029"
1,100,83,2029-06-07,1905,9,8,12,"NYV","New York Voyagers","away",1,0,"Eastern Division","PBE",11,6,5,"11 - 6",0,69,98,148,9604,4761,17,0.668569439610164,11,6,"11 - 6","#0E1540",3,4,"2029"
1,100,88,2029-06-08,1905,9,6,12,"NYV","New York Voyagers","away",1,0,"Eastern Division","PBE",12,6,6,"12 - 6",0,69,104,160,10816,4761,18,0.694357064903383,12,6,"12 - 6","#0E1540",3,4,"2029"
1,100,93,2029-06-09,1905,9,9,13,"NYV","New York Voyagers","away",1,0,"Eastern Division","PBE",13,6,7,"13 - 6",6,75,113,173,12769,5625,19,0.694193758834402,13,6,"13 - 6","#0E1540",3,4,"2029"
1,100,99,2029-06-11,1905,11,3,9,"NYV","New York Voyagers","home",1,0,"Eastern Division","PBE",14,6,8,"14 - 6",1,76,116,182,13456,5776,20,0.699667221297837,14,6,"14 - 6","#0E1540",3,4,"2029"
1,100,104,2029-06-12,1905,9,4,6,"NYV","New York Voyagers","home",1,0,"Eastern Division","PBE",15,6,9,"15 - 6",2,78,120,188,14400,6084,21,0.70298769771529,15,6,"15 - 6","#0E1540",3,4,"2029"
1,100,109,2029-06-13,1905,9,5,7,"NYV","New York Voyagers","home",1,0,"Eastern Division","PBE",16,6,10,"16 - 6",3,81,125,195,15625,6561,22,0.704272964932841,15,7,"15 - 7","#0E1540",3,4,"2029"
1,100,113,2029-06-14,1905,9,4,6,"NYV","New York Voyagers","home",0,1,"Eastern Division","PBE",16,7,9,"16 - 7",6,87,129,201,16641,7569,23,0.687360594795539,16,7,"16 - 7","#0E1540",3,4,"2029"
1,100,116,2029-06-16,1905,9,2,5,"NYV","New York Voyagers","home",0,1,"Eastern Division","PBE",16,8,8,"16 - 8",7,94,131,206,17161,8836,24,0.660114628610994,16,8,"16 - 8","#0E1540",3,4,"2029"
1,100,120,2029-06-17,1905,9,9,17,"NYV","New York Voyagers","home",1,0,"Eastern Division","PBE",17,8,9,"17 - 8",1,95,140,223,19600,9025,25,0.68471615720524,17,8,"17 - 8","#0E1540",3,4,"2029"
1,100,125,2029-06-18,1905,9,4,7,"NYV","New York Voyagers","home",1,0,"Eastern Division","PBE",18,8,10,"18 - 8",2,97,144,230,20736,9409,26,0.687875269530602,18,8,"18 - 8","#0E1540",3,4,"2029"
1,100,130,2029-06-19,1905,9,4,6,"NYV","New York Voyagers","home",0,1,"Eastern Division","PBE",18,9,9,"18 - 9",10,107,148,236,21904,11449,27,0.656732527808593,18,9,"18 - 9","#0E1540",3,4,"2029"
1,100,136,2029-06-22,1905,9,3,6,"NYV","New York Voyagers","away",0,1,"Eastern Division","PBE",18,10,8,"18 - 10",9,116,151,242,22801,13456,28,0.628871666161017,18,10,"18 - 10","#0E1540",3,4,"2029"
1,100,141,2029-06-23,1905,9,2,6,"NYV","New York Voyagers","away",0,1,"Eastern Division","PBE",18,11,7,"18 - 11",5,121,153,248,23409,14641,29,0.615216819973719,18,11,"18 - 11","#0E1540",3,4,"2029"
1,100,146,2029-06-24,1905,9,2,6,"NYV","New York Voyagers","away",0,1,"Eastern Division","PBE",18,12,6,"18 - 12",5,126,155,254,24025,15876,30,0.602115235207138,18,12,"18 - 12","#0E1540",3,4,"2029"
1,100,151,2029-06-25,1905,9,4,7,"NYV","New York Voyagers","away",0,1,"Eastern Division","PBE",18,13,5,"18 - 13",7,133,159,261,25281,17689,31,0.588340702815918,18,13,"18 - 13","#0E1540",3,4,"2029"
1,100,160,2029-06-28,1905,9,4,6,"NYV","New York Voyagers","away",0,1,"Eastern Division","PBE",18,14,4,"18 - 14",9,142,163,267,26569,20164,32,0.56852759292149,18,14,"18 - 14","#0E1540",3,4,"2029"
1,100,165,2029-06-29,1905,9,10,11,"NYV","New York Voyagers","away",1,0,"Eastern Division","PBE",19,14,5,"19 - 14",3,145,173,278,29929,21025,33,0.587372924598658,19,14,"19 - 14","#0E1540",3,4,"2029"
1,100,170,2029-06-30,1905,9,6,11,"NYV","New York Voyagers","away",1,0,"Eastern Division","PBE",20,14,6,"20 - 14",1,146,179,289,32041,21316,34,0.60050227711453,20,14,"20 - 14","#0E1540",3,4,"2029"
1,100,176,2029-07-03,1905,9,6,10,"NYV","New York Voyagers","away",1,0,"Eastern Division","PBE",21,14,7,"21 - 14",2,148,185,299,34225,21904,35,0.609756097560976,21,14,"21 - 14","#0E1540",3,4,"2029"
1,100,181,2029-07-04,1905,9,10,13,"NYV","New York Voyagers","away",1,0,"Eastern Division","PBE",22,14,8,"22 - 14",3,151,195,312,38025,22801,36,0.625143852957617,23,13,"23 - 13","#0E1540",3,4,"2029"
1,100,186,2029-07-05,1905,13,9,13,"NYV","New York Voyagers","away",1,0,"Eastern Division","PBE",23,14,9,"23 - 14",5,156,204,325,41616,24336,37,0.631004366812227,23,14,"23 - 14","#0E1540",3,4,"2029"
1,100,191,2029-07-06,1905,9,7,11,"NYV","New York Voyagers","away",1,0,"Eastern Division","PBE",24,14,10,"24 - 14",1,157,211,336,44521,24649,38,0.643646089345092,24,14,"24 - 14","#0E1540",3,4,"2029"
1,100,195,2029-07-09,1905,9,2,8,"NYV","New York Voyagers","home",0,1,"Eastern Division","PBE",24,15,9,"24 - 15",3,160,213,344,45369,25600,39,0.639279121870112,25,14,"25 - 14","#0E1540",3,4,"2029"
1,100,200,2029-07-10,1905,9,5,8,"NYV","New York Voyagers","home",1,0,"Eastern Division","PBE",25,15,10,"25 - 15",3,163,218,352,47524,26569,40,0.641410119714413,26,14,"26 - 14","#0E1540",3,4,"2029"
1,100,205,2029-07-11,1905,9,21,21,"NYV","New York Voyagers","home",1,0,"Eastern Division","PBE",26,15,11,"26 - 15",4,167,239,373,57121,27889,41,0.671932713798377,28,13,"28 - 13","#0E1540",3,4,"2029"
1,100,210,2029-07-12,1905,9,7,14,"NYV","New York Voyagers","home",1,0,"Eastern Division","PBE",27,15,12,"27 - 15",1,168,246,387,60516,28224,42,0.681947261663286,29,13,"29 - 13","#0E1540",3,4,"2029"
1,100,217,2029-07-15,1905,9,1,4,"NYV","New York Voyagers","away",0,1,"Eastern Division","PBE",27,16,11,"27 - 16",8,176,247,391,61009,30976,43,0.663249442843942,29,14,"29 - 14","#0E1540",3,4,"2029"
1,100,222,2029-07-16,1905,9,3,7,"NYV","New York Voyagers","away",0,1,"Eastern Division","PBE",27,17,10,"27 - 17",13,189,250,398,62500,35721,44,0.636320135205302,28,16,"28 - 16","#0E1540",3,4,"2029"
1,100,227,2029-07-17,1905,9,8,15,"NYV","New York Voyagers","away",1,0,"Eastern Division","PBE",28,17,11,"28 - 17",7,196,258,413,66564,38416,45,0.634063631167841,29,16,"29 - 16","#0E1540",3,4,"2029"
1,100,232,2029-07-18,1905,9,1,5,"NYV","New York Voyagers","away",0,1,"Eastern Division","PBE",28,18,10,"28 - 18",7,203,259,418,67081,41209,46,0.619457013574661,28,18,"28 - 18","#0E1540",3,4,"2029"
1,100,235,2029-07-21,1905,9,1,10,"NYV","New York Voyagers","home",0,1,"Eastern Division","PBE",28,19,9,"28 - 19",10,213,260,428,67600,45369,47,0.598394249749931,28,19,"28 - 19","#0E1540",3,4,"2029"
1,100,240,2029-07-22,1905,9,3,4,"NYV","New York Voyagers","home",0,1,"Eastern Division","PBE",28,20,8,"28 - 20",4,217,263,432,69169,47089,48,0.594961206970703,29,19,"29 - 19","#0E1540",3,4,"2029"
1,100,245,2029-07-23,1905,9,2,5,"NYV","New York Voyagers","home",1,0,"Eastern Division","PBE",29,20,9,"29 - 20",0,217,265,437,70225,47089,49,0.598607156861074,29,20,"29 - 20","#0E1540",3,4,"2029"
1,100,250,2029-07-24,1905,9,18,20,"NYV","New York Voyagers","home",1,0,"Eastern Division","PBE",30,20,10,"30 - 20",1,218,283,457,80089,47524,50,0.627592800106572,31,19,"31 - 19","#0E1540",3,4,"2029"
2,100,2,2029-05-15,1905,9,3,7,"OBX","Outer Banks Aviators","away",0,1,"Eastern Division","PBE",0,1,-1,"0 - 1",5,5,3,7,9,25,1,0.264705882352941,0,1,"0 - 1","#FF6700",2,3,"2029"
2,100,7,2029-05-16,1905,11,4,9,"OBX","Outer Banks Aviators","away",0,1,"Eastern Division","PBE",0,2,-2,"0 - 2",5,10,7,16,49,100,2,0.328859060402685,1,1,"1 - 1","#FF6700",2,3,"2029"
2,100,12,2029-05-17,1905,9,4,11,"OBX","Outer Banks Aviators","away",0,1,"Eastern Division","PBE",0,3,-3,"0 - 3",5,15,11,27,121,225,3,0.34971098265896,1,2,"1 - 2","#FF6700",2,3,"2029"
2,100,17,2029-05-18,1905,9,7,10,"OBX","Outer Banks Aviators","away",1,0,"Eastern Division","PBE",1,3,-2,"1 - 3",4,19,18,37,324,361,4,0.472992700729927,2,2,"2 - 2","#FF6700",2,3,"2029"
2,100,23,2029-05-21,1905,9,6,8,"OBX","Outer Banks Aviators","home",1,0,"Eastern Division","PBE",2,3,-1,"2 - 3",4,23,24,45,576,529,5,0.521266968325792,3,2,"3 - 2","#FF6700",2,3,"2029"
2,100,28,2029-05-22,1905,9,3,6,"OBX","Outer Banks Aviators","home",0,1,"Eastern Division","PBE",2,4,-2,"2 - 4",5,28,27,51,729,784,6,0.481824190350297,3,3,"3 - 3","#FF6700",2,3,"2029"
2,100,33,2029-05-23,1905,9,7,12,"OBX","Outer Banks Aviators","home",1,0,"Eastern Division","PBE",3,4,-1,"3 - 4",6,34,34,63,1156,1156,7,0.5,4,3,"4 - 3","#FF6700",2,3,"2029"
2,100,37,2029-05-24,1905,11,2,8,"OBX","Outer Banks Aviators","home",0,1,"Eastern Division","PBE",3,5,-2,"3 - 5",3,37,36,71,1296,1369,8,0.486303939962477,4,4,"4 - 4","#FF6700",2,3,"2029"
2,100,41,2029-05-26,1905,9,5,10,"OBX","Outer Banks Aviators","away",1,0,"Eastern Division","PBE",4,5,-1,"4 - 5",0,37,41,81,1681,1369,9,0.551147540983607,5,4,"5 - 4","#FF6700",2,3,"2029"
2,100,45,2029-05-27,1905,9,10,14,"OBX","Outer Banks Aviators","away",1,0,"Eastern Division","PBE",5,5,0,"5 - 5",5,42,51,95,2601,1764,10,0.595876288659794,6,4,"6 - 4","#FF6700",2,3,"2029"
2,100,50,2029-05-28,1905,9,7,11,"OBX","Outer Banks Aviators","away",1,0,"Eastern Division","PBE",6,5,1,"6 - 5",3,45,58,106,3364,2025,11,0.62423455186491,7,4,"7 - 4","#FF6700",2,3,"2029"
2,100,55,2029-05-29,1905,9,4,9,"OBX","Outer Banks Aviators","away",1,0,"Eastern Division","PBE",7,5,2,"7 - 5",1,46,62,115,3844,2116,12,0.64496644295302,8,4,"8 - 4","#FF6700",2,3,"2029"
2,100,59,2029-06-01,1905,9,2,7,"OBX","Outer Banks Aviators","home",0,1,"Eastern Division","PBE",7,6,1,"7 - 6",3,49,64,122,4096,2401,13,0.630444820686471,8,5,"8 - 5","#FF6700",2,3,"2029"
2,100,64,2029-06-02,1905,9,8,7,"OBX","Outer Banks Aviators","home",1,0,"Eastern Division","PBE",8,6,2,"8 - 6",4,53,72,129,5184,2809,14,0.64856749655949,9,5,"9 - 5","#FF6700",2,3,"2029"
2,100,69,2029-06-03,1905,9,5,10,"OBX","Outer Banks Aviators","home",0,1,"Eastern Division","PBE",8,7,1,"8 - 7",12,65,77,139,5929,4225,15,0.583907819578491,9,6,"9 - 6","#FF6700",2,3,"2029"
2,100,74,2029-06-04,1905,9,4,10,"OBX","Outer Banks Aviators","home",0,1,"Eastern Division","PBE",8,8,0,"8 - 8",13,78,81,149,6561,6084,16,0.518861209964413,8,8,"8 - 8","#FF6700",2,3,"2029"
2,100,80,2029-06-06,1905,9,4,9,"OBX","Outer Banks Aviators","home",1,0,"Eastern Division","PBE",9,8,1,"9 - 8",1,79,85,158,7225,6241,17,0.536536462201099,9,8,"9 - 8","#FF6700",2,3,"2029"
2,100,84,2029-06-07,1905,10,3,6,"OBX","Outer Banks Aviators","home",1,0,"Eastern Division","PBE",10,8,2,"10 - 8",2,81,88,164,7744,6561,18,0.541349178608878,10,8,"10 - 8","#FF6700",2,3,"2029"
2,100,89,2029-06-08,1905,9,4,10,"OBX","Outer Banks Aviators","home",1,0,"Eastern Division","PBE",11,8,3,"11 - 8",3,84,92,174,8464,7056,19,0.545360824742268,10,9,"10 - 9","#FF6700",2,3,"2029"
2,100,97,2029-06-11,1905,12,5,8,"OBX","Outer Banks Aviators","away",0,1,"Eastern Division","PBE",11,9,2,"11 - 9",6,90,97,182,9409,8100,20,0.537380775601119,11,9,"11 - 9","#FF6700",2,3,"2029"
2,100,102,2029-06-12,1905,9,3,7,"OBX","Outer Banks Aviators","away",1,0,"Eastern Division","PBE",12,9,3,"12 - 9",1,91,100,189,10000,8281,21,0.547016027569608,11,10,"11 - 10","#FF6700",2,3,"2029"
2,100,107,2029-06-13,1905,9,4,8,"OBX","Outer Banks Aviators","away",0,1,"Eastern Division","PBE",12,10,2,"12 - 10",6,97,104,197,10816,9409,22,0.534783683559951,12,10,"12 - 10","#FF6700",2,3,"2029"
2,100,117,2029-06-16,1905,9,13,16,"OBX","Outer Banks Aviators","away",1,0,"Eastern Division","PBE",13,10,3,"13 - 10",3,100,117,213,13689,10000,23,0.577863143231035,13,10,"13 - 10","#FF6700",2,3,"2029"
2,100,122,2029-06-17,1905,9,3,6,"OBX","Outer Banks Aviators","away",0,1,"Eastern Division","PBE",13,11,2,"13 - 11",5,105,120,219,14400,11025,24,0.566371681415929,14,10,"14 - 10","#FF6700",2,3,"2029"
2,100,127,2029-06-18,1905,9,5,11,"OBX","Outer Banks Aviators","away",1,0,"Eastern Division","PBE",14,11,3,"14 - 11",0,105,125,230,15625,11025,25,0.586303939962477,15,10,"15 - 10","#FF6700",2,3,"2029"
2,100,132,2029-06-19,1905,13,9,18,"OBX","Outer Banks Aviators","away",1,0,"Eastern Division","PBE",15,11,4,"15 - 11",7,112,134,248,17956,12544,26,0.58872131147541,15,11,"15 - 11","#FF6700",2,3,"2029"
2,100,136,2029-06-22,1905,9,9,12,"OBX","Outer Banks Aviators","home",1,0,"Eastern Division","PBE",16,11,5,"16 - 11",3,115,143,260,20449,13225,27,0.607263764328562,16,11,"16 - 11","#FF6700",2,3,"2029"
2,100,141,2029-06-23,1905,9,5,14,"OBX","Outer Banks Aviators","home",1,0,"Eastern Division","PBE",17,11,6,"17 - 11",2,117,148,274,21904,13689,28,0.615401904868935,17,11,"17 - 11","#FF6700",2,3,"2029"
2,100,146,2029-06-24,1905,9,5,8,"OBX","Outer Banks Aviators","home",1,0,"Eastern Division","PBE",18,11,7,"18 - 11",2,119,153,282,23409,14161,29,0.623076923076923,18,11,"18 - 11","#FF6700",2,3,"2029"
2,100,151,2029-06-25,1905,9,7,10,"OBX","Outer Banks Aviators","home",1,0,"Eastern Division","PBE",19,11,8,"19 - 11",4,123,160,292,25600,15129,30,0.628544771538707,19,11,"19 - 11","#FF6700",2,3,"2029"
2,100,155,2029-06-27,1905,9,7,14,"OBX","Outer Banks Aviators","away",0,1,"Eastern Division","PBE",19,12,7,"19 - 12",11,134,167,306,27889,17956,31,0.60833242447377,19,12,"19 - 12","#FF6700",2,3,"2029"
2,100,159,2029-06-28,1905,9,0,3,"OBX","Outer Banks Aviators","away",0,1,"Eastern Division","PBE",19,13,6,"19 - 13",9,143,167,309,27889,20449,32,0.576958086805412,18,14,"18 - 14","#FF6700",2,3,"2029"
2,100,164,2029-06-29,1905,9,7,11,"OBX","Outer Banks Aviators","away",1,0,"Eastern Division","PBE",20,13,7,"20 - 13",5,148,174,320,30276,21904,33,0.58022230739747,19,14,"19 - 14","#FF6700",2,3,"2029"
2,100,169,2029-06-30,1905,9,6,8,"OBX","Outer Banks Aviators","away",1,0,"Eastern Division","PBE",21,13,8,"21 - 13",2,150,180,328,32400,22500,34,0.590163934426229,20,14,"20 - 14","#FF6700",2,3,"2029"
2,100,174,2029-07-03,1905,9,4,8,"OBX","Outer Banks Aviators","home",0,1,"Eastern Division","PBE",21,14,7,"21 - 14",5,155,184,336,33856,24025,35,0.584924241115392,20,15,"20 - 15","#FF6700",2,3,"2029"
2,100,179,2029-07-04,1905,9,8,14,"OBX","Outer Banks Aviators","home",1,0,"Eastern Division","PBE",22,14,8,"22 - 14",0,155,192,350,36864,24025,36,0.605429552135854,22,14,"22 - 14","#FF6700",2,3,"2029"
2,100,184,2029-07-05,1905,9,26,19,"OBX","Outer Banks Aviators","home",1,0,"Eastern Division","PBE",23,14,9,"23 - 14",0,155,218,369,47524,24025,37,0.664216131602119,25,12,"25 - 12","#FF6700",2,3,"2029"
2,100,189,2029-07-06,1905,9,13,17,"OBX","Outer Banks Aviators","home",1,0,"Eastern Division","PBE",24,14,10,"24 - 14",3,158,231,386,53361,24964,38,0.681276731567188,26,12,"26 - 12","#FF6700",2,3,"2029"
2,100,196,2029-07-09,1905,10,8,9,"OBX","Outer Banks Aviators","home",1,0,"Eastern Division","PBE",25,14,11,"25 - 14",5,163,239,395,57121,26569,39,0.682530768311626,27,12,"27 - 12","#FF6700",2,3,"2029"
2,100,201,2029-07-10,1905,9,6,11,"OBX","Outer Banks Aviators","home",1,0,"Eastern Division","PBE",26,14,12,"26 - 14",1,164,245,406,60025,26896,40,0.690569597680653,28,12,"28 - 12","#FF6700",2,3,"2029"
2,100,206,2029-07-11,1905,9,5,10,"OBX","Outer Banks Aviators","home",1,0,"Eastern Division","PBE",27,14,13,"27 - 14",1,165,250,416,62500,27225,41,0.696572861521315,29,12,"29 - 12","#FF6700",2,3,"2029"
2,100,211,2029-07-12,1905,9,1,4,"OBX","Outer Banks Aviators","home",0,1,"Eastern Division","PBE",27,15,12,"27 - 15",6,171,251,420,63001,29241,42,0.682996899460116,29,13,"29 - 13","#FF6700",2,3,"2029"
2,100,218,2029-07-15,1905,9,5,6,"OBX","Outer Banks Aviators","away",0,1,"Eastern Division","PBE",27,16,11,"27 - 16",15,186,256,426,65536,34596,43,0.654496065193944,28,15,"28 - 15","#FF6700",2,3,"2029"
2,100,223,2029-07-16,1905,9,4,6,"OBX","Outer Banks Aviators","away",1,0,"Eastern Division","PBE",28,16,12,"28 - 16",3,189,260,432,67600,35721,44,0.654271638873027,29,15,"29 - 15","#FF6700",2,3,"2029"
2,100,228,2029-07-17,1905,9,1,8,"OBX","Outer Banks Aviators","away",1,0,"Eastern Division","PBE",29,16,13,"29 - 16",0,189,261,440,68121,35721,45,0.65600624024961,30,15,"30 - 15","#FF6700",2,3,"2029"
2,100,233,2029-07-18,1905,9,1,6,"OBX","Outer Banks Aviators","away",0,1,"Eastern Division","PBE",29,17,12,"29 - 17",3,192,262,446,68644,36864,46,0.650604693482959,30,16,"30 - 16","#FF6700",2,3,"2029"
2,100,237,2029-07-21,1905,9,3,7,"OBX","Outer Banks Aviators","away",1,0,"Eastern Division","PBE",30,17,13,"30 - 17",2,194,265,453,70225,37636,47,0.651069431954089,31,16,"31 - 16","#FF6700",2,3,"2029"
2,100,242,2029-07-22,1905,9,1,5,"OBX","Outer Banks Aviators","away",0,1,"Eastern Division","PBE",30,18,12,"30 - 18",3,197,266,458,70756,38809,48,0.645790170218592,31,17,"31 - 17","#FF6700",2,3,"2029"
2,100,247,2029-07-23,1905,9,5,10,"OBX","Outer Banks Aviators","away",1,0,"Eastern Division","PBE",31,18,13,"31 - 18",2,199,271,468,73441,39601,49,0.649678880416129,32,17,"32 - 17","#FF6700",2,3,"2029"
2,100,252,2029-07-24,1905,9,5,8,"OBX","Outer Banks Aviators","away",0,1,"Eastern Division","PBE",31,19,12,"31 - 19",6,205,276,476,76176,42025,50,0.644461552778741,32,18,"32 - 18","#FF6700",2,3,"2029"
3,100,3,2029-05-15,1905,9,0,2,"PRO","Providence Crabs","home",0,1,"Eastern Division","PBE",0,1,-1,"0 - 1",19,19,0,2,0,361,1,0,0,1,"0 - 1","#005CAD",5,10,"2029"
3,100,8,2029-05-16,1905,9,1,8,"PRO","Providence Crabs","home",0,1,"Eastern Division","PBE",0,2,-2,"0 - 2",9,28,1,10,1,784,2,0.00127388535031847,0,2,"0 - 2","#005CAD",5,10,"2029"
3,100,13,2029-05-17,1905,9,1,7,"PRO","Providence Crabs","home",1,0,"Eastern Division","PBE",1,2,-1,"1 - 2",0,28,2,17,4,784,3,0.0050761421319797,0,3,"0 - 3","#005CAD",5,10,"2029"
3,100,18,2029-05-18,1905,9,2,7,"PRO","Providence Crabs","home",0,1,"Eastern Division","PBE",1,3,-2,"1 - 3",7,35,4,24,16,1225,4,0.0128928283642224,0,4,"0 - 4","#005CAD",5,10,"2029"
3,100,22,2029-05-21,1905,9,7,13,"PRO","Providence Crabs","away",0,1,"Eastern Division","PBE",1,4,-3,"1 - 4",11,46,11,37,121,2116,5,0.05409029950827,0,5,"0 - 5","#005CAD",5,10,"2029"
3,100,27,2029-05-22,1905,9,2,6,"PRO","Providence Crabs","away",0,1,"Eastern Division","PBE",1,5,-4,"1 - 5",4,50,13,43,169,2500,6,0.0633195953540652,0,6,"0 - 6","#005CAD",5,10,"2029"
3,100,32,2029-05-23,1905,9,0,1,"PRO","Providence Crabs","away",0,1,"Eastern Division","PBE",1,6,-5,"1 - 6",6,56,13,44,169,3136,7,0.0511346444780635,0,7,"0 - 7","#005CAD",5,10,"2029"
3,100,36,2029-05-24,1905,9,2,9,"PRO","Providence Crabs","away",0,1,"Eastern Division","PBE",1,7,-6,"1 - 7",5,61,15,53,225,3721,8,0.0570197668525089,0,8,"0 - 8","#005CAD",5,10,"2029"
3,100,41,2029-05-26,1905,9,0,6,"PRO","Providence Crabs","home",0,1,"Eastern Division","PBE",1,8,-7,"1 - 8",5,66,15,59,225,4356,9,0.0491159135559921,0,9,"0 - 9","#005CAD",5,10,"2029"
3,100,45,2029-05-27,1905,9,5,9,"PRO","Providence Crabs","home",0,1,"Eastern Division","PBE",1,9,-8,"1 - 9",10,76,20,68,400,5776,10,0.0647668393782383,1,9,"1 - 9","#005CAD",5,10,"2029"
3,100,50,2029-05-28,1905,9,3,10,"PRO","Providence Crabs","home",0,1,"Eastern Division","PBE",1,10,-9,"1 - 10",7,83,23,78,529,6889,11,0.0713130223779995,1,10,"1 - 10","#005CAD",5,10,"2029"
3,100,55,2029-05-29,1905,9,1,5,"PRO","Providence Crabs","home",0,1,"Eastern Division","PBE",1,11,-10,"1 - 11",4,87,24,83,576,7569,12,0.0707182320441989,1,11,"1 - 11","#005CAD",5,10,"2029"
3,100,60,2029-06-01,1905,9,4,10,"PRO","Providence Crabs","away",0,1,"Eastern Division","PBE",1,12,-11,"1 - 12",7,94,28,93,784,8836,13,0.0814968814968815,1,12,"1 - 12","#005CAD",5,10,"2029"
3,100,65,2029-06-02,1905,9,0,3,"PRO","Providence Crabs","away",0,1,"Eastern Division","PBE",1,13,-12,"1 - 13",6,100,28,96,784,10000,14,0.072700296735905,1,13,"1 - 13","#005CAD",5,10,"2029"
3,100,70,2029-06-03,1905,9,0,0,"PRO","Providence Crabs","away",0,1,"Eastern Division","PBE",1,14,-13,"1 - 14",3,103,28,96,784,10609,15,0.0688141841481612,1,14,"1 - 14","#005CAD",5,10,"2029"
3,100,75,2029-06-04,1905,9,4,9,"PRO","Providence Crabs","away",1,0,"Eastern Division","PBE",2,14,-12,"2 - 14",2,105,32,105,1024,11025,16,0.0849863059175035,1,15,"1 - 15","#005CAD",5,10,"2029"
3,100,79,2029-06-06,1905,9,8,9,"PRO","Providence Crabs","home",1,0,"Eastern Division","PBE",3,14,-11,"3 - 14",3,108,40,114,1600,11664,17,0.120627261761158,2,15,"2 - 15","#005CAD",5,10,"2029"
3,100,83,2029-06-07,1905,9,0,1,"PRO","Providence Crabs","home",0,1,"Eastern Division","PBE",3,15,-12,"3 - 15",8,116,40,115,1600,13456,18,0.106269925611052,2,16,"2 - 16","#005CAD",5,10,"2029"
3,100,88,2029-06-08,1905,9,0,8,"PRO","Providence Crabs","home",0,1,"Eastern Division","PBE",3,16,-13,"3 - 16",6,122,40,123,1600,14884,19,0.0970638194612958,2,17,"2 - 17","#005CAD",5,10,"2029"
3,100,93,2029-06-09,1905,9,6,10,"PRO","Providence Crabs","home",0,1,"Eastern Division","PBE",3,17,-14,"3 - 17",9,131,46,133,2116,17161,20,0.109768117445661,2,18,"2 - 18","#005CAD",5,10,"2029"
3,100,100,2029-06-11,1905,9,3,8,"PRO","Providence Crabs","away",0,1,"Eastern Division","PBE",3,18,-15,"3 - 18",6,137,49,141,2401,18769,21,0.113415210203118,2,19,"2 - 19","#005CAD",5,10,"2029"
3,100,105,2029-06-12,1905,10,3,9,"PRO","Providence Crabs","away",0,1,"Eastern Division","PBE",3,19,-16,"3 - 19",4,141,52,150,2704,19881,22,0.119725481514279,3,19,"3 - 19","#005CAD",5,10,"2029"
3,100,110,2029-06-13,1905,9,6,12,"PRO","Providence Crabs","away",1,0,"Eastern Division","PBE",4,19,-15,"4 - 19",3,144,58,162,3364,20736,23,0.139585062240664,3,20,"3 - 20","#005CAD",5,10,"2029"
3,100,114,2029-06-14,1905,9,9,15,"PRO","Providence Crabs","away",1,0,"Eastern Division","PBE",5,19,-14,"5 - 19",7,151,67,177,4489,22801,24,0.164492488090876,4,20,"4 - 20","#005CAD",5,10,"2029"
3,100,121,2029-06-17,1905,9,3,5,"PRO","Providence Crabs","home",0,1,"Eastern Division","PBE",5,20,-15,"5 - 20",5,156,70,182,4900,24336,25,0.167601587084416,4,21,"4 - 21","#005CAD",5,10,"2029"
3,100,126,2029-06-18,1905,9,6,11,"PRO","Providence Crabs","home",0,1,"Eastern Division","PBE",5,21,-16,"5 - 21",8,164,76,193,5776,26896,26,0.176787463271303,5,21,"5 - 21","#005CAD",5,10,"2029"
3,100,131,2029-06-19,1905,9,8,11,"PRO","Providence Crabs","home",1,0,"Eastern Division","PBE",6,21,-15,"6 - 21",3,167,84,204,7056,27889,27,0.201917298612105,5,22,"5 - 22","#005CAD",5,10,"2029"
3,100,135,2029-06-22,1905,9,2,3,"PRO","Providence Crabs","home",0,1,"Eastern Division","PBE",6,22,-16,"6 - 22",6,173,86,207,7396,29929,28,0.198151373074347,6,22,"6 - 22","#005CAD",5,10,"2029"
3,100,140,2029-06-23,1905,9,5,8,"PRO","Providence Crabs","home",0,1,"Eastern Division","PBE",6,23,-17,"6 - 23",8,181,91,215,8281,32761,29,0.201768919643292,6,23,"6 - 23","#005CAD",5,10,"2029"
3,100,145,2029-06-24,1905,9,0,5,"PRO","Providence Crabs","home",0,1,"Eastern Division","PBE",6,24,-18,"6 - 24",5,186,91,220,8281,34596,30,0.193133847983768,6,24,"6 - 24","#005CAD",5,10,"2029"
3,100,150,2029-06-25,1905,9,5,10,"PRO","Providence Crabs","home",0,1,"Eastern Division","PBE",6,25,-19,"6 - 25",8,194,96,230,9216,37636,31,0.196704516349355,6,25,"6 - 25","#005CAD",5,10,"2029"
3,100,156,2029-06-27,1905,9,2,4,"PRO","Providence Crabs","home",0,1,"Eastern Division","PBE",6,26,-20,"6 - 26",5,199,98,234,9604,39601,32,0.19518341631948,6,26,"6 - 26","#005CAD",5,10,"2029"
3,100,161,2029-06-28,1905,9,4,6,"PRO","Providence Crabs","home",1,0,"Eastern Division","PBE",7,26,-19,"7 - 26",3,202,102,240,10404,40804,33,0.203171379471958,7,26,"7 - 26","#005CAD",5,10,"2029"
3,100,166,2029-06-29,1905,9,0,6,"PRO","Providence Crabs","home",0,1,"Eastern Division","PBE",7,27,-20,"7 - 27",4,206,102,246,10404,42436,34,0.196896290688872,7,27,"7 - 27","#005CAD",5,10,"2029"
3,100,171,2029-06-30,1905,9,5,9,"PRO","Providence Crabs","home",1,0,"Eastern Division","PBE",8,27,-19,"8 - 27",4,210,107,255,11449,44100,35,0.206106320545824,7,28,"7 - 28","#005CAD",5,10,"2029"
3,100,174,2029-07-03,1905,9,5,12,"PRO","Providence Crabs","away",1,0,"Eastern Division","PBE",9,27,-18,"9 - 27",4,214,112,267,12544,45796,36,0.215015426808365,8,28,"8 - 28","#005CAD",5,10,"2029"
3,100,179,2029-07-04,1905,9,0,3,"PRO","Providence Crabs","away",0,1,"Eastern Division","PBE",9,28,-19,"9 - 28",8,222,112,270,12544,49284,37,0.202885424079705,8,29,"8 - 29","#005CAD",5,10,"2029"
3,100,184,2029-07-05,1905,9,0,2,"PRO","Providence Crabs","away",0,1,"Eastern Division","PBE",9,29,-20,"9 - 29",26,248,112,272,12544,61504,38,0.169403630077787,6,32,"6 - 32","#005CAD",5,10,"2029"
3,100,189,2029-07-06,1905,9,3,5,"PRO","Providence Crabs","away",0,1,"Eastern Division","PBE",9,30,-21,"9 - 30",13,261,115,277,13225,68121,39,0.162577139625796,6,33,"6 - 33","#005CAD",5,10,"2029"
3,100,195,2029-07-09,1905,9,3,9,"PRO","Providence Crabs","away",1,0,"Eastern Division","PBE",10,30,-20,"10 - 30",2,263,118,286,13924,69169,40,0.167571275558711,7,33,"7 - 33","#005CAD",5,10,"2029"
3,100,200,2029-07-10,1905,9,3,9,"PRO","Providence Crabs","away",0,1,"Eastern Division","PBE",10,31,-21,"10 - 31",5,268,121,295,14641,71824,41,0.169328630081536,7,34,"7 - 34","#005CAD",5,10,"2029"
3,100,205,2029-07-11,1905,9,4,8,"PRO","Providence Crabs","away",0,1,"Eastern Division","PBE",10,32,-22,"10 - 32",21,289,125,303,15625,83521,42,0.157595868718859,7,35,"7 - 35","#005CAD",5,10,"2029"
3,100,210,2029-07-12,1905,9,1,6,"PRO","Providence Crabs","away",0,1,"Eastern Division","PBE",10,33,-23,"10 - 33",7,296,126,309,15876,87616,43,0.153403161597032,7,36,"7 - 36","#005CAD",5,10,"2029"
3,100,215,2029-07-15,1905,9,2,8,"PRO","Providence Crabs","home",0,1,"Eastern Division","PBE",10,34,-24,"10 - 34",9,305,128,317,16384,93025,44,0.149750020565036,7,37,"7 - 37","#005CAD",5,10,"2029"
3,100,220,2029-07-16,1905,9,4,9,"PRO","Providence Crabs","home",0,1,"Eastern Division","PBE",10,35,-25,"10 - 35",7,312,132,326,17424,97344,45,0.151819322459222,7,38,"7 - 38","#005CAD",5,10,"2029"
3,100,225,2029-07-17,1905,9,5,9,"PRO","Providence Crabs","home",1,0,"Eastern Division","PBE",11,35,-24,"11 - 35",2,314,137,335,18769,98596,46,0.159919907979381,7,39,"7 - 39","#005CAD",5,10,"2029"
3,100,230,2029-07-18,1905,9,4,10,"PRO","Providence Crabs","home",1,0,"Eastern Division","PBE",12,35,-23,"12 - 35",3,317,141,345,19881,100489,47,0.165165738971505,8,39,"8 - 39","#005CAD",5,10,"2029"
3,100,238,2029-07-21,1905,9,4,9,"PRO","Providence Crabs","away",1,0,"Eastern Division","PBE",13,35,-22,"13 - 35",3,320,145,354,21025,102400,48,0.170346364188779,8,40,"8 - 40","#005CAD",5,10,"2029"
3,100,243,2029-07-22,1905,12,2,8,"PRO","Providence Crabs","away",0,1,"Eastern Division","PBE",13,36,-23,"13 - 36",3,323,147,362,21609,104329,49,0.171584430434023,8,41,"8 - 41","#005CAD",5,10,"2029"
3,100,248,2029-07-23,1905,9,10,14,"PRO","Providence Crabs","away",1,0,"Eastern Division","PBE",14,36,-22,"14 - 36",5,328,157,376,24649,107584,50,0.186405813979869,9,41,"9 - 41","#005CAD",5,10,"2029"
3,100,253,2029-07-24,1905,9,2,7,"PRO","Providence Crabs","away",0,1,"Eastern Division","PBE",14,37,-23,"14 - 37",4,332,159,383,25281,110224,51,0.186568761300321,10,41,"10 - 41","#005CAD",5,10,"2029"
9,100,4,2029-05-15,1905,9,7,12,"SAS","San Antonio Sloths","away",1,0,"Western Division","PBE",1,0,1,"1 - 0",2,2,7,12,49,4,1,0.924528301886792,1,0,"1 - 0","#87795E",3,7,"2029"
9,100,9,2029-05-16,1905,9,5,10,"SAS","San Antonio Sloths","away",1,0,"Western Division","PBE",2,0,2,"2 - 0",1,3,12,22,144,9,2,0.941176470588235,2,0,"2 - 0","#87795E",3,7,"2029"
9,100,14,2029-05-17,1905,9,5,15,"SAS","San Antonio Sloths","away",0,1,"Western Division","PBE",2,1,1,"2 - 1",7,10,17,37,289,100,3,0.74293059125964,2,1,"2 - 1","#87795E",3,7,"2029"
9,100,19,2029-05-18,1905,9,1,5,"SAS","San Antonio Sloths","away",0,1,"Western Division","PBE",2,2,0,"2 - 2",6,16,18,42,324,256,4,0.558620689655172,2,2,"2 - 2","#87795E",3,7,"2029"
9,100,25,2029-05-21,1905,9,6,11,"SAS","San Antonio Sloths","home",0,1,"Western Division","PBE",2,3,-1,"2 - 3",8,24,24,53,576,576,5,0.5,2,3,"2 - 3","#87795E",3,7,"2029"
9,100,30,2029-05-22,1905,9,4,9,"SAS","San Antonio Sloths","home",0,1,"Western Division","PBE",2,4,-2,"2 - 4",7,31,28,62,784,961,6,0.449283667621777,3,3,"3 - 3","#87795E",3,7,"2029"
9,100,35,2029-05-23,1905,9,6,13,"SAS","San Antonio Sloths","home",1,0,"Western Division","PBE",3,4,-1,"3 - 4",4,35,34,75,1156,1225,7,0.485510289794204,3,4,"3 - 4","#87795E",3,7,"2029"
9,100,39,2029-05-24,1905,11,4,11,"SAS","San Antonio Sloths","home",1,0,"Western Division","PBE",4,4,0,"4 - 4",3,38,38,86,1444,1444,8,0.5,4,4,"4 - 4","#87795E",3,7,"2029"
9,100,47,2029-05-27,1905,9,1,7,"SAS","San Antonio Sloths","away",0,1,"Western Division","PBE",4,5,-1,"4 - 5",12,50,39,93,1521,2500,9,0.378264113404626,3,6,"3 - 6","#87795E",3,7,"2029"
9,100,52,2029-05-28,1905,9,8,10,"SAS","San Antonio Sloths","away",0,1,"Western Division","PBE",4,6,-2,"4 - 6",15,65,47,103,2209,4225,10,0.343332297171278,3,7,"3 - 7","#87795E",3,7,"2029"
9,100,57,2029-05-29,1905,9,2,7,"SAS","San Antonio Sloths","away",0,1,"Western Division","PBE",4,7,-3,"4 - 7",8,73,49,110,2401,5329,11,0.310608020698577,3,8,"3 - 8","#87795E",3,7,"2029"
9,100,63,2029-06-01,1905,9,0,2,"SAS","San Antonio Sloths","home",0,1,"Western Division","PBE",4,8,-4,"4 - 8",3,76,49,112,2401,5776,12,0.293628470099058,4,8,"4 - 8","#87795E",3,7,"2029"
9,100,68,2029-06-02,1905,9,5,8,"SAS","San Antonio Sloths","home",0,1,"Western Division","PBE",4,9,-5,"4 - 9",9,85,54,120,2916,7225,13,0.287545606942116,4,9,"4 - 9","#87795E",3,7,"2029"
9,100,73,2029-06-03,1905,9,1,4,"SAS","San Antonio Sloths","home",0,1,"Western Division","PBE",4,10,-6,"4 - 10",4,89,55,124,3025,7921,14,0.276356659967111,4,10,"4 - 10","#87795E",3,7,"2029"
9,100,78,2029-06-04,1905,9,6,9,"SAS","San Antonio Sloths","home",0,1,"Western Division","PBE",4,11,-7,"4 - 11",7,96,61,133,3721,9216,15,0.287624642498261,4,11,"4 - 11","#87795E",3,7,"2029"
9,100,81,2029-06-06,1905,9,2,5,"SAS","San Antonio Sloths","away",0,1,"Western Division","PBE",4,12,-8,"4 - 12",3,99,63,138,3969,9801,16,0.288235294117647,5,11,"5 - 11","#87795E",3,7,"2029"
9,100,85,2029-06-07,1905,9,0,6,"SAS","San Antonio Sloths","away",0,1,"Western Division","PBE",4,13,-9,"4 - 13",1,100,63,144,3969,10000,17,0.284129143102584,5,12,"5 - 12","#87795E",3,7,"2029"
9,100,90,2029-06-08,1905,9,5,10,"SAS","San Antonio Sloths","away",0,1,"Western Division","PBE",4,14,-10,"4 - 14",11,111,68,154,4624,12321,18,0.272882856299793,5,13,"5 - 13","#87795E",3,7,"2029"
9,100,94,2029-06-09,1905,9,1,1,"SAS","San Antonio Sloths","away",1,0,"Western Division","PBE",5,14,-9,"5 - 14",0,111,69,155,4761,12321,19,0.278714436248683,5,14,"5 - 14","#87795E",3,7,"2029"
9,100,100,2029-06-11,1905,9,6,9,"SAS","San Antonio Sloths","home",1,0,"Western Division","PBE",6,14,-8,"6 - 14",3,114,75,164,5625,12996,20,0.302078298695022,6,14,"6 - 14","#87795E",3,7,"2029"
9,100,105,2029-06-12,1905,10,4,11,"SAS","San Antonio Sloths","home",1,0,"Western Division","PBE",7,14,-7,"7 - 14",3,117,79,175,6241,13689,21,0.313146011038635,7,14,"7 - 14","#87795E",3,7,"2029"
9,100,110,2029-06-13,1905,9,3,9,"SAS","San Antonio Sloths","home",0,1,"Western Division","PBE",7,15,-8,"7 - 15",6,123,82,184,6724,15129,22,0.307692307692308,7,15,"7 - 15","#87795E",3,7,"2029"
9,100,114,2029-06-14,1905,9,7,11,"SAS","San Antonio Sloths","home",0,1,"Western Division","PBE",7,16,-9,"7 - 16",9,132,89,195,7921,17424,23,0.312527125665812,7,16,"7 - 16","#87795E",3,7,"2029"
9,100,119,2029-06-16,1905,9,7,10,"SAS","San Antonio Sloths","away",1,0,"Western Division","PBE",8,16,-8,"8 - 16",2,134,96,205,9216,17956,24,0.339172677756514,8,16,"8 - 16","#87795E",3,7,"2029"
9,100,124,2029-06-17,1905,9,11,16,"SAS","San Antonio Sloths","away",1,0,"Western Division","PBE",9,16,-7,"9 - 16",3,137,107,221,11449,18769,25,0.378880137666292,9,16,"9 - 16","#87795E",3,7,"2029"
9,100,129,2029-06-18,1905,9,7,8,"SAS","San Antonio Sloths","away",1,0,"Western Division","PBE",10,16,-6,"10 - 16",2,139,114,229,12996,19321,26,0.402141287867067,10,16,"10 - 16","#87795E",3,7,"2029"
9,100,134,2029-06-19,1905,9,5,11,"SAS","San Antonio Sloths","away",0,1,"Western Division","PBE",10,17,-7,"10 - 17",10,149,119,240,14161,22201,27,0.389445025026126,11,16,"11 - 16","#87795E",3,7,"2029"
9,100,138,2029-06-22,1905,9,6,9,"SAS","San Antonio Sloths","home",1,0,"Western Division","PBE",11,17,-6,"11 - 17",2,151,125,249,15625,22801,28,0.406625722167283,11,17,"11 - 17","#87795E",3,7,"2029"
9,100,143,2029-06-23,1905,9,6,11,"SAS","San Antonio Sloths","home",1,0,"Western Division","PBE",12,17,-5,"12 - 17",5,156,131,260,17161,24336,29,0.413547967322939,12,17,"12 - 17","#87795E",3,7,"2029"
9,100,148,2029-06-24,1905,9,5,5,"SAS","San Antonio Sloths","home",0,1,"Western Division","PBE",12,18,-6,"12 - 18",7,163,136,265,18496,26569,30,0.410429379784755,12,18,"12 - 18","#87795E",3,7,"2029"
9,100,153,2029-06-25,1905,10,10,13,"SAS","San Antonio Sloths","home",1,0,"Western Division","PBE",13,18,-5,"13 - 18",8,171,146,278,21316,29241,31,0.421623118460352,13,18,"13 - 18","#87795E",3,7,"2029"
9,100,158,2029-06-27,1905,9,2,8,"SAS","San Antonio Sloths","home",0,1,"Western Division","PBE",13,19,-6,"13 - 19",5,176,148,286,21904,30976,32,0.414220877458396,13,19,"13 - 19","#87795E",3,7,"2029"
9,100,163,2029-06-28,1905,9,1,2,"SAS","San Antonio Sloths","home",1,0,"Western Division","PBE",14,19,-5,"14 - 19",0,176,149,288,22201,30976,33,0.4174925249638,14,19,"14 - 19","#87795E",3,7,"2029"
9,100,168,2029-06-29,1905,9,6,10,"SAS","San Antonio Sloths","home",1,0,"Western Division","PBE",15,19,-4,"15 - 19",2,178,155,298,24025,31684,34,0.431258863020338,15,19,"15 - 19","#87795E",3,7,"2029"
9,100,173,2029-06-30,1905,9,1,5,"SAS","San Antonio Sloths","home",0,1,"Western Division","PBE",15,20,-5,"15 - 20",3,181,156,303,24336,32761,35,0.42622204318966,15,20,"15 - 20","#87795E",3,7,"2029"
9,100,175,2029-07-03,1905,9,3,6,"SAS","San Antonio Sloths","away",0,1,"Western Division","PBE",15,21,-6,"15 - 21",6,187,159,309,25281,34969,36,0.419601659751037,15,21,"15 - 21","#87795E",3,7,"2029"
9,100,180,2029-07-04,1905,9,12,13,"SAS","San Antonio Sloths","away",1,0,"Western Division","PBE",16,21,-5,"16 - 21",4,191,171,322,29241,36481,37,0.444919509448891,16,21,"16 - 21","#87795E",3,7,"2029"
9,100,185,2029-07-05,1905,9,3,5,"SAS","San Antonio Sloths","away",0,1,"Western Division","PBE",16,22,-6,"16 - 22",8,199,174,327,30276,39601,38,0.433275612862601,16,22,"16 - 22","#87795E",3,7,"2029"
9,100,190,2029-07-06,1905,9,3,7,"SAS","San Antonio Sloths","away",0,1,"Western Division","PBE",16,23,-7,"16 - 23",12,211,177,334,31329,44521,39,0.413038892551088,16,23,"16 - 23","#87795E",3,7,"2029"
9,100,198,2029-07-09,1905,9,3,9,"SAS","San Antonio Sloths","away",0,1,"Western Division","PBE",16,24,-8,"16 - 24",4,215,180,343,32400,46225,40,0.4120826709062,16,24,"16 - 24","#87795E",3,7,"2029"
9,100,203,2029-07-10,1905,9,1,2,"SAS","San Antonio Sloths","away",0,1,"Western Division","PBE",16,25,-9,"16 - 25",2,217,181,345,32761,47089,41,0.410281778334377,17,24,"17 - 24","#87795E",3,7,"2029"
9,100,208,2029-07-11,1905,9,6,11,"SAS","San Antonio Sloths","away",1,0,"Western Division","PBE",17,25,-8,"17 - 25",4,221,187,356,34969,48841,42,0.417241379310345,18,24,"18 - 24","#87795E",3,7,"2029"
9,100,213,2029-07-12,1905,9,0,4,"SAS","San Antonio Sloths","away",0,1,"Western Division","PBE",17,26,-9,"17 - 26",10,231,187,360,34969,53361,43,0.395890410958904,17,26,"17 - 26","#87795E",3,7,"2029"
9,100,217,2029-07-15,1905,9,8,12,"SAS","San Antonio Sloths","home",1,0,"Western Division","PBE",18,26,-8,"18 - 26",1,232,195,372,38025,53824,44,0.413994708706682,18,26,"18 - 26","#87795E",3,7,"2029"
9,100,222,2029-07-16,1905,9,13,9,"SAS","San Antonio Sloths","home",1,0,"Western Division","PBE",19,26,-7,"19 - 26",3,235,208,381,43264,55225,45,0.439277482764573,20,25,"20 - 25","#87795E",3,7,"2029"
9,100,227,2029-07-17,1905,9,7,7,"SAS","San Antonio Sloths","home",0,1,"Western Division","PBE",19,27,-8,"19 - 27",8,243,215,388,46225,59049,46,0.43909227349583,20,26,"20 - 26","#87795E",3,7,"2029"
9,100,232,2029-07-18,1905,9,7,8,"SAS","San Antonio Sloths","home",1,0,"Western Division","PBE",20,27,-7,"20 - 27",1,244,222,396,49284,59536,47,0.452894688476383,21,26,"21 - 26","#87795E",3,7,"2029"
9,100,237,2029-07-21,1905,9,2,7,"SAS","San Antonio Sloths","home",0,1,"Western Division","PBE",20,28,-8,"20 - 28",3,247,224,403,50176,61009,48,0.451283896209021,22,26,"22 - 26","#87795E",3,7,"2029"
9,100,242,2029-07-22,1905,9,3,6,"SAS","San Antonio Sloths","home",1,0,"Western Division","PBE",21,28,-7,"21 - 28",1,248,227,409,51529,61504,49,0.455875717710757,22,27,"22 - 27","#87795E",3,7,"2029"
9,100,247,2029-07-23,1905,9,2,5,"SAS","San Antonio Sloths","home",0,1,"Western Division","PBE",21,29,-8,"21 - 29",5,253,229,414,52441,64009,50,0.450330613997424,23,27,"23 - 27","#87795E",3,7,"2029"
9,100,252,2029-07-24,1905,9,6,9,"SAS","San Antonio Sloths","home",1,0,"Western Division","PBE",22,29,-7,"22 - 29",5,258,235,423,55225,66564,51,0.453448176764732,23,28,"23 - 28","#87795E",3,7,"2029"
10,100,3,2029-05-15,1905,9,19,15,"DV","Death Valley Scorpions","away",1,0,"Western Division","PBE",1,0,1,"1 - 0",0,0,19,15,361,0,1,1,1,0,"1 - 0","#97162B",1,2,"2029"
10,100,8,2029-05-16,1905,9,9,12,"DV","Death Valley Scorpions","away",1,0,"Western Division","PBE",2,0,2,"2 - 0",1,1,28,27,784,1,2,0.998726114649682,2,0,"2 - 0","#97162B",1,2,"2029"
10,100,13,2029-05-17,1905,9,0,5,"DV","Death Valley Scorpions","away",0,1,"Western Division","PBE",2,1,1,"2 - 1",1,2,28,32,784,4,3,0.99492385786802,3,0,"3 - 0","#97162B",1,2,"2029"
10,100,18,2029-05-18,1905,9,7,10,"DV","Death Valley Scorpions","away",1,0,"Western Division","PBE",3,1,2,"3 - 1",2,4,35,42,1225,16,4,0.987107171635778,4,0,"4 - 0","#97162B",1,2,"2029"
10,100,24,2029-05-21,1905,9,5,11,"DV","Death Valley Scorpions","home",1,0,"Western Division","PBE",4,1,3,"4 - 1",3,7,40,53,1600,49,5,0.970285021224985,5,0,"5 - 0","#97162B",1,2,"2029"
10,100,29,2029-05-22,1905,9,6,7,"DV","Death Valley Scorpions","home",1,0,"Western Division","PBE",5,1,4,"5 - 1",3,10,46,60,2116,100,6,0.954873646209386,6,0,"6 - 0","#97162B",1,2,"2029"
10,100,34,2029-05-23,1905,9,6,12,"DV","Death Valley Scorpions","home",1,0,"Western Division","PBE",6,1,5,"6 - 1",4,14,52,72,2704,196,7,0.932413793103448,7,0,"7 - 0","#97162B",1,2,"2029"
10,100,38,2029-05-24,1905,9,7,8,"DV","Death Valley Scorpions","home",1,0,"Western Division","PBE",7,1,6,"7 - 1",6,20,59,80,3481,400,8,0.89693377995362,7,1,"7 - 1","#97162B",1,2,"2029"
10,100,47,2029-05-27,1905,9,12,18,"DV","Death Valley Scorpions","home",1,0,"Western Division","PBE",8,1,7,"8 - 1",1,21,71,98,5041,441,9,0.91955490696826,8,1,"8 - 1","#97162B",1,2,"2029"
10,100,52,2029-05-28,1905,9,15,18,"DV","Death Valley Scorpions","home",1,0,"Western Division","PBE",9,1,8,"9 - 1",8,29,86,116,7396,841,10,0.897899720772126,9,1,"9 - 1","#97162B",1,2,"2029"
10,100,57,2029-05-29,1905,9,8,8,"DV","Death Valley Scorpions","home",1,0,"Western Division","PBE",10,1,9,"10 - 1",2,31,94,124,8836,961,11,0.901908747575789,10,1,"10 - 1","#97162B",1,2,"2029"
10,100,62,2029-06-01,1905,9,9,10,"DV","Death Valley Scorpions","away",1,0,"Western Division","PBE",11,1,10,"11 - 1",2,33,103,134,10609,1089,12,0.906907163617712,11,1,"11 - 1","#97162B",1,2,"2029"
10,100,67,2029-06-02,1905,10,6,9,"DV","Death Valley Scorpions","away",0,1,"Western Division","PBE",11,2,9,"11 - 2",7,40,109,143,11881,1600,13,0.881314442548772,11,2,"11 - 2","#97162B",1,2,"2029"
10,100,72,2029-06-03,1905,9,13,14,"DV","Death Valley Scorpions","away",1,0,"Western Division","PBE",12,2,10,"12 - 2",4,44,122,157,14884,1936,14,0.884898929845422,12,2,"12 - 2","#97162B",1,2,"2029"
10,100,77,2029-06-04,1905,9,4,12,"DV","Death Valley Scorpions","away",1,0,"Western Division","PBE",13,2,11,"13 - 2",0,44,126,169,15876,1936,15,0.891309229732764,13,2,"13 - 2","#97162B",1,2,"2029"
10,100,87,2029-06-07,1905,9,2,7,"DV","Death Valley Scorpions","away",0,1,"Western Division","PBE",13,3,10,"13 - 3",4,48,128,176,16384,2304,16,0.876712328767123,14,2,"14 - 2","#97162B",1,2,"2029"
10,100,92,2029-06-08,1905,10,5,9,"DV","Death Valley Scorpions","away",1,0,"Western Division","PBE",14,3,11,"14 - 3",4,52,133,185,17689,2704,17,0.867405482273329,15,2,"15 - 2","#97162B",1,2,"2029"
10,100,96,2029-06-09,1905,9,9,10,"DV","Death Valley Scorpions","away",1,0,"Western Division","PBE",15,3,12,"15 - 3",2,54,142,195,20164,2916,18,0.873656845753899,16,2,"16 - 2","#97162B",1,2,"2029"
10,100,98,2029-06-11,1905,9,11,12,"DV","Death Valley Scorpions","home",1,0,"Western Division","PBE",16,3,13,"16 - 3",8,62,153,207,23409,3844,19,0.858951308112868,16,3,"16 - 3","#97162B",1,2,"2029"
10,100,103,2029-06-12,1905,9,8,10,"DV","Death Valley Scorpions","home",1,0,"Western Division","PBE",17,3,14,"17 - 3",6,68,161,217,25921,4624,20,0.848616794892781,17,3,"17 - 3","#97162B",1,2,"2029"
10,100,108,2029-06-13,1905,9,8,13,"DV","Death Valley Scorpions","home",1,0,"Western Division","PBE",18,3,15,"18 - 3",0,68,169,230,28561,4624,21,0.860659936718397,18,3,"18 - 3","#97162B",1,2,"2029"
10,100,112,2029-06-14,1905,9,10,9,"DV","Death Valley Scorpions","home",1,0,"Western Division","PBE",19,3,16,"19 - 3",2,70,179,239,32041,4900,22,0.867356054248667,19,3,"19 - 3","#97162B",1,2,"2029"
10,100,118,2029-06-16,1905,9,3,7,"DV","Death Valley Scorpions","home",0,1,"Western Division","PBE",19,4,15,"19 - 4",4,74,182,246,33124,5476,23,0.858134715025907,20,3,"20 - 3","#97162B",1,2,"2029"
10,100,123,2029-06-17,1905,9,11,12,"DV","Death Valley Scorpions","home",1,0,"Western Division","PBE",20,4,16,"20 - 4",1,75,193,258,37249,5625,24,0.868801604702151,21,3,"21 - 3","#97162B",1,2,"2029"
10,100,128,2029-06-18,1905,9,4,5,"DV","Death Valley Scorpions","home",1,0,"Western Division","PBE",21,4,17,"21 - 4",0,75,197,263,38809,5625,25,0.873407750821443,22,3,"22 - 3","#97162B",1,2,"2029"
10,100,133,2029-06-19,1905,9,6,10,"DV","Death Valley Scorpions","home",1,0,"Western Division","PBE",22,4,18,"22 - 4",0,75,203,273,41209,5625,26,0.879894948114618,23,3,"23 - 3","#97162B",1,2,"2029"
10,100,138,2029-06-22,1905,9,2,12,"DV","Death Valley Scorpions","away",0,1,"Western Division","PBE",22,5,17,"22 - 5",6,81,205,285,42025,6561,27,0.864961099905323,23,4,"23 - 4","#97162B",1,2,"2029"
10,100,143,2029-06-23,1905,9,5,7,"DV","Death Valley Scorpions","away",0,1,"Western Division","PBE",22,6,16,"22 - 6",6,87,210,292,44100,7569,28,0.853509841491029,24,4,"24 - 4","#97162B",1,2,"2029"
10,100,148,2029-06-24,1905,9,7,10,"DV","Death Valley Scorpions","away",1,0,"Western Division","PBE",23,6,17,"23 - 6",5,92,217,302,47089,8464,29,0.847640991485608,25,4,"25 - 4","#97162B",1,2,"2029"
10,100,153,2029-06-25,1905,10,8,6,"DV","Death Valley Scorpions","away",0,1,"Western Division","PBE",23,7,16,"23 - 7",10,102,225,308,50625,10404,30,0.829523669075358,25,5,"25 - 5","#97162B",1,2,"2029"
10,100,157,2029-06-27,1905,9,2,9,"DV","Death Valley Scorpions","home",0,1,"Western Division","PBE",23,8,15,"23 - 8",3,105,227,317,51529,11025,31,0.823752278031781,26,5,"26 - 5","#97162B",1,2,"2029"
10,100,162,2029-06-28,1905,9,3,5,"DV","Death Valley Scorpions","home",0,1,"Western Division","PBE",23,9,14,"23 - 9",11,116,230,322,52900,13456,32,0.797215022002532,26,6,"26 - 6","#97162B",1,2,"2029"
10,100,167,2029-06-29,1905,9,6,7,"DV","Death Valley Scorpions","home",1,0,"Western Division","PBE",24,9,15,"24 - 9",3,119,236,329,55696,14161,33,0.797285884020213,26,7,"26 - 7","#97162B",1,2,"2029"
10,100,172,2029-06-30,1905,9,3,4,"DV","Death Valley Scorpions","home",1,0,"Western Division","PBE",25,9,16,"25 - 9",2,121,239,333,57121,14641,34,0.795978372955046,27,7,"27 - 7","#97162B",1,2,"2029"
10,100,178,2029-07-03,1905,9,3,9,"DV","Death Valley Scorpions","away",1,0,"Western Division","PBE",26,9,17,"26 - 9",1,122,242,342,58564,14884,35,0.797353229495698,28,7,"28 - 7","#97162B",1,2,"2029"
10,100,183,2029-07-04,1905,9,4,11,"DV","Death Valley Scorpions","away",0,1,"Western Division","PBE",26,10,16,"26 - 10",10,132,246,353,60516,17424,36,0.776443418013857,28,8,"28 - 8","#97162B",1,2,"2029"
10,100,188,2029-07-05,1905,9,12,14,"DV","Death Valley Scorpions","away",1,0,"Western Division","PBE",27,10,17,"27 - 10",3,135,258,367,66564,18225,37,0.785054665109861,29,8,"29 - 8","#97162B",1,2,"2029"
10,100,193,2029-07-06,1905,9,4,6,"DV","Death Valley Scorpions","away",0,1,"Western Division","PBE",27,11,16,"27 - 11",5,140,262,373,68644,19600,38,0.777888581659943,30,8,"30 - 8","#97162B",1,2,"2029"
10,100,196,2029-07-09,1905,10,5,11,"DV","Death Valley Scorpions","away",0,1,"Western Division","PBE",27,12,15,"27 - 12",8,148,267,384,71289,21904,39,0.764960887620315,30,9,"30 - 9","#97162B",1,2,"2029"
10,100,201,2029-07-10,1905,9,1,7,"DV","Death Valley Scorpions","away",0,1,"Western Division","PBE",27,13,14,"27 - 13",6,154,268,391,71824,23716,40,0.751768892610425,30,10,"30 - 10","#97162B",1,2,"2029"
10,100,206,2029-07-11,1905,9,1,4,"DV","Death Valley Scorpions","away",0,1,"Western Division","PBE",27,14,13,"27 - 14",5,159,269,395,72361,25281,41,0.741084779090965,30,11,"30 - 11","#97162B",1,2,"2029"
10,100,211,2029-07-12,1905,9,6,8,"DV","Death Valley Scorpions","away",1,0,"Western Division","PBE",28,14,14,"28 - 14",1,160,275,403,75625,25600,42,0.747098048900963,31,11,"31 - 11","#97162B",1,2,"2029"
10,100,216,2029-07-15,1905,9,2,5,"DV","Death Valley Scorpions","home",0,1,"Western Division","PBE",28,15,13,"28 - 15",3,163,277,408,76729,26569,43,0.742792696857635,32,11,"32 - 11","#97162B",1,2,"2029"
10,100,221,2029-07-16,1905,9,7,10,"DV","Death Valley Scorpions","home",0,1,"Western Division","PBE",28,16,12,"28 - 16",10,173,284,418,80656,29929,44,0.72935750779943,32,12,"32 - 12","#97162B",1,2,"2029"
10,100,226,2029-07-17,1905,9,3,6,"DV","Death Valley Scorpions","home",1,0,"Western Division","PBE",29,16,13,"29 - 16",0,173,287,424,82369,29929,45,0.73348590357798,33,12,"33 - 12","#97162B",1,2,"2029"
10,100,231,2029-07-18,1905,9,8,6,"DV","Death Valley Scorpions","home",1,0,"Western Division","PBE",30,16,14,"30 - 16",3,176,295,430,87025,30976,46,0.737493750052966,34,12,"34 - 12","#97162B",1,2,"2029"
10,100,235,2029-07-21,1905,9,10,11,"DV","Death Valley Scorpions","away",1,0,"Western Division","PBE",31,16,15,"31 - 16",1,177,305,441,93025,31329,47,0.748066005114431,35,12,"35 - 12","#97162B",1,2,"2029"
10,100,240,2029-07-22,1905,9,4,7,"DV","Death Valley Scorpions","away",1,0,"Western Division","PBE",32,16,16,"32 - 16",3,180,309,448,95481,32400,48,0.746639453867267,36,12,"36 - 12","#97162B",1,2,"2029"
10,100,245,2029-07-23,1905,9,0,7,"DV","Death Valley Scorpions","away",0,1,"Western Division","PBE",32,17,15,"32 - 17",2,182,309,455,95481,33124,49,0.742436141674118,36,13,"36 - 13","#97162B",1,2,"2029"
10,100,250,2029-07-24,1905,9,1,6,"DV","Death Valley Scorpions","away",0,1,"Western Division","PBE",32,18,14,"32 - 18",18,200,310,461,96100,40000,50,0.706098457016899,35,15,"35 - 15","#97162B",1,2,"2029"
11,100,5,2029-05-15,1905,9,4,9,"VAN","Vancouver Vandals","away",1,0,"Western Division","PBE",1,0,1,"1 - 0",1,1,4,9,16,1,1,0.941176470588235,1,0,"1 - 0","#183013",2,6,"2029"
11,100,10,2029-05-16,1905,9,4,9,"VAN","Vancouver Vandals","away",1,0,"Western Division","PBE",2,0,2,"2 - 0",2,3,8,18,64,9,2,0.876712328767123,2,0,"2 - 0","#183013",2,6,"2029"
11,100,15,2029-05-17,1905,10,3,9,"VAN","Vancouver Vandals","away",1,0,"Western Division","PBE",3,0,3,"3 - 0",2,5,11,27,121,25,3,0.828767123287671,2,1,"2 - 1","#183013",2,6,"2029"
11,100,20,2029-05-18,1905,9,10,18,"VAN","Vancouver Vandals","away",1,0,"Western Division","PBE",4,0,4,"4 - 0",0,5,21,45,441,25,4,0.946351931330472,4,0,"4 - 0","#183013",2,6,"2029"
11,100,24,2029-05-21,1905,9,3,11,"VAN","Vancouver Vandals","away",0,1,"Western Division","PBE",4,1,3,"4 - 1",5,10,24,56,576,100,5,0.85207100591716,4,1,"4 - 1","#183013",2,6,"2029"
11,100,29,2029-05-22,1905,9,3,5,"VAN","Vancouver Vandals","away",0,1,"Western Division","PBE",4,2,2,"4 - 2",6,16,27,61,729,256,6,0.74010152284264,4,2,"4 - 2","#183013",2,6,"2029"
11,100,34,2029-05-23,1905,9,4,6,"VAN","Vancouver Vandals","away",0,1,"Western Division","PBE",4,3,1,"4 - 3",6,22,31,67,961,484,7,0.665051903114187,5,2,"5 - 2","#183013",2,6,"2029"
11,100,38,2029-05-24,1905,9,6,12,"VAN","Vancouver Vandals","away",0,1,"Western Division","PBE",4,4,0,"4 - 4",7,29,37,79,1369,841,8,0.619457013574661,5,3,"5 - 3","#183013",2,6,"2029"
11,100,42,2029-05-26,1905,13,1,6,"VAN","Vancouver Vandals","home",1,0,"Western Division","PBE",5,4,1,"5 - 4",0,29,38,85,1444,841,9,0.631947483588621,6,3,"6 - 3","#183013",2,6,"2029"
11,100,46,2029-05-27,1905,9,2,9,"VAN","Vancouver Vandals","home",0,1,"Western Division","PBE",5,5,0,"5 - 5",7,36,40,94,1600,1296,10,0.552486187845304,6,4,"6 - 4","#183013",2,6,"2029"
11,100,51,2029-05-28,1905,10,1,4,"VAN","Vancouver Vandals","home",1,0,"Western Division","PBE",6,5,1,"6 - 5",0,36,41,98,1681,1296,11,0.564662411823984,6,5,"6 - 5","#183013",2,6,"2029"
11,100,56,2029-05-29,1905,9,10,13,"VAN","Vancouver Vandals","home",1,0,"Western Division","PBE",7,5,2,"7 - 5",3,39,51,111,2601,1521,12,0.631004366812227,8,4,"8 - 4","#183013",2,6,"2029"
11,100,63,2029-06-01,1905,9,3,7,"VAN","Vancouver Vandals","away",1,0,"Western Division","PBE",8,5,3,"8 - 5",0,39,54,118,2916,1521,13,0.657200811359026,9,4,"9 - 4","#183013",2,6,"2029"
11,100,68,2029-06-02,1905,9,9,8,"VAN","Vancouver Vandals","away",1,0,"Western Division","PBE",9,5,4,"9 - 5",5,44,63,126,3969,1936,14,0.672142252328535,9,5,"9 - 5","#183013",2,6,"2029"
11,100,73,2029-06-03,1905,9,4,10,"VAN","Vancouver Vandals","away",1,0,"Western Division","PBE",10,5,5,"10 - 5",1,45,67,136,4489,2025,15,0.689131102241326,10,5,"10 - 5","#183013",2,6,"2029"
11,100,78,2029-06-04,1905,9,7,9,"VAN","Vancouver Vandals","away",1,0,"Western Division","PBE",11,5,6,"11 - 5",6,51,74,145,5476,2601,16,0.677974495480995,11,5,"11 - 5","#183013",2,6,"2029"
11,100,82,2029-06-06,1905,13,2,10,"VAN","Vancouver Vandals","home",1,0,"Western Division","PBE",12,5,7,"12 - 5",1,52,76,155,5776,2704,17,0.681132075471698,12,5,"12 - 5","#183013",2,6,"2029"
11,100,86,2029-06-07,1905,9,13,17,"VAN","Vancouver Vandals","home",1,0,"Western Division","PBE",13,5,8,"13 - 5",5,57,89,172,7921,3249,18,0.709131602506714,13,5,"13 - 5","#183013",2,6,"2029"
11,100,91,2029-06-08,1905,9,3,10,"VAN","Vancouver Vandals","home",1,0,"Western Division","PBE",14,5,9,"14 - 5",2,59,92,182,8464,3481,19,0.708580996232733,13,6,"13 - 6","#183013",2,6,"2029"
11,100,95,2029-06-09,1905,9,1,4,"VAN","Vancouver Vandals","home",0,1,"Western Division","PBE",14,6,8,"14 - 6",7,66,93,186,8649,4356,20,0.665051903114187,13,7,"13 - 7","#183013",2,6,"2029"
11,100,99,2029-06-11,1905,11,1,10,"VAN","Vancouver Vandals","away",0,1,"Western Division","PBE",14,7,7,"14 - 7",3,69,94,196,8836,4761,21,0.649849231448114,14,7,"14 - 7","#183013",2,6,"2029"
11,100,104,2029-06-12,1905,9,2,11,"VAN","Vancouver Vandals","away",0,1,"Western Division","PBE",14,8,6,"14 - 8",4,73,96,207,9216,5329,22,0.633619800618769,14,8,"14 - 8","#183013",2,6,"2029"
11,100,109,2029-06-13,1905,9,3,10,"VAN","Vancouver Vandals","away",0,1,"Western Division","PBE",14,9,5,"14 - 9",5,78,99,217,9801,6084,23,0.61699716713881,14,9,"14 - 9","#183013",2,6,"2029"
11,100,113,2029-06-14,1905,9,6,14,"VAN","Vancouver Vandals","away",1,0,"Western Division","PBE",15,9,6,"15 - 9",4,82,105,231,11025,6724,24,0.621161755591864,15,9,"15 - 9","#183013",2,6,"2029"
11,100,119,2029-06-16,1905,9,2,12,"VAN","Vancouver Vandals","home",0,1,"Western Division","PBE",15,10,5,"15 - 10",7,89,107,243,11449,7921,25,0.591068662880743,15,10,"15 - 10","#183013",2,6,"2029"
11,100,124,2029-06-17,1905,9,3,10,"VAN","Vancouver Vandals","home",0,1,"Western Division","PBE",15,11,4,"15 - 11",11,100,110,253,12100,10000,26,0.547511312217195,14,12,"14 - 12","#183013",2,6,"2029"
11,100,129,2029-06-18,1905,9,2,5,"VAN","Vancouver Vandals","home",0,1,"Western Division","PBE",15,12,3,"15 - 12",7,107,112,258,12544,11449,27,0.522819155587046,14,13,"14 - 13","#183013",2,6,"2029"
11,100,134,2029-06-19,1905,9,10,12,"VAN","Vancouver Vandals","home",1,0,"Western Division","PBE",16,12,4,"16 - 12",5,112,122,270,14884,12544,28,0.542657138690389,15,13,"15 - 13","#183013",2,6,"2029"
11,100,139,2029-06-22,1905,9,7,10,"VAN","Vancouver Vandals","home",1,0,"Western Division","PBE",17,12,5,"17 - 12",5,117,129,280,16641,13689,29,0.5486646884273,16,13,"16 - 13","#183013",2,6,"2029"
11,100,144,2029-06-23,1905,9,4,8,"VAN","Vancouver Vandals","home",0,1,"Western Division","PBE",17,13,4,"17 - 13",6,123,133,288,17689,15129,30,0.539002986166128,16,14,"16 - 14","#183013",2,6,"2029"
11,100,149,2029-06-24,1905,9,9,15,"VAN","Vancouver Vandals","home",1,0,"Western Division","PBE",18,13,5,"18 - 13",6,129,142,303,20164,16641,31,0.547860345061812,17,14,"17 - 14","#183013",2,6,"2029"
11,100,154,2029-06-25,1905,12,6,14,"VAN","Vancouver Vandals","home",0,1,"Western Division","PBE",18,14,4,"18 - 14",7,136,148,317,21904,18496,32,0.542178217821782,17,15,"17 - 15","#183013",2,6,"2029"
11,100,156,2029-06-27,1905,9,5,11,"VAN","Vancouver Vandals","away",1,0,"Western Division","PBE",19,14,5,"19 - 14",2,138,153,328,23409,19044,33,0.551409794360823,18,15,"18 - 15","#183013",2,6,"2029"
11,100,161,2029-06-28,1905,9,3,7,"VAN","Vancouver Vandals","away",0,1,"Western Division","PBE",19,15,4,"19 - 15",4,142,156,335,24336,20164,34,0.546876404494382,19,15,"19 - 15","#183013",2,6,"2029"
11,100,166,2029-06-29,1905,9,4,9,"VAN","Vancouver Vandals","away",1,0,"Western Division","PBE",20,15,5,"20 - 15",0,142,160,344,25600,20164,35,0.559391661568045,20,15,"20 - 15","#183013",2,6,"2029"
11,100,171,2029-06-30,1905,9,4,11,"VAN","Vancouver Vandals","away",0,1,"Western Division","PBE",20,16,4,"20 - 16",5,147,164,355,26896,21609,36,0.554499536130296,20,16,"20 - 16","#183013",2,6,"2029"
11,100,178,2029-07-03,1905,9,1,7,"VAN","Vancouver Vandals","home",0,1,"Western Division","PBE",20,17,3,"20 - 17",3,150,165,362,27225,22500,37,0.547511312217195,20,17,"20 - 17","#183013",2,6,"2029"
11,100,183,2029-07-04,1905,9,10,11,"VAN","Vancouver Vandals","home",1,0,"Western Division","PBE",21,17,4,"21 - 17",4,154,175,373,30625,23716,38,0.563570784490532,21,17,"21 - 17","#183013",2,6,"2029"
11,100,188,2029-07-05,1905,9,3,6,"VAN","Vancouver Vandals","home",0,1,"Western Division","PBE",21,18,3,"21 - 18",12,166,178,379,31684,27556,39,0.534841323430115,21,18,"21 - 18","#183013",2,6,"2029"
11,100,193,2029-07-06,1905,9,5,13,"VAN","Vancouver Vandals","home",1,0,"Western Division","PBE",22,18,4,"22 - 18",4,170,183,392,33489,28900,40,0.536777316514129,21,19,"21 - 19","#183013",2,6,"2029"
11,100,197,2029-07-09,1905,15,8,17,"VAN","Vancouver Vandals","away",1,0,"Western Division","PBE",23,18,5,"23 - 18",3,173,191,409,36481,29929,41,0.549329920192742,23,18,"23 - 18","#183013",2,6,"2029"
11,100,202,2029-07-10,1905,9,6,10,"VAN","Vancouver Vandals","away",0,1,"Western Division","PBE",23,19,4,"23 - 19",7,180,197,419,38809,32400,42,0.545001334101027,23,19,"23 - 19","#183013",2,6,"2029"
11,100,207,2029-07-11,1905,9,5,7,"VAN","Vancouver Vandals","away",0,1,"Western Division","PBE",23,20,3,"23 - 20",7,187,202,426,40804,34969,43,0.53850316075647,23,20,"23 - 20","#183013",2,6,"2029"
11,100,212,2029-07-12,1905,9,3,6,"VAN","Vancouver Vandals","away",0,1,"Western Division","PBE",23,21,2,"23 - 21",4,191,205,432,42025,36481,44,0.535309403102948,24,20,"24 - 20","#183013",2,6,"2029"
11,100,218,2029-07-15,1905,9,15,19,"VAN","Vancouver Vandals","home",1,0,"Western Division","PBE",24,21,3,"24 - 21",5,196,220,451,48400,38416,45,0.557500921489126,25,20,"25 - 20","#183013",2,6,"2029"
11,100,223,2029-07-16,1905,9,3,5,"VAN","Vancouver Vandals","home",0,1,"Western Division","PBE",24,22,2,"24 - 22",4,200,223,456,49729,40000,46,0.554213242095644,25,21,"25 - 21","#183013",2,6,"2029"
11,100,228,2029-07-17,1905,9,0,8,"VAN","Vancouver Vandals","home",0,1,"Western Division","PBE",24,23,1,"24 - 23",1,201,223,464,49729,40401,47,0.55174747586819,26,21,"26 - 21","#183013",2,6,"2029"
11,100,233,2029-07-18,1905,9,3,12,"VAN","Vancouver Vandals","home",1,0,"Western Division","PBE",25,23,2,"25 - 23",1,202,226,476,51076,40804,48,0.555898998693949,27,21,"27 - 21","#183013",2,6,"2029"
11,100,234,2029-07-21,1905,9,2,5,"VAN","Vancouver Vandals","home",1,0,"Western Division","PBE",26,23,3,"26 - 23",1,203,228,481,51984,41209,49,0.557810135954417,27,22,"27 - 22","#183013",2,6,"2029"
11,100,239,2029-07-22,1905,9,5,10,"VAN","Vancouver Vandals","home",0,1,"Western Division","PBE",26,24,2,"26 - 24",9,212,233,491,54289,44944,50,0.547086150776455,27,23,"27 - 23","#183013",2,6,"2029"
11,100,244,2029-07-23,1905,9,3,6,"VAN","Vancouver Vandals","home",0,1,"Western Division","PBE",26,25,1,"26 - 25",4,216,236,497,55696,46656,51,0.544161325621385,28,23,"28 - 23","#183013",2,6,"2029"
11,100,249,2029-07-24,1905,9,0,3,"VAN","Vancouver Vandals","home",0,1,"Western Division","PBE",26,26,0,"26 - 26",5,221,236,500,55696,48841,52,0.532787434114237,28,24,"28 - 24","#183013",2,6,"2029"
16,101,303,2029-05-16,1905,9,4,14,"ANC","Anchorage Wheelers","home",0,1,"West Division","MiLPBE",0,1,-1,"0 - 1",6,6,4,14,16,36,1,0.307692307692308,0,1,"0 - 1","#007EF3",2,2,"2029"
16,101,306,2029-05-17,1905,9,11,12,"ANC","Anchorage Wheelers","home",0,1,"West Division","MiLPBE",0,2,-2,"0 - 2",12,18,15,26,225,324,2,0.409836065573771,1,1,"1 - 1","#007EF3",2,2,"2029"
16,101,309,2029-05-18,1905,9,5,8,"ANC","Anchorage Wheelers","home",1,0,"West Division","MiLPBE",1,2,-1,"1 - 2",3,21,20,34,400,441,3,0.475624256837099,1,2,"1 - 2","#007EF3",2,2,"2029"
16,101,312,2029-05-19,1905,9,7,14,"ANC","Anchorage Wheelers","home",0,1,"West Division","MiLPBE",1,3,-2,"1 - 3",12,33,27,48,729,1089,4,0.400990099009901,2,2,"2 - 2","#007EF3",2,2,"2029"
16,101,314,2029-05-21,1905,9,3,9,"ANC","Anchorage Wheelers","home",0,1,"West Division","MiLPBE",1,4,-3,"1 - 4",4,37,30,57,900,1369,5,0.396650506831203,2,3,"2 - 3","#007EF3",2,2,"2029"
16,101,317,2029-05-22,1905,9,4,6,"ANC","Anchorage Wheelers","home",1,0,"West Division","MiLPBE",2,4,-2,"2 - 4",3,40,34,63,1156,1600,6,0.41944847605225,3,3,"3 - 3","#007EF3",2,2,"2029"
16,101,320,2029-05-23,1905,9,3,12,"ANC","Anchorage Wheelers","home",1,0,"West Division","MiLPBE",3,4,-1,"3 - 4",1,41,37,75,1369,1681,7,0.448852459016393,3,4,"3 - 4","#007EF3",2,2,"2029"
16,101,323,2029-05-24,1905,11,4,11,"ANC","Anchorage Wheelers","home",1,0,"West Division","MiLPBE",4,4,0,"4 - 4",3,44,41,86,1681,1936,8,0.464749792645839,4,4,"4 - 4","#007EF3",2,2,"2029"
16,101,327,2029-05-27,1905,9,1,9,"ANC","Anchorage Wheelers","home",0,1,"West Division","MiLPBE",4,5,-1,"4 - 5",8,52,42,95,1764,2704,9,0.394807520143241,4,5,"4 - 5","#007EF3",2,2,"2029"
16,101,330,2029-05-28,1905,9,7,14,"ANC","Anchorage Wheelers","home",1,0,"West Division","MiLPBE",5,5,0,"5 - 5",4,56,49,109,2401,3136,10,0.433628318584071,4,6,"4 - 6","#007EF3",2,2,"2029"
16,101,333,2029-05-29,1905,9,5,13,"ANC","Anchorage Wheelers","home",0,1,"West Division","MiLPBE",5,6,-1,"5 - 6",9,65,54,122,2916,4225,11,0.408346170004201,4,7,"4 - 7","#007EF3",2,2,"2029"
16,101,336,2029-05-30,1905,9,4,10,"ANC","Anchorage Wheelers","home",0,1,"West Division","MiLPBE",5,7,-2,"5 - 7",14,79,58,132,3364,6241,12,0.350234252993233,4,8,"4 - 8","#007EF3",2,2,"2029"
16,101,340,2029-06-02,1905,9,5,14,"ANC","Anchorage Wheelers","away",1,0,"West Division","MiLPBE",6,7,-1,"6 - 7",2,81,63,146,3969,6561,13,0.376923076923077,5,8,"5 - 8","#007EF3",2,2,"2029"
16,101,343,2029-06-03,1905,9,5,11,"ANC","Anchorage Wheelers","away",1,0,"West Division","MiLPBE",7,7,0,"7 - 7",0,81,68,157,4624,6561,14,0.413410818059902,6,8,"6 - 8","#007EF3",2,2,"2029"
16,101,346,2029-06-04,1905,9,12,13,"ANC","Anchorage Wheelers","away",1,0,"West Division","MiLPBE",8,7,1,"8 - 7",7,88,80,170,6400,7744,15,0.452488687782805,7,8,"7 - 8","#007EF3",2,2,"2029"
16,101,349,2029-06-05,1905,9,7,11,"ANC","Anchorage Wheelers","away",1,0,"West Division","MiLPBE",9,7,2,"9 - 7",6,94,87,181,7569,8836,16,0.461383724474246,7,9,"7 - 9","#007EF3",2,2,"2029"
16,101,352,2029-06-08,1905,9,8,13,"ANC","Anchorage Wheelers","home",1,0,"West Division","MiLPBE",10,7,3,"10 - 7",4,98,95,194,9025,9604,17,0.484459713350153,8,9,"8 - 9","#007EF3",2,2,"2029"
16,101,355,2029-06-09,1905,9,2,6,"ANC","Anchorage Wheelers","home",0,1,"West Division","MiLPBE",10,8,2,"10 - 8",5,103,97,200,9409,10609,18,0.47002697572185,8,10,"8 - 10","#007EF3",2,2,"2029"
16,101,358,2029-06-10,1905,9,2,5,"ANC","Anchorage Wheelers","home",0,1,"West Division","MiLPBE",10,9,1,"10 - 9",3,106,99,205,9801,11236,19,0.465893425868708,9,10,"9 - 10","#007EF3",2,2,"2029"
16,101,361,2029-06-11,1905,9,5,5,"ANC","Anchorage Wheelers","home",1,0,"West Division","MiLPBE",11,9,2,"11 - 9",4,110,104,210,10816,12100,20,0.471984639553151,9,11,"9 - 11","#007EF3",2,2,"2029"
16,101,363,2029-06-14,1905,9,1,2,"ANC","Anchorage Wheelers","away",0,1,"West Division","MiLPBE",11,10,1,"11 - 10",3,113,105,212,11025,12769,21,0.463352105572833,10,11,"10 - 11","#007EF3",2,2,"2029"
16,101,366,2029-06-15,1905,9,2,5,"ANC","Anchorage Wheelers","away",1,0,"West Division","MiLPBE",12,10,2,"12 - 10",0,113,107,217,11449,12769,22,0.472747543149723,10,12,"10 - 12","#007EF3",2,2,"2029"
16,101,369,2029-06-16,1905,9,3,11,"ANC","Anchorage Wheelers","away",1,0,"West Division","MiLPBE",13,10,3,"13 - 10",2,115,110,228,12100,13225,23,0.477788746298124,11,12,"11 - 12","#007EF3",2,2,"2029"
16,101,372,2029-06-17,1905,9,4,10,"ANC","Anchorage Wheelers","away",0,1,"West Division","MiLPBE",13,11,2,"13 - 11",5,120,114,238,12996,14400,24,0.474375821287779,11,13,"11 - 13","#007EF3",2,2,"2029"
16,101,374,2029-06-20,1905,9,2,6,"ANC","Anchorage Wheelers","away",0,1,"West Division","MiLPBE",13,12,1,"13 - 12",5,125,116,244,13456,15625,25,0.462707609779581,12,13,"12 - 13","#007EF3",2,2,"2029"
16,101,377,2029-06-21,1905,9,4,10,"ANC","Anchorage Wheelers","away",1,0,"West Division","MiLPBE",14,12,2,"14 - 12",3,128,120,254,14400,16384,26,0.467775467775468,12,14,"12 - 14","#007EF3",2,2,"2029"
16,101,380,2029-06-22,1905,9,8,14,"ANC","Anchorage Wheelers","away",1,0,"West Division","MiLPBE",15,12,3,"15 - 12",0,128,128,268,16384,16384,27,0.5,14,13,"14 - 13","#007EF3",2,2,"2029"
16,101,509,2029-06-23,1905,9,4,8,"ANC","Anchorage Wheelers","away",1,0,"West Division","MiLPBE",16,12,4,"16 - 12",3,131,132,276,17424,17161,28,0.503802226398728,14,14,"14 - 14","#007EF3",2,2,"2029"
16,101,514,2029-07-15,1905,9,4,11,"ANC","Anchorage Wheelers","home",1,0,"West Division","MiLPBE",17,12,5,"17 - 12",1,132,136,287,18496,17424,29,0.514922048997773,15,14,"15 - 14","#007EF3",2,2,"2029"
16,101,516,2029-06-25,1905,9,10,12,"ANC","Anchorage Wheelers","away",1,0,"West Division","MiLPBE",18,12,6,"18 - 12",8,140,146,299,21316,19600,30,0.520969791768501,16,14,"16 - 14","#007EF3",2,2,"2029"
16,101,519,2029-06-26,1905,9,8,11,"ANC","Anchorage Wheelers","away",1,0,"West Division","MiLPBE",19,12,7,"19 - 12",3,143,154,310,23716,20449,31,0.536986301369863,17,14,"17 - 14","#007EF3",2,2,"2029"
16,101,522,2029-06-27,1905,9,6,8,"ANC","Anchorage Wheelers","away",0,1,"West Division","MiLPBE",19,13,6,"19 - 13",12,155,160,318,25600,24025,32,0.515869017632242,17,15,"17 - 15","#007EF3",2,2,"2029"
16,101,525,2029-06-28,1905,9,0,2,"ANC","Anchorage Wheelers","away",0,1,"West Division","MiLPBE",19,14,5,"19 - 14",8,163,160,320,25600,26569,33,0.490712875462439,16,17,"16 - 17","#007EF3",2,2,"2029"
16,101,529,2029-07-01,1905,9,6,13,"ANC","Anchorage Wheelers","home",1,0,"West Division","MiLPBE",20,14,6,"20 - 14",5,168,166,333,27556,28224,34,0.494012190749373,17,17,"17 - 17","#007EF3",2,2,"2029"
16,101,532,2029-07-02,1905,9,12,14,"ANC","Anchorage Wheelers","home",1,0,"West Division","MiLPBE",21,14,7,"21 - 14",0,168,178,347,31684,28224,35,0.52887761233892,19,16,"19 - 16","#007EF3",2,2,"2029"
16,101,535,2029-07-03,1905,9,6,12,"ANC","Anchorage Wheelers","home",1,0,"West Division","MiLPBE",22,14,8,"22 - 14",3,171,184,359,33856,29241,36,0.536570676894306,19,17,"19 - 17","#007EF3",2,2,"2029"
16,101,538,2029-07-04,1905,9,15,23,"ANC","Anchorage Wheelers","home",1,0,"West Division","MiLPBE",23,14,9,"23 - 14",6,177,199,382,39601,31329,37,0.558311010855773,21,16,"21 - 16","#007EF3",2,2,"2029"
16,101,541,2029-07-07,1905,9,5,10,"ANC","Anchorage Wheelers","away",1,0,"West Division","MiLPBE",24,14,10,"24 - 14",0,177,204,392,41616,31329,38,0.570512029611351,22,16,"22 - 16","#007EF3",2,2,"2029"
16,101,544,2029-07-08,1905,9,4,11,"ANC","Anchorage Wheelers","away",0,1,"West Division","MiLPBE",24,15,9,"24 - 15",5,182,208,403,43264,33124,39,0.566371681415929,22,17,"22 - 17","#007EF3",2,2,"2029"
16,101,547,2029-07-09,1905,9,3,6,"ANC","Anchorage Wheelers","away",0,1,"West Division","MiLPBE",24,16,8,"24 - 16",6,188,211,409,44521,35344,40,0.557453202278846,22,18,"22 - 18","#007EF3",2,2,"2029"
16,101,550,2029-07-10,1905,9,4,10,"ANC","Anchorage Wheelers","away",0,1,"West Division","MiLPBE",24,17,7,"24 - 17",5,193,215,419,46225,37249,41,0.553765244267676,23,18,"23 - 18","#007EF3",2,2,"2029"
16,101,552,2029-07-12,1905,11,5,10,"ANC","Anchorage Wheelers","home",0,1,"West Division","MiLPBE",24,18,6,"24 - 18",8,201,220,429,48400,40401,42,0.545038907219513,23,19,"23 - 19","#007EF3",2,2,"2029"
16,101,555,2029-07-13,1905,9,1,8,"ANC","Anchorage Wheelers","home",0,1,"West Division","MiLPBE",24,19,5,"24 - 19",7,208,221,437,48841,43264,43,0.530275229357798,23,20,"23 - 20","#007EF3",2,2,"2029"
16,101,558,2029-07-14,1905,9,6,10,"ANC","Anchorage Wheelers","home",1,0,"West Division","MiLPBE",25,19,6,"25 - 19",4,212,227,447,51529,44944,44,0.534128719952733,24,20,"24 - 20","#007EF3",2,2,"2029"
16,101,560,2029-07-18,1905,9,2,5,"ANC","Anchorage Wheelers","home",0,1,"West Division","MiLPBE",25,20,5,"25 - 20",5,217,229,452,52441,47089,45,0.526886365919823,24,21,"24 - 21","#007EF3",2,2,"2029"
16,101,563,2029-07-19,1905,9,7,14,"ANC","Anchorage Wheelers","home",0,1,"West Division","MiLPBE",25,21,4,"25 - 21",9,226,236,466,55696,51076,46,0.521634885550519,24,22,"24 - 22","#007EF3",2,2,"2029"
16,101,566,2029-07-20,1905,10,2,9,"ANC","Anchorage Wheelers","home",0,1,"West Division","MiLPBE",25,22,3,"25 - 22",5,231,238,475,56644,53361,47,0.514922048997773,24,23,"24 - 23","#007EF3",2,2,"2029"
16,101,569,2029-07-21,1905,9,4,10,"ANC","Anchorage Wheelers","home",0,1,"West Division","MiLPBE",25,23,2,"25 - 23",15,246,242,485,58564,60516,48,0.491803829358414,24,24,"24 - 24","#007EF3",2,2,"2029"
16,101,574,2029-07-24,1905,9,9,13,"ANC","Anchorage Wheelers","away",1,0,"West Division","MiLPBE",26,23,3,"26 - 23",2,248,251,498,63001,61504,49,0.506011806754749,25,24,"25 - 24","#007EF3",2,2,"2029"
16,101,577,2029-07-25,1905,9,3,5,"ANC","Anchorage Wheelers","away",0,1,"West Division","MiLPBE",26,24,2,"26 - 24",9,257,254,503,64516,66049,50,0.494129360854747,25,25,"25 - 25","#007EF3",2,2,"2029"
16,101,580,2029-07-26,1905,9,7,13,"ANC","Anchorage Wheelers","away",1,0,"West Division","MiLPBE",27,24,3,"27 - 24",2,259,261,516,68121,67081,51,0.503846096951229,26,25,"26 - 25","#007EF3",2,2,"2029"
16,101,583,2029-07-27,1905,9,4,13,"ANC","Anchorage Wheelers","away",1,0,"West Division","MiLPBE",28,24,4,"28 - 24",3,262,265,529,70225,68644,52,0.50569241515385,26,26,"26 - 26","#007EF3",2,2,"2029"
17,101,303,2029-05-16,1905,9,6,13,"KGN","Kingston Mounties","away",1,0,"East Division","MiLPBE",1,0,1,"1 - 0",4,4,6,13,36,16,1,0.692307692307692,1,0,"1 - 0","#6C0000",2,4,"2029"
17,101,306,2029-05-17,1905,9,12,13,"KGN","Kingston Mounties","away",1,0,"East Division","MiLPBE",2,0,2,"2 - 0",11,15,18,26,324,225,2,0.590163934426229,1,1,"1 - 1","#6C0000",2,4,"2029"
17,101,309,2029-05-18,1905,9,3,10,"KGN","Kingston Mounties","away",0,1,"East Division","MiLPBE",2,1,1,"2 - 1",5,20,21,36,441,400,3,0.524375743162901,2,1,"2 - 1","#6C0000",2,4,"2029"
17,101,312,2029-05-19,1905,9,12,12,"KGN","Kingston Mounties","away",1,0,"East Division","MiLPBE",3,1,2,"3 - 1",7,27,33,48,1089,729,4,0.599009900990099,2,2,"2 - 2","#6C0000",2,4,"2029"
17,101,316,2029-05-21,1905,9,3,9,"KGN","Kingston Mounties","home",0,1,"East Division","MiLPBE",3,2,1,"3 - 2",10,37,36,57,1296,1369,5,0.486303939962477,2,3,"2 - 3","#6C0000",2,4,"2029"
17,101,319,2029-05-22,1905,9,1,9,"KGN","Kingston Mounties","home",0,1,"East Division","MiLPBE",3,3,0,"3 - 3",14,51,37,66,1369,2601,6,0.344836272040302,2,4,"2 - 4","#6C0000",2,4,"2029"
17,101,322,2029-05-23,1905,9,1,6,"KGN","Kingston Mounties","home",0,1,"East Division","MiLPBE",3,4,-1,"3 - 4",3,54,38,72,1444,2916,7,0.331192660550459,2,5,"2 - 5","#6C0000",2,4,"2029"
17,101,325,2029-05-24,1905,9,14,14,"KGN","Kingston Mounties","home",1,0,"East Division","MiLPBE",4,4,0,"4 - 4",5,59,52,86,2704,3481,8,0.437186742118027,3,5,"3 - 5","#6C0000",2,4,"2029"
17,101,328,2029-05-27,1905,9,4,11,"KGN","Kingston Mounties","home",1,0,"East Division","MiLPBE",5,4,1,"5 - 4",1,60,56,97,3136,3600,9,0.465558194774347,4,5,"4 - 5","#6C0000",2,4,"2029"
17,101,331,2029-05-28,1905,9,4,8,"KGN","Kingston Mounties","home",0,1,"East Division","MiLPBE",5,5,0,"5 - 5",8,68,60,105,3600,4624,10,0.437743190661479,4,6,"4 - 6","#6C0000",2,4,"2029"
17,101,334,2029-05-29,1905,9,2,8,"KGN","Kingston Mounties","home",1,0,"East Division","MiLPBE",6,5,1,"6 - 5",1,69,62,113,3844,4761,11,0.446717024985474,5,6,"5 - 6","#6C0000",2,4,"2029"
17,101,337,2029-05-30,1905,9,3,6,"KGN","Kingston Mounties","home",0,1,"East Division","MiLPBE",6,6,0,"6 - 6",4,73,65,119,4225,5329,12,0.442223152606238,5,7,"5 - 7","#6C0000",2,4,"2029"
17,101,339,2029-06-02,1905,9,0,8,"KGN","Kingston Mounties","away",0,1,"East Division","MiLPBE",6,7,-1,"6 - 7",4,77,65,127,4225,5929,13,0.416092180421509,5,8,"5 - 8","#6C0000",2,4,"2029"
17,101,342,2029-06-03,1905,9,3,13,"KGN","Kingston Mounties","away",1,0,"East Division","MiLPBE",7,7,0,"7 - 7",2,79,68,140,4624,6241,14,0.425586746433502,6,8,"6 - 8","#6C0000",2,4,"2029"
17,101,345,2029-06-04,1905,9,3,8,"KGN","Kingston Mounties","away",0,1,"East Division","MiLPBE",7,8,-1,"7 - 8",8,87,71,148,5041,7569,15,0.399762093576527,6,9,"6 - 9","#6C0000",2,4,"2029"
17,101,348,2029-06-05,1905,9,5,13,"KGN","Kingston Mounties","away",1,0,"East Division","MiLPBE",8,8,0,"8 - 8",0,87,76,161,5776,7569,16,0.432821281378794,7,9,"7 - 9","#6C0000",2,4,"2029"
17,101,350,2029-06-08,1905,9,3,3,"KGN","Kingston Mounties","away",0,1,"East Division","MiLPBE",8,9,-1,"8 - 9",5,92,79,164,6241,8464,17,0.424413464807888,7,10,"7 - 10","#6C0000",2,4,"2029"
17,101,353,2029-06-09,1905,9,3,11,"KGN","Kingston Mounties","away",0,1,"East Division","MiLPBE",8,10,-2,"8 - 10",5,97,82,175,6724,9409,18,0.41678547077419,8,10,"8 - 10","#6C0000",2,4,"2029"
17,101,356,2029-06-10,1905,9,7,9,"KGN","Kingston Mounties","away",1,0,"East Division","MiLPBE",9,10,-1,"9 - 10",5,102,89,184,7921,10404,19,0.43225102319236,8,11,"8 - 11","#6C0000",2,4,"2029"
17,101,359,2029-06-11,1905,9,1,6,"KGN","Kingston Mounties","away",1,0,"East Division","MiLPBE",10,10,0,"10 - 10",0,102,90,190,8100,10404,20,0.437743190661479,9,11,"9 - 11","#6C0000",2,4,"2029"
17,101,363,2029-06-14,1905,9,3,10,"KGN","Kingston Mounties","home",1,0,"East Division","MiLPBE",11,10,1,"11 - 10",1,103,93,200,8649,10609,21,0.449112057326825,9,12,"9 - 12","#6C0000",2,4,"2029"
17,101,366,2029-06-15,1905,9,0,2,"KGN","Kingston Mounties","home",0,1,"East Division","MiLPBE",11,11,0,"11 - 11",2,105,93,202,8649,11025,22,0.439615736505032,10,12,"10 - 12","#6C0000",2,4,"2029"
17,101,369,2029-06-16,1905,9,2,7,"KGN","Kingston Mounties","home",0,1,"East Division","MiLPBE",11,12,-1,"11 - 12",3,108,95,209,9025,11664,23,0.436222147034656,10,13,"10 - 13","#6C0000",2,4,"2029"
17,101,372,2029-06-17,1905,9,5,8,"KGN","Kingston Mounties","home",1,0,"East Division","MiLPBE",12,12,0,"12 - 12",4,112,100,217,10000,12544,24,0.443577004968062,11,13,"11 - 13","#6C0000",2,4,"2029"
17,101,376,2029-06-20,1905,9,4,12,"KGN","Kingston Mounties","away",0,1,"East Division","MiLPBE",12,13,-1,"12 - 13",6,118,104,229,10816,13924,25,0.437186742118027,11,14,"11 - 14","#6C0000",2,4,"2029"
17,101,379,2029-06-21,1905,9,1,8,"KGN","Kingston Mounties","away",0,1,"East Division","MiLPBE",12,14,-2,"12 - 14",2,120,105,237,11025,14400,26,0.433628318584071,11,15,"11 - 15","#6C0000",2,4,"2029"
17,101,508,2029-06-22,1905,9,9,13,"KGN","Kingston Mounties","away",1,0,"East Division","MiLPBE",13,14,-1,"13 - 14",6,126,114,250,12996,15876,27,0.450124688279302,12,15,"12 - 15","#6C0000",2,4,"2029"
17,101,511,2029-06-23,1905,9,6,10,"KGN","Kingston Mounties","away",1,0,"East Division","MiLPBE",14,14,0,"14 - 14",5,131,120,260,14400,17161,28,0.456259307373024,13,15,"13 - 15","#6C0000",2,4,"2029"
17,101,514,2029-07-15,1905,9,1,8,"KGN","Kingston Mounties","away",0,1,"East Division","MiLPBE",14,15,-1,"14 - 15",4,135,121,268,14641,18225,29,0.445475567455729,13,16,"13 - 16","#6C0000",2,4,"2029"
17,101,517,2029-06-25,1905,9,2,7,"KGN","Kingston Mounties","away",0,1,"East Division","MiLPBE",14,16,-2,"14 - 16",5,140,123,275,15129,19600,30,0.435630164991794,13,17,"13 - 17","#6C0000",2,4,"2029"
17,101,520,2029-06-26,1905,9,2,11,"KGN","Kingston Mounties","away",0,1,"East Division","MiLPBE",14,17,-3,"14 - 17",4,144,125,286,15625,20736,31,0.429718654602459,13,18,"13 - 18","#6C0000",2,4,"2029"
17,101,523,2029-06-27,1905,9,8,8,"KGN","Kingston Mounties","away",1,0,"East Division","MiLPBE",15,17,-2,"15 - 17",5,149,133,294,17689,22201,32,0.443444472298822,14,18,"14 - 18","#6C0000",2,4,"2029"
17,101,526,2029-06-28,1905,9,7,8,"KGN","Kingston Mounties","away",1,0,"East Division","MiLPBE",16,17,-1,"16 - 17",3,152,140,302,19600,23104,33,0.458973398276508,15,18,"15 - 18","#6C0000",2,4,"2029"
17,101,528,2029-07-01,1905,9,11,16,"KGN","Kingston Mounties","home",1,0,"East Division","MiLPBE",17,17,0,"17 - 17",5,157,151,318,22801,24649,34,0.480526870389884,16,18,"16 - 18","#6C0000",2,4,"2029"
17,101,531,2029-07-02,1905,9,6,9,"KGN","Kingston Mounties","home",1,0,"East Division","MiLPBE",18,17,1,"18 - 17",5,162,157,327,24649,26244,35,0.484329868547737,17,18,"17 - 18","#6C0000",2,4,"2029"
17,101,534,2029-07-03,1905,9,10,15,"KGN","Kingston Mounties","home",1,0,"East Division","MiLPBE",19,17,2,"19 - 17",1,163,167,342,27889,26569,36,0.512119431488486,18,18,"18 - 18","#6C0000",2,4,"2029"
17,101,537,2029-07-04,1905,9,8,9,"KGN","Kingston Mounties","home",1,0,"East Division","MiLPBE",20,17,3,"20 - 17",7,170,175,351,30625,28900,37,0.514489710205796,19,18,"19 - 18","#6C0000",2,4,"2029"
17,101,539,2029-07-07,1905,9,2,4,"KGN","Kingston Mounties","home",0,1,"East Division","MiLPBE",20,18,2,"20 - 18",7,177,177,355,31329,31329,38,0.5,19,19,"19 - 19","#6C0000",2,4,"2029"
17,101,542,2029-07-08,1905,9,4,11,"KGN","Kingston Mounties","home",1,0,"East Division","MiLPBE",21,18,3,"21 - 18",0,177,181,366,32761,31329,39,0.511171789670775,20,19,"20 - 19","#6C0000",2,4,"2029"
17,101,545,2029-07-09,1905,9,3,8,"KGN","Kingston Mounties","home",0,1,"East Division","MiLPBE",21,19,2,"21 - 19",7,184,184,374,33856,33856,40,0.5,20,20,"20 - 20","#6C0000",2,4,"2029"
17,101,548,2029-07-10,1905,12,4,11,"KGN","Kingston Mounties","home",1,0,"East Division","MiLPBE",22,19,3,"22 - 19",3,187,188,385,35344,34969,41,0.502666647703839,21,20,"21 - 20","#6C0000",2,4,"2029"
17,101,552,2029-07-12,1905,11,8,15,"KGN","Kingston Mounties","away",1,0,"East Division","MiLPBE",23,19,4,"23 - 19",5,192,196,400,38416,36864,42,0.510308182784272,21,21,"21 - 21","#6C0000",2,4,"2029"
17,101,555,2029-07-13,1905,9,7,14,"KGN","Kingston Mounties","away",1,0,"East Division","MiLPBE",24,19,5,"24 - 19",1,193,203,414,41209,37249,43,0.525236432231257,23,20,"23 - 20","#6C0000",2,4,"2029"
17,101,558,2029-07-14,1905,9,4,7,"KGN","Kingston Mounties","away",0,1,"East Division","MiLPBE",24,20,4,"24 - 20",6,199,207,421,42849,39601,44,0.519696785930867,23,21,"23 - 21","#6C0000",2,4,"2029"
17,101,562,2029-07-18,1905,9,6,10,"KGN","Kingston Mounties","home",0,1,"East Division","MiLPBE",24,21,3,"24 - 21",8,207,213,431,45369,42849,45,0.514282799428688,23,22,"23 - 22","#6C0000",2,4,"2029"
17,101,565,2029-07-19,1905,9,1,6,"KGN","Kingston Mounties","home",0,1,"East Division","MiLPBE",24,22,2,"24 - 22",3,210,214,437,45796,44100,46,0.509433122719587,23,23,"23 - 23","#6C0000",2,4,"2029"
17,101,568,2029-07-20,1905,9,8,12,"KGN","Kingston Mounties","home",1,0,"East Division","MiLPBE",25,22,3,"25 - 22",3,213,222,449,49284,45369,47,0.520680802510222,24,23,"24 - 23","#6C0000",2,4,"2029"
17,101,571,2029-07-21,1905,9,2,3,"KGN","Kingston Mounties","home",0,1,"East Division","MiLPBE",25,23,2,"25 - 23",6,219,224,452,50176,47961,48,0.511285244097537,25,23,"25 - 23","#6C0000",2,4,"2029"
17,101,572,2029-07-24,1905,9,5,9,"KGN","Kingston Mounties","home",0,1,"East Division","MiLPBE",25,24,1,"25 - 24",6,225,229,461,52441,50625,49,0.508809888809113,25,24,"25 - 24","#6C0000",2,4,"2029"
17,101,575,2029-07-25,1905,9,8,12,"KGN","Kingston Mounties","home",1,0,"East Division","MiLPBE",26,24,2,"26 - 24",1,226,237,473,56169,51076,50,0.523744696722458,26,24,"26 - 24","#6C0000",2,4,"2029"
17,101,578,2029-07-26,1905,9,2,7,"KGN","Kingston Mounties","home",0,1,"East Division","MiLPBE",26,25,1,"26 - 25",5,231,239,480,57121,53361,51,0.51701634655419,26,25,"26 - 25","#6C0000",2,4,"2029"
17,101,581,2029-07-27,1905,10,1,7,"KGN","Kingston Mounties","home",0,1,"East Division","MiLPBE",26,26,0,"26 - 26",2,233,240,487,57600,54289,52,0.514795913807434,27,25,"27 - 25","#6C0000",2,4,"2029"
18,101,304,2029-05-16,1905,9,2,8,"SCSS","State College Swift Steeds ","away",0,1,"East Division","MiLPBE",0,1,-1,"0 - 1",4,4,2,8,4,16,1,0.2,0,1,"0 - 1","#115376",1,1,"2029"
18,101,307,2029-05-17,1905,9,4,12,"SCSS","State College Swift Steeds ","away",0,1,"East Division","MiLPBE",0,2,-2,"0 - 2",5,9,6,20,36,81,2,0.307692307692308,1,1,"1 - 1","#115376",1,1,"2029"
18,101,310,2029-05-18,1905,9,9,13,"SCSS","State College Swift Steeds ","away",1,0,"East Division","MiLPBE",1,2,-1,"1 - 2",4,13,15,33,225,169,3,0.571065989847716,2,1,"2 - 1","#115376",1,1,"2029"
18,101,313,2029-05-19,1905,14,7,14,"SCSS","State College Swift Steeds ","away",1,0,"East Division","MiLPBE",2,2,0,"2 - 2",6,19,22,47,484,361,4,0.572781065088757,2,2,"2 - 2","#115376",1,1,"2029"
18,101,316,2029-05-21,1905,9,10,14,"SCSS","State College Swift Steeds ","away",1,0,"East Division","MiLPBE",3,2,1,"3 - 2",3,22,32,61,1024,484,5,0.679045092838196,3,2,"3 - 2","#115376",1,1,"2029"
18,101,319,2029-05-22,1905,9,14,14,"SCSS","State College Swift Steeds ","away",1,0,"East Division","MiLPBE",4,2,2,"4 - 2",1,23,46,75,2116,529,6,0.8,5,1,"5 - 1","#115376",1,1,"2029"
18,101,322,2029-05-23,1905,9,3,5,"SCSS","State College Swift Steeds ","away",1,0,"East Division","MiLPBE",5,2,3,"5 - 2",1,24,49,80,2401,576,7,0.806516627477326,6,1,"6 - 1","#115376",1,1,"2029"
18,101,325,2029-05-24,1905,9,5,7,"SCSS","State College Swift Steeds ","away",0,1,"East Division","MiLPBE",5,3,2,"5 - 3",14,38,54,87,2916,1444,8,0.668807339449541,5,3,"5 - 3","#115376",1,1,"2029"
18,101,327,2029-05-27,1905,9,8,14,"SCSS","State College Swift Steeds ","away",1,0,"East Division","MiLPBE",6,3,3,"6 - 3",1,39,62,101,3844,1521,9,0.716495806150979,6,3,"6 - 3","#115376",1,1,"2029"
18,101,330,2029-05-28,1905,9,4,9,"SCSS","State College Swift Steeds ","away",0,1,"East Division","MiLPBE",6,4,2,"6 - 4",7,46,66,110,4356,2116,10,0.673053152039555,7,3,"7 - 3","#115376",1,1,"2029"
18,101,333,2029-05-29,1905,9,9,12,"SCSS","State College Swift Steeds ","away",1,0,"East Division","MiLPBE",7,4,3,"7 - 4",5,51,75,122,5625,2601,11,0.683807439824945,8,3,"8 - 3","#115376",1,1,"2029"
18,101,336,2029-05-30,1905,9,14,16,"SCSS","State College Swift Steeds ","away",1,0,"East Division","MiLPBE",8,4,4,"8 - 4",4,55,89,138,7921,3025,12,0.723643340032889,9,3,"9 - 3","#115376",1,1,"2029"
18,101,338,2029-06-02,1905,9,1,4,"SCSS","State College Swift Steeds ","away",1,0,"East Division","MiLPBE",9,4,5,"9 - 4",0,55,90,142,8100,3025,13,0.728089887640449,9,4,"9 - 4","#115376",1,1,"2029"
18,101,341,2029-06-03,1905,10,6,9,"SCSS","State College Swift Steeds ","away",1,0,"East Division","MiLPBE",10,4,6,"10 - 4",5,60,96,151,9216,3600,14,0.719101123595506,10,4,"10 - 4","#115376",1,1,"2029"
18,101,344,2029-06-04,1905,9,8,11,"SCSS","State College Swift Steeds ","away",0,1,"East Division","MiLPBE",10,5,5,"10 - 5",11,71,104,162,10816,5041,15,0.682096235101217,10,5,"10 - 5","#115376",1,1,"2029"
18,101,347,2029-06-05,1905,10,7,9,"SCSS","State College Swift Steeds ","away",0,1,"East Division","MiLPBE",10,6,4,"10 - 6",8,79,111,171,12321,6241,16,0.663775455231117,11,5,"11 - 5","#115376",1,1,"2029"
18,101,351,2029-06-08,1905,9,2,12,"SCSS","State College Swift Steeds ","away",0,1,"East Division","MiLPBE",10,7,3,"10 - 7",4,83,113,183,12769,6889,17,0.649557432088717,11,6,"11 - 6","#115376",1,1,"2029"
18,101,354,2029-06-09,1905,9,7,16,"SCSS","State College Swift Steeds ","away",1,0,"East Division","MiLPBE",11,7,4,"11 - 7",4,87,120,199,14400,7569,18,0.655469070053257,12,6,"12 - 6","#115376",1,1,"2029"
18,101,357,2029-06-10,1905,9,16,19,"SCSS","State College Swift Steeds ","away",1,0,"East Division","MiLPBE",12,7,5,"12 - 7",4,91,136,218,18496,8281,19,0.690742054748478,13,6,"13 - 6","#115376",1,1,"2029"
18,101,360,2029-06-11,1905,9,10,15,"SCSS","State College Swift Steeds ","away",1,0,"East Division","MiLPBE",13,7,6,"13 - 7",1,92,146,233,21316,8464,20,0.715782404298187,14,6,"14 - 6","#115376",1,1,"2029"
18,101,364,2029-06-14,1905,9,8,11,"SCSS","State College Swift Steeds ","home",1,0,"East Division","MiLPBE",14,7,7,"14 - 7",0,92,154,244,23716,8464,21,0.736979490366687,15,6,"15 - 6","#115376",1,1,"2029"
18,101,367,2029-06-15,1905,10,6,10,"SCSS","State College Swift Steeds ","home",1,0,"East Division","MiLPBE",15,7,8,"15 - 7",5,97,160,254,25600,9409,22,0.731240538147334,16,6,"16 - 6","#115376",1,1,"2029"
18,101,370,2029-06-16,1905,9,3,10,"SCSS","State College Swift Steeds ","home",0,1,"East Division","MiLPBE",15,8,7,"15 - 8",5,102,163,264,26569,10404,23,0.718605468855651,17,6,"17 - 6","#115376",1,1,"2029"
18,101,373,2029-06-17,1905,9,7,10,"SCSS","State College Swift Steeds ","home",1,0,"East Division","MiLPBE",16,8,8,"16 - 8",4,106,170,274,28900,11236,24,0.720051823799083,17,7,"17 - 7","#115376",1,1,"2029"
18,101,376,2029-06-20,1905,9,6,11,"SCSS","State College Swift Steeds ","home",1,0,"East Division","MiLPBE",17,8,9,"17 - 8",4,110,176,285,30976,12100,25,0.719101123595506,18,7,"18 - 7","#115376",1,1,"2029"
18,101,379,2029-06-21,1905,9,2,8,"SCSS","State College Swift Steeds ","home",1,0,"East Division","MiLPBE",18,8,10,"18 - 8",1,111,178,293,31684,12321,26,0.72000908987615,19,7,"19 - 7","#115376",1,1,"2029"
18,101,508,2029-06-22,1905,9,6,9,"SCSS","State College Swift Steeds ","home",0,1,"East Division","MiLPBE",18,9,9,"18 - 9",9,120,184,302,33856,14400,27,0.70159151193634,19,8,"19 - 8","#115376",1,1,"2029"
18,101,511,2029-06-23,1905,9,5,12,"SCSS","State College Swift Steeds ","home",0,1,"East Division","MiLPBE",18,10,8,"18 - 10",6,126,189,314,35721,15876,28,0.692307692307692,19,9,"19 - 9","#115376",1,1,"2029"
18,101,512,2029-07-15,1405,9,10,17,"SCSS","State College Swift Steeds ","away",1,0,"East Division","MiLPBE",19,10,9,"19 - 10",2,128,199,331,39601,16384,29,0.707350183084755,21,8,"21 - 8","#115376",1,1,"2029"
18,101,516,2029-06-25,1905,9,8,12,"SCSS","State College Swift Steeds ","home",0,1,"East Division","MiLPBE",19,11,8,"19 - 11",10,138,207,343,42849,19044,30,0.692307692307692,21,9,"21 - 9","#115376",1,1,"2029"
18,101,519,2029-06-26,1905,9,3,8,"SCSS","State College Swift Steeds ","home",0,1,"East Division","MiLPBE",19,12,7,"19 - 12",8,146,210,351,44100,21316,31,0.674146997676409,21,10,"21 - 10","#115376",1,1,"2029"
18,101,522,2029-06-27,1905,9,12,15,"SCSS","State College Swift Steeds ","home",1,0,"East Division","MiLPBE",20,12,8,"20 - 12",6,152,222,366,49284,23104,32,0.680831076974084,22,10,"22 - 10","#115376",1,1,"2029"
18,101,525,2029-06-28,1905,9,8,11,"SCSS","State College Swift Steeds ","home",1,0,"East Division","MiLPBE",21,12,9,"21 - 12",0,152,230,377,52900,23104,33,0.696015999157939,23,10,"23 - 10","#115376",1,1,"2029"
18,101,527,2029-07-01,1905,10,6,11,"SCSS","State College Swift Steeds ","home",1,0,"East Division","MiLPBE",22,12,10,"22 - 12",5,157,236,388,55696,24649,34,0.693210529591138,24,10,"24 - 10","#115376",1,1,"2029"
18,101,530,2029-07-02,1905,9,7,13,"SCSS","State College Swift Steeds ","home",1,0,"East Division","MiLPBE",23,12,11,"23 - 12",3,160,243,401,59049,25600,35,0.697574690781935,24,11,"24 - 11","#115376",1,1,"2029"
18,101,533,2029-07-03,1905,9,2,3,"SCSS","State College Swift Steeds ","home",1,0,"East Division","MiLPBE",24,12,12,"24 - 12",1,161,245,404,60025,25921,36,0.698403648802737,25,11,"25 - 11","#115376",1,1,"2029"
18,101,536,2029-07-04,1905,9,6,11,"SCSS","State College Swift Steeds ","home",1,0,"East Division","MiLPBE",25,12,13,"25 - 12",3,164,251,415,63001,26896,37,0.700813152830462,26,11,"26 - 11","#115376",1,1,"2029"
18,101,540,2029-07-07,1905,9,2,6,"SCSS","State College Swift Steeds ","home",0,1,"East Division","MiLPBE",25,13,12,"25 - 13",5,169,253,421,64009,28561,38,0.691465917683915,26,12,"26 - 12","#115376",1,1,"2029"
18,101,543,2029-07-08,1905,9,5,12,"SCSS","State College Swift Steeds ","home",0,1,"East Division","MiLPBE",25,14,11,"25 - 14",14,183,258,433,66564,33489,39,0.66528739767923,26,13,"26 - 13","#115376",1,1,"2029"
18,101,546,2029-07-09,1905,9,9,14,"SCSS","State College Swift Steeds ","home",1,0,"East Division","MiLPBE",26,14,12,"26 - 14",4,187,267,447,71289,34969,40,0.670904778934292,27,13,"27 - 13","#115376",1,1,"2029"
18,101,549,2029-07-10,1905,9,11,16,"SCSS","State College Swift Steeds ","home",1,0,"East Division","MiLPBE",27,14,13,"27 - 14",5,192,278,463,77284,36864,41,0.677050846269755,28,13,"28 - 13","#115376",1,1,"2029"
18,101,553,2029-07-12,1905,9,4,8,"SCSS","State College Swift Steeds ","away",1,0,"East Division","MiLPBE",28,14,14,"28 - 14",3,195,282,471,79524,38025,42,0.676517877651022,28,14,"28 - 14","#115376",1,1,"2029"
18,101,556,2029-07-13,1905,9,4,14,"SCSS","State College Swift Steeds ","away",0,1,"East Division","MiLPBE",28,15,13,"28 - 15",6,201,286,485,81796,40401,43,0.669378135306104,29,14,"29 - 14","#115376",1,1,"2029"
18,101,559,2029-07-14,1905,9,11,14,"SCSS","State College Swift Steeds ","away",1,0,"East Division","MiLPBE",29,15,14,"29 - 15",3,204,297,499,88209,41616,44,0.679445407279029,30,14,"30 - 14","#115376",1,1,"2029"
18,101,562,2029-07-18,1905,9,8,12,"SCSS","State College Swift Steeds ","away",1,0,"East Division","MiLPBE",30,15,15,"30 - 15",6,210,305,511,93025,44100,45,0.678395624430264,31,14,"31 - 14","#115376",1,1,"2029"
18,101,565,2029-07-19,1905,9,3,8,"SCSS","State College Swift Steeds ","away",1,0,"East Division","MiLPBE",31,15,16,"31 - 15",1,211,308,519,94864,44521,46,0.680589733472038,31,15,"31 - 15","#115376",1,1,"2029"
18,101,568,2029-07-20,1905,9,3,6,"SCSS","State College Swift Steeds ","away",0,1,"East Division","MiLPBE",31,16,15,"31 - 16",8,219,311,525,96721,47961,47,0.668507485381734,31,16,"31 - 16","#115376",1,1,"2029"
18,101,571,2029-07-21,1905,9,6,10,"SCSS","State College Swift Steeds ","away",1,0,"East Division","MiLPBE",32,16,16,"32 - 16",2,221,317,535,100489,48841,48,0.672932431527489,32,16,"32 - 16","#115376",1,1,"2029"
18,101,573,2029-07-24,1905,9,6,12,"SCSS","State College Swift Steeds ","home",1,0,"East Division","MiLPBE",33,16,17,"33 - 16",2,223,323,547,104329,49729,49,0.677205987355412,33,16,"33 - 16","#115376",1,1,"2029"
18,101,576,2029-07-25,1905,9,5,15,"SCSS","State College Swift Steeds ","home",0,1,"East Division","MiLPBE",33,17,16,"33 - 17",6,229,328,562,107584,52441,50,0.672294953913451,34,16,"34 - 16","#115376",1,1,"2029"
18,101,579,2029-07-26,1905,9,9,11,"SCSS","State College Swift Steeds ","home",1,0,"East Division","MiLPBE",34,17,17,"34 - 17",7,236,337,573,113569,55696,51,0.670953829793519,34,17,"34 - 17","#115376",1,1,"2029"
18,101,582,2029-07-27,1905,9,6,13,"SCSS","State College Swift Steeds ","home",1,0,"East Division","MiLPBE",35,17,18,"35 - 17",5,241,343,586,117649,58081,52,0.669487281625221,35,17,"35 - 17","#115376",1,1,"2029"
19,101,302,2029-05-16,1905,9,5,12,"ARM","Amarillo Armadillos","away",1,0,"West Division","MiLPBE",1,0,1,"1 - 0",1,1,5,12,25,1,1,0.961538461538462,1,0,"1 - 0","#86572C",1,2,"2029"
19,101,305,2029-05-17,1905,9,0,3,"ARM","Amarillo Armadillos","away",0,1,"West Division","MiLPBE",1,1,0,"1 - 1",2,3,5,15,25,9,2,0.735294117647059,1,1,"1 - 1","#86572C",1,2,"2029"
19,101,308,2029-05-18,1905,9,2,7,"ARM","Amarillo Armadillos","away",0,1,"West Division","MiLPBE",1,2,-1,"1 - 2",8,11,7,22,49,121,3,0.288235294117647,1,2,"1 - 2","#86572C",1,2,"2029"
19,101,311,2029-05-19,1905,9,9,13,"ARM","Amarillo Armadillos","away",1,0,"West Division","MiLPBE",2,2,0,"2 - 2",4,15,16,35,256,225,4,0.532224532224532,2,2,"2 - 2","#86572C",1,2,"2029"
19,101,314,2029-05-21,1905,9,4,8,"ARM","Amarillo Armadillos","away",1,0,"West Division","MiLPBE",3,2,1,"3 - 2",3,18,20,43,400,324,5,0.552486187845304,3,2,"3 - 2","#86572C",1,2,"2029"
19,101,317,2029-05-22,1905,9,3,9,"ARM","Amarillo Armadillos","away",0,1,"West Division","MiLPBE",3,3,0,"3 - 3",4,22,23,52,529,484,6,0.522211253701876,3,3,"3 - 3","#86572C",1,2,"2029"
19,101,320,2029-05-23,1905,9,1,3,"ARM","Amarillo Armadillos","away",0,1,"West Division","MiLPBE",3,4,-1,"3 - 4",3,25,24,55,576,625,7,0.479600333055787,3,4,"3 - 4","#86572C",1,2,"2029"
19,101,323,2029-05-24,1905,11,3,6,"ARM","Amarillo Armadillos","away",0,1,"West Division","MiLPBE",3,5,-2,"3 - 5",4,29,27,61,729,841,8,0.464331210191083,4,4,"4 - 4","#86572C",1,2,"2029"
19,101,326,2029-05-27,1905,10,3,14,"ARM","Amarillo Armadillos","home",0,1,"West Division","MiLPBE",3,6,-3,"3 - 6",4,33,30,75,900,1089,9,0.452488687782805,4,5,"4 - 5","#86572C",1,2,"2029"
19,101,329,2029-05-28,1905,9,10,16,"ARM","Amarillo Armadillos","home",1,0,"West Division","MiLPBE",4,6,-2,"4 - 6",0,33,40,91,1600,1089,10,0.595016734845668,6,4,"6 - 4","#86572C",1,2,"2029"
19,101,332,2029-05-29,1905,9,6,8,"ARM","Amarillo Armadillos","home",1,0,"West Division","MiLPBE",5,6,-1,"5 - 6",4,37,46,99,2116,1369,11,0.607173601147776,7,4,"7 - 4","#86572C",1,2,"2029"
19,101,335,2029-05-30,1905,9,7,9,"ARM","Amarillo Armadillos","home",1,0,"West Division","MiLPBE",6,6,0,"6 - 6",2,39,53,108,2809,1521,12,0.648729792147806,8,4,"8 - 4","#86572C",1,2,"2029"
19,101,338,2029-06-02,1905,9,0,4,"ARM","Amarillo Armadillos","home",0,1,"West Division","MiLPBE",6,7,-1,"6 - 7",1,40,53,112,2809,1600,13,0.637105919709685,8,5,"8 - 5","#86572C",1,2,"2029"
19,101,341,2029-06-03,1905,10,5,9,"ARM","Amarillo Armadillos","home",0,1,"West Division","MiLPBE",6,8,-2,"6 - 8",6,46,58,121,3364,2116,14,0.613868613138686,9,5,"9 - 5","#86572C",1,2,"2029"
19,101,344,2029-06-04,1905,9,11,16,"ARM","Amarillo Armadillos","home",1,0,"West Division","MiLPBE",7,8,-1,"7 - 8",8,54,69,137,4761,2916,15,0.620164126611958,9,6,"9 - 6","#86572C",1,2,"2029"
19,101,347,2029-06-05,1905,10,8,11,"ARM","Amarillo Armadillos","home",1,0,"West Division","MiLPBE",8,8,0,"8 - 8",7,61,77,148,5929,3721,16,0.61440414507772,10,6,"10 - 6","#86572C",1,2,"2029"
19,101,350,2029-06-08,1905,9,5,8,"ARM","Amarillo Armadillos","home",1,0,"West Division","MiLPBE",9,8,1,"9 - 8",3,64,82,156,6724,4096,17,0.621441774491682,11,6,"11 - 6","#86572C",1,2,"2029"
19,101,353,2029-06-09,1905,9,5,12,"ARM","Amarillo Armadillos","home",1,0,"West Division","MiLPBE",10,8,2,"10 - 8",3,67,87,168,7569,4489,18,0.627716039144137,11,7,"11 - 7","#86572C",1,2,"2029"
19,101,356,2029-06-10,1905,9,5,9,"ARM","Amarillo Armadillos","home",0,1,"West Division","MiLPBE",10,9,1,"10 - 9",7,74,92,177,8464,5476,19,0.607173601147776,12,7,"12 - 7","#86572C",1,2,"2029"
19,101,359,2029-06-11,1905,9,0,3,"ARM","Amarillo Armadillos","home",0,1,"West Division","MiLPBE",10,10,0,"10 - 10",1,75,92,180,8464,5625,20,0.600752359997161,12,8,"12 - 8","#86572C",1,2,"2029"
19,101,362,2029-06-14,1905,9,5,12,"ARM","Amarillo Armadillos","home",1,0,"West Division","MiLPBE",11,10,1,"11 - 10",1,76,97,192,9409,5776,21,0.619624629568653,13,8,"13 - 8","#86572C",1,2,"2029"
19,101,365,2029-06-15,1905,9,3,5,"ARM","Amarillo Armadillos","home",1,0,"West Division","MiLPBE",12,10,2,"12 - 10",1,77,100,197,10000,5929,22,0.627785799485216,14,8,"14 - 8","#86572C",1,2,"2029"
19,101,368,2029-06-16,1905,9,1,7,"ARM","Amarillo Armadillos","home",0,1,"West Division","MiLPBE",12,11,1,"12 - 11",5,82,101,204,10201,6724,23,0.602717872968981,14,9,"14 - 9","#86572C",1,2,"2029"
19,101,371,2029-06-17,1905,9,11,17,"ARM","Amarillo Armadillos","home",1,0,"West Division","MiLPBE",13,11,2,"13 - 11",3,85,112,221,12544,7225,24,0.634528807729273,15,9,"15 - 9","#86572C",1,2,"2029"
19,101,374,2029-06-20,1905,9,5,7,"ARM","Amarillo Armadillos","home",1,0,"West Division","MiLPBE",14,11,3,"14 - 11",2,87,117,228,13689,7569,25,0.643945808636749,16,9,"16 - 9","#86572C",1,2,"2029"
19,101,377,2029-06-21,1905,9,3,8,"ARM","Amarillo Armadillos","home",0,1,"West Division","MiLPBE",14,12,2,"14 - 12",4,91,120,236,14400,8281,26,0.634892641417927,17,9,"17 - 9","#86572C",1,2,"2029"
19,101,380,2029-06-22,1905,9,0,5,"ARM","Amarillo Armadillos","home",0,1,"West Division","MiLPBE",14,13,1,"14 - 13",8,99,120,241,14400,9801,27,0.595016734845668,16,11,"16 - 11","#86572C",1,2,"2029"
19,101,509,2029-06-23,1905,9,3,8,"ARM","Amarillo Armadillos","home",0,1,"West Division","MiLPBE",14,14,0,"14 - 14",4,103,123,249,15129,10609,28,0.587807910482555,16,12,"16 - 12","#86572C",1,2,"2029"
19,101,513,2029-07-15,1905,10,8,16,"ARM","Amarillo Armadillos","away",1,0,"West Division","MiLPBE",15,14,1,"15 - 14",6,109,131,265,17161,11881,29,0.590902830383582,17,12,"17 - 12","#86572C",1,2,"2029"
19,101,515,2029-06-25,1905,9,6,14,"ARM","Amarillo Armadillos","away",1,0,"West Division","MiLPBE",16,14,2,"16 - 14",4,113,137,279,18769,12769,30,0.595123343268438,18,12,"18 - 12","#86572C",1,2,"2029"
19,101,518,2029-06-26,1905,9,8,11,"ARM","Amarillo Armadillos","away",1,0,"West Division","MiLPBE",17,14,3,"17 - 14",3,116,145,290,21025,13456,31,0.609756097560976,19,12,"19 - 12","#86572C",1,2,"2029"
19,101,521,2029-06-27,1905,9,8,15,"ARM","Amarillo Armadillos","away",1,0,"West Division","MiLPBE",18,14,4,"18 - 14",1,117,153,305,23409,13689,32,0.631004366812227,20,12,"20 - 12","#86572C",1,2,"2029"
19,101,524,2029-06-28,1905,9,0,3,"ARM","Amarillo Armadillos","away",0,1,"West Division","MiLPBE",18,15,3,"18 - 15",3,120,153,308,23409,14400,33,0.619138300404666,20,13,"20 - 13","#86572C",1,2,"2029"
19,101,527,2029-07-01,1905,10,5,11,"ARM","Amarillo Armadillos","away",0,1,"West Division","MiLPBE",18,16,2,"18 - 16",6,126,158,319,24964,15876,34,0.61126346718903,21,13,"21 - 13","#86572C",1,2,"2029"
19,101,530,2029-07-02,1905,9,3,8,"ARM","Amarillo Armadillos","away",0,1,"West Division","MiLPBE",18,17,1,"18 - 17",7,133,161,327,25921,17689,35,0.59438202247191,21,14,"21 - 14","#86572C",1,2,"2029"
19,101,533,2029-07-03,1905,9,1,8,"ARM","Amarillo Armadillos","away",0,1,"West Division","MiLPBE",18,18,0,"18 - 18",2,135,162,335,26244,18225,36,0.590163934426229,21,15,"21 - 15","#86572C",1,2,"2029"
19,101,536,2029-07-04,1905,9,3,10,"ARM","Amarillo Armadillos","away",0,1,"West Division","MiLPBE",18,19,-1,"18 - 19",6,141,165,345,27225,19881,37,0.5779518532671,21,16,"21 - 16","#86572C",1,2,"2029"
19,101,539,2029-07-07,1905,9,7,8,"ARM","Amarillo Armadillos","away",1,0,"West Division","MiLPBE",19,19,0,"19 - 19",2,143,172,353,29584,20449,38,0.591289748765815,22,16,"22 - 16","#86572C",1,2,"2029"
19,101,542,2029-07-08,1905,9,0,3,"ARM","Amarillo Armadillos","away",0,1,"West Division","MiLPBE",19,20,-1,"19 - 20",4,147,172,356,29584,21609,39,0.577891508604692,23,16,"23 - 16","#86572C",1,2,"2029"
19,101,545,2029-07-09,1905,9,7,12,"ARM","Amarillo Armadillos","away",1,0,"West Division","MiLPBE",20,20,0,"20 - 20",3,150,179,368,32041,22500,40,0.587466309748629,23,17,"23 - 17","#86572C",1,2,"2029"
19,101,548,2029-07-10,1905,12,3,9,"ARM","Amarillo Armadillos","away",0,1,"West Division","MiLPBE",20,21,-1,"20 - 21",4,154,182,377,33124,23716,41,0.582758620689655,24,17,"24 - 17","#86572C",1,2,"2029"
19,101,551,2029-07-12,1905,9,4,13,"ARM","Amarillo Armadillos","away",0,1,"West Division","MiLPBE",20,22,-2,"20 - 22",5,159,186,390,34596,25281,42,0.577784458139185,24,18,"24 - 18","#86572C",1,2,"2029"
19,101,554,2029-07-13,1905,9,0,6,"ARM","Amarillo Armadillos","away",0,1,"West Division","MiLPBE",20,23,-3,"20 - 23",8,167,186,396,34596,27889,43,0.553668880531328,24,19,"24 - 19","#86572C",1,2,"2029"
19,101,557,2029-07-14,1905,9,4,13,"ARM","Amarillo Armadillos","away",1,0,"West Division","MiLPBE",21,23,-2,"21 - 23",2,169,190,409,36100,28561,44,0.558296345556054,25,19,"25 - 19","#86572C",1,2,"2029"
19,101,560,2029-07-18,1905,9,5,8,"ARM","Amarillo Armadillos","away",1,0,"West Division","MiLPBE",22,23,-1,"22 - 23",2,171,195,417,38025,29241,45,0.565293015788065,25,20,"25 - 20","#86572C",1,2,"2029"
19,101,563,2029-07-19,1905,9,9,14,"ARM","Amarillo Armadillos","away",1,0,"West Division","MiLPBE",23,23,0,"23 - 23",7,178,204,431,41616,31684,46,0.56774897680764,26,20,"26 - 20","#86572C",1,2,"2029"
19,101,566,2029-07-20,1905,10,5,13,"ARM","Amarillo Armadillos","away",1,0,"West Division","MiLPBE",24,23,1,"24 - 23",2,180,209,444,43681,32400,47,0.574138089667591,27,20,"27 - 20","#86572C",1,2,"2029"
19,101,569,2029-07-21,1905,9,15,15,"ARM","Amarillo Armadillos","away",1,0,"West Division","MiLPBE",25,23,2,"25 - 23",4,184,224,459,50176,33856,48,0.597105864432597,29,19,"29 - 19","#86572C",1,2,"2029"
19,101,572,2029-07-24,1905,9,6,10,"ARM","Amarillo Armadillos","away",1,0,"West Division","MiLPBE",26,23,3,"26 - 23",5,189,230,469,52900,35721,49,0.596923979643651,29,20,"29 - 20","#86572C",1,2,"2029"
19,101,575,2029-07-25,1905,9,1,4,"ARM","Amarillo Armadillos","away",0,1,"West Division","MiLPBE",26,24,2,"26 - 24",8,197,231,473,53361,38809,50,0.578941087121623,29,21,"29 - 21","#86572C",1,2,"2029"
19,101,578,2029-07-26,1905,9,5,8,"ARM","Amarillo Armadillos","away",1,0,"West Division","MiLPBE",27,24,3,"27 - 24",2,199,236,481,55696,39601,51,0.584446519827487,30,21,"30 - 21","#86572C",1,2,"2029"
19,101,581,2029-07-27,1905,10,2,9,"ARM","Amarillo Armadillos","away",1,0,"West Division","MiLPBE",28,24,4,"28 - 24",1,200,238,490,56644,40000,52,0.586109846446753,30,22,"30 - 22","#86572C",1,2,"2029"
24,100,1,2029-05-15,1905,9,2,5,"FL","Florida Space Rangers","away",0,1,"Eastern Division","PBE",0,1,-1,"0 - 1",4,4,2,5,4,16,1,0.2,0,1,"0 - 1","#D0D02B",1,1,"2029"
24,100,6,2029-05-16,1905,9,9,14,"FL","Florida Space Rangers","away",1,0,"Eastern Division","PBE",1,1,0,"1 - 1",2,6,11,19,121,36,2,0.770700636942675,2,0,"2 - 0","#D0D02B",1,1,"2029"
24,100,11,2029-05-17,1905,9,3,9,"FL","Florida Space Rangers","away",0,1,"Eastern Division","PBE",1,2,-1,"1 - 2",5,11,14,28,196,121,3,0.618296529968454,2,1,"2 - 1","#D0D02B",1,1,"2029"
24,100,16,2029-05-18,1905,9,4,7,"FL","Florida Space Rangers","away",1,0,"Eastern Division","PBE",2,2,0,"2 - 2",3,14,18,35,324,196,4,0.623076923076923,2,2,"2 - 2","#D0D02B",1,1,"2029"
24,100,22,2029-05-21,1905,9,11,14,"FL","Florida Space Rangers","home",1,0,"Eastern Division","PBE",3,2,1,"3 - 2",7,21,29,49,841,441,5,0.65600624024961,3,2,"3 - 2","#D0D02B",1,1,"2029"
24,100,27,2029-05-22,1905,9,4,6,"FL","Florida Space Rangers","home",1,0,"Eastern Division","PBE",4,2,2,"4 - 2",2,23,33,55,1089,529,6,0.673053152039555,4,2,"4 - 2","#D0D02B",1,1,"2029"
24,100,32,2029-05-23,1905,9,6,11,"FL","Florida Space Rangers","home",1,0,"Eastern Division","PBE",5,2,3,"5 - 2",0,23,39,66,1521,529,7,0.741951219512195,5,2,"5 - 2","#D0D02B",1,1,"2029"
24,100,36,2029-05-24,1905,9,5,8,"FL","Florida Space Rangers","home",1,0,"Eastern Division","PBE",6,2,4,"6 - 2",2,25,44,74,1936,625,8,0.755954705193284,6,2,"6 - 2","#D0D02B",1,1,"2029"
24,100,40,2029-05-26,1905,9,8,11,"FL","Florida Space Rangers","away",1,0,"Eastern Division","PBE",7,2,5,"7 - 2",4,29,52,85,2704,841,9,0.762764456981664,7,2,"7 - 2","#D0D02B",1,1,"2029"
24,100,44,2029-05-27,1905,9,1,5,"FL","Florida Space Rangers","away",0,1,"Eastern Division","PBE",7,3,4,"7 - 3",5,34,53,90,2809,1156,10,0.708448928121059,7,3,"7 - 3","#D0D02B",1,1,"2029"
24,100,49,2029-05-28,1905,9,6,8,"FL","Florida Space Rangers","away",1,0,"Eastern Division","PBE",8,3,5,"8 - 3",3,37,59,98,3481,1369,11,0.717731958762887,8,3,"8 - 3","#D0D02B",1,1,"2029"
24,100,54,2029-05-29,1905,9,3,4,"FL","Florida Space Rangers","away",0,1,"Eastern Division","PBE",8,4,4,"8 - 4",4,41,62,102,3844,1681,12,0.695746606334842,8,4,"8 - 4","#D0D02B",1,1,"2029"
24,100,59,2029-06-01,1905,9,3,5,"FL","Florida Space Rangers","away",1,0,"Eastern Division","PBE",9,4,5,"9 - 4",2,43,65,107,4225,1849,13,0.695587751070135,9,4,"9 - 4","#D0D02B",1,1,"2029"
24,100,64,2029-06-02,1905,9,4,11,"FL","Florida Space Rangers","away",0,1,"Eastern Division","PBE",9,5,4,"9 - 5",8,51,69,118,4761,2601,14,0.646699266503667,9,5,"9 - 5","#D0D02B",1,1,"2029"
24,100,69,2029-06-03,1905,9,12,14,"FL","Florida Space Rangers","away",1,0,"Eastern Division","PBE",10,5,5,"10 - 5",5,56,81,132,6561,3136,15,0.676601010621842,10,5,"10 - 5","#D0D02B",1,1,"2029"
24,100,74,2029-06-04,1905,9,13,17,"FL","Florida Space Rangers","away",1,0,"Eastern Division","PBE",11,5,6,"11 - 5",4,60,94,149,8836,3600,16,0.710517851399164,11,5,"11 - 5","#D0D02B",1,1,"2029"
24,100,81,2029-06-06,1905,9,3,9,"FL","Florida Space Rangers","home",1,0,"Eastern Division","PBE",12,5,7,"12 - 5",2,62,97,158,9409,3844,17,0.709952463593149,12,5,"12 - 5","#D0D02B",1,1,"2029"
24,100,85,2029-06-07,1905,9,1,3,"FL","Florida Space Rangers","home",1,0,"Eastern Division","PBE",13,5,8,"13 - 5",0,62,98,161,9604,3844,18,0.714158239143367,13,5,"13 - 5","#D0D02B",1,1,"2029"
24,100,90,2029-06-08,1905,9,11,13,"FL","Florida Space Rangers","home",1,0,"Eastern Division","PBE",14,5,9,"14 - 5",5,67,109,174,11881,4489,19,0.725778863775199,14,5,"14 - 5","#D0D02B",1,1,"2029"
24,100,94,2029-06-09,1905,9,0,2,"FL","Florida Space Rangers","home",0,1,"Eastern Division","PBE",14,6,8,"14 - 6",1,68,109,176,11881,4624,20,0.719842471978188,14,6,"14 - 6","#D0D02B",1,1,"2029"
24,100,97,2029-06-11,1905,12,6,11,"FL","Florida Space Rangers","home",1,0,"Eastern Division","PBE",15,6,9,"15 - 6",5,73,115,187,13225,5329,21,0.712784305271101,15,6,"15 - 6","#D0D02B",1,1,"2029"
24,100,102,2029-06-12,1905,9,1,4,"FL","Florida Space Rangers","home",0,1,"Eastern Division","PBE",15,7,8,"15 - 7",3,76,116,191,13456,5776,22,0.699667221297837,15,7,"15 - 7","#D0D02B",1,1,"2029"
24,100,107,2029-06-13,1905,9,6,6,"FL","Florida Space Rangers","home",1,0,"Eastern Division","PBE",16,7,9,"16 - 7",4,80,122,197,14884,6400,23,0.699304641984589,16,7,"16 - 7","#D0D02B",1,1,"2029"
24,100,121,2029-06-17,1905,9,5,6,"FL","Florida Space Rangers","away",1,0,"Eastern Division","PBE",17,7,10,"17 - 7",3,83,127,203,16129,6889,24,0.700712485880615,17,7,"17 - 7","#D0D02B",1,1,"2029"
24,100,126,2029-06-18,1905,9,8,11,"FL","Florida Space Rangers","away",1,0,"Eastern Division","PBE",18,7,11,"18 - 7",6,89,135,214,18225,7921,25,0.697047349498967,17,8,"17 - 8","#D0D02B",1,1,"2029"
24,100,131,2029-06-19,1905,9,3,11,"FL","Florida Space Rangers","away",0,1,"Eastern Division","PBE",18,8,10,"18 - 8",8,97,138,225,19044,9409,26,0.669314307805855,17,9,"17 - 9","#D0D02B",1,1,"2029"
24,100,137,2029-06-22,1905,9,5,7,"FL","Florida Space Rangers","home",1,0,"Eastern Division","PBE",19,8,11,"19 - 8",1,98,143,232,20449,9604,27,0.680431238145942,18,9,"18 - 9","#D0D02B",1,1,"2029"
24,100,142,2029-06-23,1905,9,3,8,"FL","Florida Space Rangers","home",1,0,"Eastern Division","PBE",20,8,12,"20 - 8",0,98,146,240,21316,9604,28,0.689391979301423,19,9,"19 - 9","#D0D02B",1,1,"2029"
24,100,147,2029-06-24,1905,9,0,5,"FL","Florida Space Rangers","home",0,1,"Eastern Division","PBE",20,9,11,"20 - 9",2,100,146,245,21316,10000,29,0.680674415634181,20,9,"20 - 9","#D0D02B",1,1,"2029"
24,100,152,2029-06-25,1905,9,5,11,"FL","Florida Space Rangers","home",1,0,"Eastern Division","PBE",21,9,12,"21 - 9",0,100,151,256,22801,10000,30,0.695131245998598,21,9,"21 - 9","#D0D02B",1,1,"2029"
24,100,160,2029-06-28,1905,9,9,13,"FL","Florida Space Rangers","home",1,0,"Eastern Division","PBE",22,9,13,"22 - 9",4,104,160,269,25600,10816,31,0.70298769771529,22,9,"22 - 9","#D0D02B",1,1,"2029"
24,100,165,2029-06-29,1905,9,3,9,"FL","Florida Space Rangers","home",0,1,"Eastern Division","PBE",22,10,12,"22 - 10",10,114,163,278,26569,12996,32,0.671527865537723,21,11,"21 - 11","#D0D02B",1,1,"2029"
24,100,170,2029-06-30,1905,9,1,10,"FL","Florida Space Rangers","home",0,1,"Eastern Division","PBE",22,11,11,"22 - 11",6,120,164,288,26896,14400,33,0.651297946532352,21,12,"21 - 12","#D0D02B",1,1,"2029"
24,100,177,2029-07-03,1905,9,11,14,"FL","Florida Space Rangers","away",1,0,"Eastern Division","PBE",23,11,12,"23 - 11",7,127,175,302,30625,16129,34,0.655024169055054,22,12,"22 - 12","#D0D02B",1,1,"2029"
24,100,182,2029-07-04,1905,9,6,6,"FL","Florida Space Rangers","away",1,0,"Eastern Division","PBE",24,11,13,"24 - 11",2,129,181,308,32761,16641,35,0.663151289421481,23,12,"23 - 12","#D0D02B",1,1,"2029"
24,100,187,2029-07-05,1905,9,2,6,"FL","Florida Space Rangers","away",1,0,"Eastern Division","PBE",25,11,14,"25 - 11",1,130,183,314,33489,16900,36,0.664609339339935,24,12,"24 - 12","#D0D02B",1,1,"2029"
24,100,192,2029-07-06,1905,9,7,12,"FL","Florida Space Rangers","away",1,0,"Eastern Division","PBE",26,11,15,"26 - 11",1,131,190,326,36100,17161,37,0.677794258463041,25,12,"25 - 12","#D0D02B",1,1,"2029"
24,100,194,2029-07-09,1905,9,2,5,"FL","Florida Space Rangers","home",1,0,"Eastern Division","PBE",27,11,16,"27 - 11",0,131,192,331,36864,17161,38,0.6823507635354,26,12,"26 - 12","#D0D02B",1,1,"2029"
24,100,199,2029-07-10,1905,9,6,10,"FL","Florida Space Rangers","home",0,1,"Eastern Division","PBE",27,12,15,"27 - 12",8,139,198,341,39204,19321,39,0.669867577958138,26,13,"26 - 13","#D0D02B",1,1,"2029"
24,100,204,2029-07-11,1905,9,0,4,"FL","Florida Space Rangers","home",0,1,"Eastern Division","PBE",27,13,14,"27 - 13",7,146,198,345,39204,21316,40,0.6477858559154,26,14,"26 - 14","#D0D02B",1,1,"2029"
24,100,209,2029-07-12,1905,9,5,7,"FL","Florida Space Rangers","home",1,0,"Eastern Division","PBE",28,13,15,"28 - 13",0,146,203,352,41209,21316,41,0.659080367852859,27,14,"27 - 14","#D0D02B",1,1,"2029"
24,100,216,2029-07-15,1905,9,3,4,"FL","Florida Space Rangers","away",1,0,"Eastern Division","PBE",29,13,16,"29 - 13",2,148,206,356,42436,21904,42,0.659558594964252,28,14,"28 - 14","#D0D02B",1,1,"2029"
24,100,221,2029-07-16,1905,9,10,12,"FL","Florida Space Rangers","away",1,0,"Eastern Division","PBE",30,13,17,"30 - 13",7,155,216,368,46656,24025,43,0.660092528402258,28,15,"28 - 15","#D0D02B",1,1,"2029"
24,100,226,2029-07-17,1905,9,0,5,"FL","Florida Space Rangers","away",0,1,"Eastern Division","PBE",30,14,16,"30 - 14",3,158,216,373,46656,24964,44,0.651438145769338,29,15,"29 - 15","#D0D02B",1,1,"2029"
24,100,231,2029-07-18,1905,9,3,6,"FL","Florida Space Rangers","away",0,1,"Eastern Division","PBE",30,15,15,"30 - 15",8,166,219,379,47961,27556,45,0.635102030006489,29,16,"29 - 16","#D0D02B",1,1,"2029"
24,100,234,2029-07-21,1905,9,1,7,"FL","Florida Space Rangers","away",0,1,"Eastern Division","PBE",30,16,14,"30 - 16",2,168,220,386,48400,28224,46,0.631655878053873,29,17,"29 - 17","#D0D02B",1,1,"2029"
24,100,239,2029-07-22,1905,9,9,15,"FL","Florida Space Rangers","away",1,0,"Eastern Division","PBE",31,16,15,"31 - 16",5,173,229,401,52441,29929,47,0.636651693577759,30,17,"30 - 17","#D0D02B",1,1,"2029"
24,100,244,2029-07-23,1905,9,4,7,"FL","Florida Space Rangers","away",1,0,"Eastern Division","PBE",32,16,16,"32 - 16",3,176,233,408,54289,30976,48,0.636709083445728,31,17,"31 - 17","#D0D02B",1,1,"2029"
24,100,249,2029-07-24,1905,9,5,12,"FL","Florida Space Rangers","away",1,0,"Eastern Division","PBE",33,16,17,"33 - 16",0,176,238,420,56644,30976,49,0.64647340789774,32,17,"32 - 17","#D0D02B",1,1,"2029"
25,100,5,2029-05-15,1905,9,1,4,"UTA","Utah Railroaders","home",0,1,"Western Division","PBE",0,1,-1,"0 - 1",4,4,1,4,1,16,1,0.0588235294117647,0,1,"0 - 1","#2C0060",4,8,"2029"
25,100,10,2029-05-16,1905,9,2,11,"UTA","Utah Railroaders","home",0,1,"Western Division","PBE",0,2,-2,"0 - 2",4,8,3,15,9,64,2,0.123287671232877,0,2,"0 - 2","#2C0060",4,8,"2029"
25,100,15,2029-05-17,1905,10,2,9,"UTA","Utah Railroaders","home",0,1,"Western Division","PBE",0,3,-3,"0 - 3",3,11,5,24,25,121,3,0.171232876712329,1,2,"1 - 2","#2C0060",4,8,"2029"
25,100,20,2029-05-18,1905,9,0,3,"UTA","Utah Railroaders","home",0,1,"Western Division","PBE",0,4,-4,"0 - 4",10,21,5,27,25,441,4,0.0536480686695279,0,4,"0 - 4","#2C0060",4,8,"2029"
25,100,25,2029-05-21,1905,9,8,12,"UTA","Utah Railroaders","away",1,0,"Western Division","PBE",1,4,-3,"1 - 4",6,27,13,39,169,729,5,0.188195991091314,1,4,"1 - 4","#2C0060",4,8,"2029"
25,100,30,2029-05-22,1905,9,7,7,"UTA","Utah Railroaders","away",1,0,"Western Division","PBE",2,4,-2,"2 - 4",4,31,20,46,400,961,6,0.293901542983101,2,4,"2 - 4","#2C0060",4,8,"2029"
25,100,35,2029-05-23,1905,9,4,10,"UTA","Utah Railroaders","away",0,1,"Western Division","PBE",2,5,-3,"2 - 5",6,37,24,56,576,1369,7,0.296143958868895,2,5,"2 - 5","#2C0060",4,8,"2029"
25,100,39,2029-05-24,1905,11,3,10,"UTA","Utah Railroaders","away",0,1,"Western Division","PBE",2,6,-4,"2 - 6",4,41,27,66,729,1681,8,0.302489626556017,2,6,"2 - 6","#2C0060",4,8,"2029"
25,100,43,2029-05-26,1905,9,9,10,"UTA","Utah Railroaders","home",1,0,"Western Division","PBE",3,6,-3,"3 - 6",1,42,36,76,1296,1764,9,0.423529411764706,4,5,"4 - 5","#2C0060",4,8,"2029"
25,100,48,2029-05-27,1905,9,6,7,"UTA","Utah Railroaders","home",1,0,"Western Division","PBE",4,6,-2,"4 - 6",2,44,42,83,1764,1936,10,0.476756756756757,5,5,"5 - 5","#2C0060",4,8,"2029"
25,100,53,2029-05-28,1905,9,2,4,"UTA","Utah Railroaders","home",0,1,"Western Division","PBE",4,7,-3,"4 - 7",4,48,44,87,1936,2304,11,0.456603773584906,5,6,"5 - 6","#2C0060",4,8,"2029"
25,100,58,2029-05-29,1905,9,5,5,"UTA","Utah Railroaders","home",1,0,"Western Division","PBE",5,7,-2,"5 - 7",2,50,49,92,2401,2500,12,0.489900020403999,6,6,"6 - 6","#2C0060",4,8,"2029"
25,100,61,2029-06-01,1905,9,7,9,"UTA","Utah Railroaders","home",1,0,"Western Division","PBE",6,7,-1,"6 - 7",5,55,56,101,3136,3025,13,0.509008277876968,7,6,"7 - 6","#2C0060",4,8,"2029"
25,100,66,2029-06-02,1905,9,3,8,"UTA","Utah Railroaders","home",0,1,"Western Division","PBE",6,8,-2,"6 - 8",8,63,59,109,3481,3969,14,0.467248322147651,7,7,"7 - 7","#2C0060",4,8,"2029"
25,100,71,2029-06-03,1905,9,1,6,"UTA","Utah Railroaders","home",0,1,"Western Division","PBE",6,9,-3,"6 - 9",11,74,60,115,3600,5476,15,0.396650506831203,6,9,"6 - 9","#2C0060",4,8,"2029"
25,100,76,2029-06-04,1905,9,4,7,"UTA","Utah Railroaders","home",0,1,"Western Division","PBE",6,10,-4,"6 - 10",8,82,64,122,4096,6724,16,0.378558225508318,6,10,"6 - 10","#2C0060",4,8,"2029"
25,100,87,2029-06-07,1905,9,4,8,"UTA","Utah Railroaders","home",1,0,"Western Division","PBE",7,10,-3,"7 - 10",2,84,68,130,4624,7056,17,0.395890410958904,7,10,"7 - 10","#2C0060",4,8,"2029"
25,100,92,2029-06-08,1905,10,4,10,"UTA","Utah Railroaders","home",0,1,"Western Division","PBE",7,11,-4,"7 - 11",5,89,72,140,5184,7921,18,0.395574208317436,7,11,"7 - 11","#2C0060",4,8,"2029"
25,100,96,2029-06-09,1905,9,2,8,"UTA","Utah Railroaders","home",0,1,"Western Division","PBE",7,12,-5,"7 - 12",9,98,74,148,5476,9604,19,0.363129973474801,7,12,"7 - 12","#2C0060",4,8,"2029"
25,100,101,2029-06-11,1905,9,9,9,"UTA","Utah Railroaders","away",1,0,"Western Division","PBE",8,12,-4,"8 - 12",2,100,83,157,6889,10000,20,0.40789863224584,8,12,"8 - 12","#2C0060",4,8,"2029"
25,100,106,2029-06-12,1905,9,2,7,"UTA","Utah Railroaders","away",0,1,"Western Division","PBE",8,13,-5,"8 - 13",3,103,85,164,7225,10609,21,0.405125042054503,9,12,"9 - 12","#2C0060",4,8,"2029"
25,100,111,2029-06-13,1905,9,7,13,"UTA","Utah Railroaders","away",1,0,"Western Division","PBE",9,13,-4,"9 - 13",3,106,92,177,8464,11236,22,0.429644670050761,9,13,"9 - 13","#2C0060",4,8,"2029"
25,100,115,2029-06-14,1905,9,2,7,"UTA","Utah Railroaders","away",0,1,"Western Division","PBE",9,14,-5,"9 - 14",4,110,94,184,8836,12100,23,0.4220481467329,10,13,"10 - 13","#2C0060",4,8,"2029"
25,100,117,2029-06-16,1905,9,3,3,"UTA","Utah Railroaders","home",0,1,"Western Division","PBE",9,15,-6,"9 - 15",13,123,97,187,9409,15129,24,0.383446083625397,9,15,"9 - 15","#2C0060",4,8,"2029"
25,100,122,2029-06-17,1905,9,5,9,"UTA","Utah Railroaders","home",1,0,"Western Division","PBE",10,15,-5,"10 - 15",3,126,102,196,10404,15876,25,0.395890410958904,10,15,"10 - 15","#2C0060",4,8,"2029"
25,100,127,2029-06-18,1905,9,0,5,"UTA","Utah Railroaders","home",0,1,"Western Division","PBE",10,16,-6,"10 - 16",5,131,102,201,10404,17161,26,0.377435153274079,10,16,"10 - 16","#2C0060",4,8,"2029"
25,100,132,2029-06-19,1905,13,7,13,"UTA","Utah Railroaders","home",0,1,"Western Division","PBE",10,17,-7,"10 - 17",9,140,109,214,11881,19600,27,0.377402242622534,10,17,"10 - 17","#2C0060",4,8,"2029"
25,100,139,2029-06-22,1905,9,5,8,"UTA","Utah Railroaders","away",0,1,"Western Division","PBE",10,18,-8,"10 - 18",7,147,114,222,12996,21609,28,0.37555266579974,11,17,"11 - 17","#2C0060",4,8,"2029"
25,100,144,2029-06-23,1905,9,6,13,"UTA","Utah Railroaders","away",1,0,"Western Division","PBE",11,18,-7,"11 - 18",4,151,120,235,14400,22801,29,0.387086368646004,11,18,"11 - 18","#2C0060",4,8,"2029"
25,100,149,2029-06-24,1905,9,6,10,"UTA","Utah Railroaders","away",0,1,"Western Division","PBE",11,19,-8,"11 - 19",9,160,126,245,15876,25600,30,0.382775581058926,11,19,"11 - 19","#2C0060",4,8,"2029"
25,100,154,2029-06-25,1905,12,7,12,"UTA","Utah Railroaders","away",1,0,"Western Division","PBE",12,19,-7,"12 - 19",6,166,133,257,17689,27556,31,0.390960327107968,12,19,"12 - 19","#2C0060",4,8,"2029"
25,100,157,2029-06-27,1905,9,3,9,"UTA","Utah Railroaders","away",1,0,"Western Division","PBE",13,19,-6,"13 - 19",2,168,136,266,18496,28224,32,0.395890410958904,13,19,"13 - 19","#2C0060",4,8,"2029"
25,100,162,2029-06-28,1905,9,11,15,"UTA","Utah Railroaders","away",1,0,"Western Division","PBE",14,19,-5,"14 - 19",3,171,147,281,21609,29241,33,0.424955752212389,14,19,"14 - 19","#2C0060",4,8,"2029"
25,100,167,2029-06-29,1905,9,3,5,"UTA","Utah Railroaders","away",0,1,"Western Division","PBE",14,20,-6,"14 - 20",6,177,150,286,22500,31329,34,0.417990302624979,14,20,"14 - 20","#2C0060",4,8,"2029"
25,100,172,2029-06-30,1905,9,2,5,"UTA","Utah Railroaders","away",0,1,"Western Division","PBE",14,21,-7,"14 - 21",3,180,152,291,23104,32400,35,0.416258287690977,15,20,"15 - 20","#2C0060",4,8,"2029"
25,100,177,2029-07-03,1905,9,7,10,"UTA","Utah Railroaders","home",0,1,"Western Division","PBE",14,22,-8,"14 - 22",11,191,159,301,25281,36481,36,0.409329361095819,15,21,"15 - 21","#2C0060",4,8,"2029"
25,100,182,2029-07-04,1905,9,2,8,"UTA","Utah Railroaders","home",0,1,"Western Division","PBE",14,23,-9,"14 - 23",6,197,161,309,25921,38809,37,0.400448014830836,15,22,"15 - 22","#2C0060",4,8,"2029"
25,100,187,2029-07-05,1905,9,1,3,"UTA","Utah Railroaders","home",0,1,"Western Division","PBE",14,24,-10,"14 - 24",2,199,162,312,26244,39601,38,0.398572404890273,15,23,"15 - 23","#2C0060",4,8,"2029"
25,100,192,2029-07-06,1905,9,1,8,"UTA","Utah Railroaders","home",0,1,"Western Division","PBE",14,25,-11,"14 - 25",7,206,163,320,26569,42436,39,0.385030070284762,15,24,"15 - 24","#2C0060",4,8,"2029"
25,100,198,2029-07-09,1905,9,4,8,"UTA","Utah Railroaders","home",1,0,"Western Division","PBE",15,25,-10,"15 - 25",3,209,167,328,27889,43681,40,0.389674444599693,16,24,"16 - 24","#2C0060",4,8,"2029"
25,100,203,2029-07-10,1905,9,2,6,"UTA","Utah Railroaders","home",1,0,"Western Division","PBE",16,25,-9,"16 - 25",1,210,169,334,28561,44100,41,0.393071936802411,16,25,"16 - 25","#2C0060",4,8,"2029"
25,100,208,2029-07-11,1905,9,4,9,"UTA","Utah Railroaders","home",0,1,"Western Division","PBE",16,26,-10,"16 - 26",6,216,173,343,29929,46656,42,0.390794542012143,16,26,"16 - 26","#2C0060",4,8,"2029"
25,100,213,2029-07-12,1905,9,10,14,"UTA","Utah Railroaders","home",1,0,"Western Division","PBE",17,26,-9,"17 - 26",0,216,183,357,33489,46656,43,0.417855137563167,18,25,"18 - 25","#2C0060",4,8,"2029"
25,100,215,2029-07-15,1905,9,9,13,"UTA","Utah Railroaders","away",1,0,"Western Division","PBE",18,26,-8,"18 - 26",2,218,192,370,36864,47524,44,0.436839361046594,19,25,"19 - 25","#2C0060",4,8,"2029"
25,100,220,2029-07-16,1905,9,7,14,"UTA","Utah Railroaders","away",1,0,"Western Division","PBE",19,26,-7,"19 - 26",4,222,199,384,39601,49284,45,0.445530741969961,20,25,"20 - 25","#2C0060",4,8,"2029"
25,100,225,2029-07-17,1905,9,2,7,"UTA","Utah Railroaders","away",0,1,"Western Division","PBE",19,27,-8,"19 - 27",5,227,201,391,40401,51529,46,0.439475688023496,20,26,"20 - 26","#2C0060",4,8,"2029"
25,100,230,2029-07-18,1905,9,3,6,"UTA","Utah Railroaders","away",0,1,"Western Division","PBE",19,28,-9,"19 - 28",4,231,204,397,41616,53361,47,0.438169240974131,21,26,"21 - 26","#2C0060",4,8,"2029"
25,100,236,2029-07-21,1905,10,7,10,"UTA","Utah Railroaders","away",1,0,"Western Division","PBE",20,28,-8,"20 - 28",6,237,211,407,44521,56169,48,0.442159102194855,21,27,"21 - 27","#2C0060",4,8,"2029"
25,100,241,2029-07-22,1905,10,5,13,"UTA","Utah Railroaders","away",0,1,"Western Division","PBE",20,29,-9,"20 - 29",6,243,216,420,46656,59049,49,0.441379310344828,22,27,"22 - 27","#2C0060",4,8,"2029"
25,100,246,2029-07-23,1905,12,4,7,"UTA","Utah Railroaders","away",0,1,"Western Division","PBE",20,30,-10,"20 - 30",7,250,220,427,48400,62500,50,0.436429215509468,22,28,"22 - 28","#2C0060",4,8,"2029"
25,100,251,2029-07-24,1905,9,3,9,"UTA","Utah Railroaders","away",1,0,"Western Division","PBE",21,30,-9,"21 - 30",1,251,223,436,49729,63001,51,0.441133682249623,22,29,"22 - 29","#2C0060",4,8,"2029"
26,100,1,2029-05-15,1905,9,4,9,"CUN","Cancun Toros","home",1,0,"Eastern Division","PBE",1,0,1,"1 - 0",2,2,4,9,16,4,1,0.8,1,0,"1 - 0","#0090D4",4,5,"2029"
26,100,6,2029-05-16,1905,9,2,4,"CUN","Cancun Toros","home",0,1,"Eastern Division","PBE",1,1,0,"1 - 1",9,11,6,13,36,121,2,0.229299363057325,0,2,"0 - 2","#0090D4",4,5,"2029"
26,100,11,2029-05-17,1905,9,5,9,"CUN","Cancun Toros","home",1,0,"Eastern Division","PBE",2,1,1,"2 - 1",3,14,11,22,121,196,3,0.381703470031546,1,2,"1 - 2","#0090D4",4,5,"2029"
26,100,16,2029-05-18,1905,9,3,11,"CUN","Cancun Toros","home",0,1,"Eastern Division","PBE",2,2,0,"2 - 2",4,18,14,33,196,324,4,0.376923076923077,2,2,"2 - 2","#0090D4",4,5,"2029"
26,100,21,2029-05-21,1905,9,2,6,"CUN","Cancun Toros","home",1,0,"Eastern Division","PBE",3,2,1,"3 - 2",1,19,16,39,256,361,5,0.414910858995138,2,3,"2 - 3","#0090D4",4,5,"2029"
26,100,26,2029-05-22,1905,9,1,8,"CUN","Cancun Toros","home",0,1,"Eastern Division","PBE",3,3,0,"3 - 3",11,30,17,47,289,900,6,0.243061396131203,1,5,"1 - 5","#0090D4",4,5,"2029"
26,100,31,2029-05-23,1905,10,7,14,"CUN","Cancun Toros","home",0,1,"Eastern Division","PBE",3,4,-1,"3 - 4",8,38,24,61,576,1444,7,0.285148514851485,2,5,"2 - 5","#0090D4",4,5,"2029"
26,100,42,2029-05-26,1905,13,0,7,"CUN","Cancun Toros","away",0,1,"Eastern Division","PBE",3,5,-2,"3 - 5",1,39,24,68,576,1521,8,0.274678111587983,2,6,"2 - 6","#0090D4",4,5,"2029"
26,100,46,2029-05-27,1905,9,7,11,"CUN","Cancun Toros","away",1,0,"Eastern Division","PBE",4,5,-1,"4 - 5",2,41,31,79,961,1681,9,0.363739591218774,3,6,"3 - 6","#0090D4",4,5,"2029"
26,100,51,2029-05-28,1905,10,0,3,"CUN","Cancun Toros","away",0,1,"Eastern Division","PBE",4,6,-2,"4 - 6",1,42,31,82,961,1764,10,0.352660550458716,4,6,"4 - 6","#0090D4",4,5,"2029"
26,100,56,2029-05-29,1905,9,3,10,"CUN","Cancun Toros","away",0,1,"Eastern Division","PBE",4,7,-3,"4 - 7",10,52,34,92,1156,2704,11,0.299481865284974,3,8,"3 - 8","#0090D4",4,5,"2029"
26,100,60,2029-06-01,1905,9,7,9,"CUN","Cancun Toros","home",1,0,"Eastern Division","PBE",5,7,-2,"5 - 7",4,56,41,101,1681,3136,12,0.348972389454017,4,8,"4 - 8","#0090D4",4,5,"2029"
26,100,65,2029-06-02,1905,9,6,11,"CUN","Cancun Toros","home",1,0,"Eastern Division","PBE",6,7,-1,"6 - 7",0,56,47,112,2209,3136,13,0.413283442469598,5,8,"5 - 8","#0090D4",4,5,"2029"
26,100,70,2029-06-03,1905,9,3,7,"CUN","Cancun Toros","home",1,0,"Eastern Division","PBE",7,7,0,"7 - 7",0,56,50,119,2500,3136,14,0.443577004968062,6,8,"6 - 8","#0090D4",4,5,"2029"
26,100,75,2029-06-04,1905,9,2,4,"CUN","Cancun Toros","home",0,1,"Eastern Division","PBE",7,8,-1,"7 - 8",4,60,52,123,2704,3600,15,0.428934010152284,6,9,"6 - 9","#0090D4",4,5,"2029"
26,100,80,2029-06-06,1905,9,1,3,"CUN","Cancun Toros","away",0,1,"Eastern Division","PBE",7,9,-2,"7 - 9",4,64,53,126,2809,4096,16,0.406806661839247,7,9,"7 - 9","#0090D4",4,5,"2029"
26,100,84,2029-06-07,1905,10,2,9,"CUN","Cancun Toros","away",0,1,"Eastern Division","PBE",7,10,-3,"7 - 10",3,67,55,135,3025,4489,17,0.402581847218525,7,10,"7 - 10","#0090D4",4,5,"2029"
26,100,89,2029-06-08,1905,9,3,10,"CUN","Cancun Toros","away",0,1,"Eastern Division","PBE",7,11,-4,"7 - 11",4,71,58,145,3364,5041,18,0.400237953599048,7,11,"7 - 11","#0090D4",4,5,"2029"
26,100,98,2029-06-11,1905,9,8,10,"CUN","Cancun Toros","away",0,1,"Eastern Division","PBE",7,12,-5,"7 - 12",11,82,66,155,4356,6724,19,0.393140794223827,7,12,"7 - 12","#0090D4",4,5,"2029"
26,100,103,2029-06-12,1905,9,6,9,"CUN","Cancun Toros","away",0,1,"Eastern Division","PBE",7,13,-6,"7 - 13",8,90,72,164,5184,8100,20,0.390243902439024,8,12,"8 - 12","#0090D4",4,5,"2029"
26,100,108,2029-06-13,1905,9,0,4,"CUN","Cancun Toros","away",0,1,"Eastern Division","PBE",7,14,-7,"7 - 14",8,98,72,168,5184,9604,21,0.350554503651609,7,14,"7 - 14","#0090D4",4,5,"2029"
26,100,112,2029-06-14,1905,9,2,3,"CUN","Cancun Toros","away",0,1,"Eastern Division","PBE",7,15,-8,"7 - 15",10,108,74,171,5476,11664,22,0.319486581096849,7,15,"7 - 15","#0090D4",4,5,"2029"
26,100,116,2029-06-16,1905,9,7,13,"CUN","Cancun Toros","away",1,0,"Eastern Division","PBE",8,15,-7,"8 - 15",2,110,81,184,6561,12100,23,0.351588875194255,8,15,"8 - 15","#0090D4",4,5,"2029"
26,100,120,2029-06-17,1905,9,1,5,"CUN","Cancun Toros","away",0,1,"Eastern Division","PBE",8,16,-8,"8 - 16",9,119,82,189,6724,14161,24,0.321953555183146,8,16,"8 - 16","#0090D4",4,5,"2029"
26,100,125,2029-06-18,1905,9,2,6,"CUN","Cancun Toros","away",0,1,"Eastern Division","PBE",8,17,-9,"8 - 17",4,123,84,195,7056,15129,25,0.318052738336714,8,17,"8 - 17","#0090D4",4,5,"2029"
26,100,130,2029-06-19,1905,9,10,14,"CUN","Cancun Toros","away",1,0,"Eastern Division","PBE",9,17,-8,"9 - 17",4,127,94,209,8836,16129,26,0.353935509713599,9,17,"9 - 17","#0090D4",4,5,"2029"
26,100,135,2029-06-22,1905,9,6,10,"CUN","Cancun Toros","away",1,0,"Eastern Division","PBE",10,17,-7,"10 - 17",2,129,100,219,10000,16641,27,0.375361285237041,10,17,"10 - 17","#0090D4",4,5,"2029"
26,100,140,2029-06-23,1905,9,8,12,"CUN","Cancun Toros","away",1,0,"Eastern Division","PBE",11,17,-6,"11 - 17",5,134,108,231,11664,17956,28,0.393787981093855,11,17,"11 - 17","#0090D4",4,5,"2029"
26,100,145,2029-06-24,1905,9,5,10,"CUN","Cancun Toros","away",1,0,"Eastern Division","PBE",12,17,-5,"12 - 17",0,134,113,241,12769,17956,29,0.415589910496338,12,17,"12 - 17","#0090D4",4,5,"2029"
26,100,150,2029-06-25,1905,9,8,12,"CUN","Cancun Toros","away",1,0,"Eastern Division","PBE",13,17,-4,"13 - 17",5,139,121,253,14641,19321,30,0.431099464106943,13,17,"13 - 17","#0090D4",4,5,"2029"
26,100,155,2029-06-27,1905,9,11,13,"CUN","Cancun Toros","home",1,0,"Eastern Division","PBE",14,17,-3,"14 - 17",7,146,132,266,17424,21316,31,0.449767681982447,14,17,"14 - 17","#0090D4",4,5,"2029"
26,100,159,2029-06-28,1905,9,9,18,"CUN","Cancun Toros","home",1,0,"Eastern Division","PBE",15,17,-2,"15 - 17",0,146,141,284,19881,21316,32,0.482583683277909,15,17,"15 - 17","#0090D4",4,5,"2029"
26,100,164,2029-06-29,1905,9,5,7,"CUN","Cancun Toros","home",0,1,"Eastern Division","PBE",15,18,-3,"15 - 18",7,153,146,291,21316,23409,33,0.47660145332588,16,17,"16 - 17","#0090D4",4,5,"2029"
26,100,169,2029-06-30,1905,9,2,5,"CUN","Cancun Toros","home",0,1,"Eastern Division","PBE",15,19,-4,"15 - 19",6,159,148,296,21904,25281,34,0.464215322666101,16,18,"16 - 18","#0090D4",4,5,"2029"
26,100,175,2029-07-03,1905,9,6,6,"CUN","Cancun Toros","home",1,0,"Eastern Division","PBE",16,19,-3,"16 - 19",3,162,154,302,23716,26244,35,0.474699759807846,17,18,"17 - 18","#0090D4",4,5,"2029"
26,100,180,2029-07-04,1905,9,4,17,"CUN","Cancun Toros","home",0,1,"Eastern Division","PBE",16,20,-4,"16 - 20",12,174,158,319,24964,30276,36,0.451918899348298,16,20,"16 - 20","#0090D4",4,5,"2029"
26,100,185,2029-07-05,1905,9,8,13,"CUN","Cancun Toros","home",1,0,"Eastern Division","PBE",17,20,-3,"17 - 20",3,177,166,332,27556,31329,37,0.467962978687272,17,20,"17 - 20","#0090D4",4,5,"2029"
26,100,190,2029-07-06,1905,9,12,14,"CUN","Cancun Toros","home",1,0,"Eastern Division","PBE",18,20,-2,"18 - 20",3,180,178,346,31684,32400,38,0.494413582173397,19,19,"19 - 19","#0090D4",4,5,"2029"
26,100,194,2029-07-09,1905,9,0,6,"CUN","Cancun Toros","away",0,1,"Eastern Division","PBE",18,21,-3,"18 - 21",2,182,178,352,31684,33124,39,0.488890260461671,19,20,"19 - 20","#0090D4",4,5,"2029"
26,100,199,2029-07-10,1905,9,8,8,"CUN","Cancun Toros","away",1,0,"Eastern Division","PBE",19,21,-2,"19 - 21",6,188,186,360,34596,35344,40,0.494652559336574,20,20,"20 - 20","#0090D4",4,5,"2029"
26,100,204,2029-07-11,1905,9,7,7,"CUN","Cancun Toros","away",1,0,"Eastern Division","PBE",20,21,-1,"20 - 21",0,188,193,367,37249,35344,41,0.513121099830562,21,20,"21 - 20","#0090D4",4,5,"2029"
26,100,209,2029-07-12,1905,9,0,3,"CUN","Cancun Toros","away",0,1,"Eastern Division","PBE",20,22,-2,"20 - 22",5,193,193,370,37249,37249,42,0.5,21,21,"21 - 21","#0090D4",4,5,"2029"
26,100,214,2029-07-15,1905,9,6,8,"CUN","Cancun Toros","home",1,0,"Eastern Division","PBE",21,22,-1,"21 - 22",3,196,199,378,39601,38416,43,0.507594498634913,22,21,"22 - 21","#0090D4",4,5,"2029"
26,100,219,2029-07-16,1905,9,13,15,"CUN","Cancun Toros","home",1,0,"Eastern Division","PBE",22,22,0,"22 - 22",3,199,212,393,44944,39601,44,0.531598556981489,23,21,"23 - 21","#0090D4",4,5,"2029"
26,100,224,2029-07-17,1905,9,10,18,"CUN","Cancun Toros","home",1,0,"Eastern Division","PBE",23,22,1,"23 - 22",0,199,222,411,49284,39601,45,0.554469258030039,25,20,"25 - 20","#0090D4",4,5,"2029"
26,100,229,2029-07-18,1905,9,6,10,"CUN","Cancun Toros","home",1,0,"Eastern Division","PBE",24,22,2,"24 - 22",1,200,228,421,51984,40000,46,0.565141763785006,26,20,"26 - 20","#0090D4",4,5,"2029"
26,100,236,2029-07-21,1905,10,6,7,"CUN","Cancun Toros","home",0,1,"Eastern Division","PBE",24,23,1,"24 - 23",7,207,234,428,54756,42849,47,0.560995850622407,26,21,"26 - 21","#0090D4",4,5,"2029"
26,100,241,2029-07-22,1905,10,6,10,"CUN","Cancun Toros","home",1,0,"Eastern Division","PBE",25,23,2,"25 - 23",5,212,240,438,57600,44944,48,0.561710095178655,27,21,"27 - 21","#0090D4",4,5,"2029"
26,100,246,2029-07-23,1905,12,7,13,"CUN","Cancun Toros","home",1,0,"Eastern Division","PBE",26,23,3,"26 - 23",4,216,247,451,61009,46656,49,0.566655830585613,28,21,"28 - 21","#0090D4",4,5,"2029"
26,100,251,2029-07-24,1905,9,1,5,"CUN","Cancun Toros","home",0,1,"Eastern Division","PBE",26,24,2,"26 - 24",3,219,248,456,61504,47961,50,0.561859955236834,28,22,"28 - 22","#0090D4",4,5,"2029"
27,100,4,2029-05-15,1905,9,2,5,"NSH","Nashville Stars","home",0,1,"Western Division","PBE",0,1,-1,"0 - 1",7,7,2,5,4,49,1,0.0754716981132075,0,1,"0 - 1","#AC0000",5,9,"2029"
27,100,9,2029-05-16,1905,9,1,5,"NSH","Nashville Stars","home",0,1,"Western Division","PBE",0,2,-2,"0 - 2",5,12,3,10,9,144,2,0.0588235294117647,0,2,"0 - 2","#AC0000",5,9,"2029"
27,100,14,2029-05-17,1905,9,7,6,"NSH","Nashville Stars","home",1,0,"Western Division","PBE",1,2,-1,"1 - 2",5,17,10,16,100,289,3,0.25706940874036,1,2,"1 - 2","#AC0000",5,9,"2029"
27,100,19,2029-05-18,1905,9,6,9,"NSH","Nashville Stars","home",1,0,"Western Division","PBE",2,2,0,"2 - 2",1,18,16,25,256,324,4,0.441379310344828,2,2,"2 - 2","#AC0000",5,9,"2029"
27,100,23,2029-05-21,1905,9,4,9,"NSH","Nashville Stars","away",0,1,"Western Division","PBE",2,3,-1,"2 - 3",6,24,20,34,400,576,5,0.409836065573771,2,3,"2 - 3","#AC0000",5,9,"2029"
27,100,28,2029-05-22,1905,9,5,10,"NSH","Nashville Stars","away",1,0,"Western Division","PBE",3,3,0,"3 - 3",3,27,25,44,625,729,6,0.461595273264402,3,3,"3 - 3","#AC0000",5,9,"2029"
27,100,33,2029-05-23,1905,9,6,9,"NSH","Nashville Stars","away",0,1,"Western Division","PBE",3,4,-1,"3 - 4",7,34,31,53,961,1156,7,0.453944260746339,3,4,"3 - 4","#AC0000",5,9,"2029"
27,100,37,2029-05-24,1905,11,3,6,"NSH","Nashville Stars","away",1,0,"Western Division","PBE",4,4,0,"4 - 4",2,36,34,59,1156,1296,8,0.471451876019576,4,4,"4 - 4","#AC0000",5,9,"2029"
27,100,43,2029-05-26,1905,9,1,6,"NSH","Nashville Stars","away",0,1,"Western Division","PBE",4,5,-1,"4 - 5",9,45,35,65,1225,2025,9,0.376923076923077,3,6,"3 - 6","#AC0000",5,9,"2029"
27,100,48,2029-05-27,1905,9,2,4,"NSH","Nashville Stars","away",0,1,"Western Division","PBE",4,6,-2,"4 - 6",6,51,37,69,1369,2601,10,0.344836272040302,3,7,"3 - 7","#AC0000",5,9,"2029"
27,100,53,2029-05-28,1905,9,4,7,"NSH","Nashville Stars","away",1,0,"Western Division","PBE",5,6,-1,"5 - 6",2,53,41,76,1681,2809,11,0.374387527839644,4,7,"4 - 7","#AC0000",5,9,"2029"
27,100,58,2029-05-29,1905,9,2,9,"NSH","Nashville Stars","away",0,1,"Western Division","PBE",5,7,-2,"5 - 7",5,58,43,85,1849,3364,12,0.354690197582966,4,8,"4 - 8","#AC0000",5,9,"2029"
27,100,62,2029-06-01,1905,9,2,7,"NSH","Nashville Stars","home",0,1,"Western Division","PBE",5,8,-3,"5 - 8",9,67,45,92,2025,4489,13,0.310868897758674,4,9,"4 - 9","#AC0000",5,9,"2029"
27,100,67,2029-06-02,1905,10,7,9,"NSH","Nashville Stars","home",1,0,"Western Division","PBE",6,8,-2,"6 - 8",6,73,52,101,2704,5329,14,0.336611477654674,5,9,"5 - 9","#AC0000",5,9,"2029"
27,100,72,2029-06-03,1905,9,4,10,"NSH","Nashville Stars","home",0,1,"Western Division","PBE",6,9,-3,"6 - 9",13,86,56,111,3136,7396,15,0.297759210026586,4,11,"4 - 11","#AC0000",5,9,"2029"
27,100,77,2029-06-04,1905,9,0,2,"NSH","Nashville Stars","home",0,1,"Western Division","PBE",6,10,-4,"6 - 10",4,90,56,113,3136,8100,16,0.279102883588466,4,12,"4 - 12","#AC0000",5,9,"2029"
27,100,82,2029-06-06,1905,13,1,5,"NSH","Nashville Stars","away",0,1,"Western Division","PBE",6,11,-5,"6 - 11",2,92,57,118,3249,8464,17,0.277384103133271,5,12,"5 - 12","#AC0000",5,9,"2029"
27,100,86,2029-06-07,1905,9,5,7,"NSH","Nashville Stars","away",0,1,"Western Division","PBE",6,12,-6,"6 - 12",13,105,62,125,3844,11025,18,0.258524446835698,5,13,"5 - 13","#AC0000",5,9,"2029"
27,100,91,2029-06-08,1905,9,2,12,"NSH","Nashville Stars","away",0,1,"Western Division","PBE",6,13,-7,"6 - 13",3,108,64,137,4096,11664,19,0.25989847715736,5,14,"5 - 14","#AC0000",5,9,"2029"
27,100,95,2029-06-09,1905,9,7,7,"NSH","Nashville Stars","away",1,0,"Western Division","PBE",7,13,-6,"7 - 13",1,109,71,144,5041,11881,20,0.297896229760076,6,14,"6 - 14","#AC0000",5,9,"2029"
27,100,101,2029-06-11,1905,9,2,10,"NSH","Nashville Stars","home",0,1,"Western Division","PBE",7,14,-7,"7 - 14",9,118,73,154,5329,13924,21,0.276788033033813,6,15,"6 - 15","#AC0000",5,9,"2029"
27,100,106,2029-06-12,1905,9,3,5,"NSH","Nashville Stars","home",1,0,"Western Division","PBE",8,14,-6,"8 - 14",2,120,76,159,5776,14400,22,0.286280729579699,6,16,"6 - 16","#AC0000",5,9,"2029"
27,100,111,2029-06-13,1905,9,3,8,"NSH","Nashville Stars","home",0,1,"Western Division","PBE",8,15,-7,"8 - 15",7,127,79,167,6241,16129,23,0.278989718372821,6,17,"6 - 17","#AC0000",5,9,"2029"
27,100,115,2029-06-14,1905,9,4,10,"NSH","Nashville Stars","home",1,0,"Western Division","PBE",9,15,-6,"9 - 15",2,129,83,177,6889,16641,24,0.292775180620484,7,17,"7 - 17","#AC0000",5,9,"2029"
27,100,118,2029-06-16,1905,9,4,7,"NSH","Nashville Stars","away",1,0,"Western Division","PBE",10,15,-5,"10 - 15",3,132,87,184,7569,17424,25,0.302844796543032,8,17,"8 - 17","#AC0000",5,9,"2029"
27,100,123,2029-06-17,1905,9,1,6,"NSH","Nashville Stars","away",0,1,"Western Division","PBE",10,16,-6,"10 - 16",11,143,88,190,7744,20449,26,0.274678111587983,7,19,"7 - 19","#AC0000",5,9,"2029"
27,100,128,2029-06-18,1905,9,0,6,"NSH","Nashville Stars","away",0,1,"Western Division","PBE",10,17,-7,"10 - 17",4,147,88,196,7744,21609,27,0.263823118590945,7,20,"7 - 20","#AC0000",5,9,"2029"
27,100,133,2029-06-19,1905,9,0,1,"NSH","Nashville Stars","away",0,1,"Western Division","PBE",10,18,-8,"10 - 18",6,153,88,197,7744,23409,28,0.248579591050621,7,21,"7 - 21","#AC0000",5,9,"2029"
27,100,137,2029-06-22,1905,9,1,4,"NSH","Nashville Stars","away",0,1,"Western Division","PBE",10,19,-9,"10 - 19",5,158,89,201,7921,24964,29,0.240869697430439,7,22,"7 - 22","#AC0000",5,9,"2029"
27,100,142,2029-06-23,1905,9,0,5,"NSH","Nashville Stars","away",0,1,"Western Division","PBE",10,20,-10,"10 - 20",3,161,89,206,7921,25921,30,0.234058270787778,7,23,"7 - 23","#AC0000",5,9,"2029"
27,100,147,2029-06-24,1905,9,2,8,"NSH","Nashville Stars","away",1,0,"Western Division","PBE",11,20,-9,"11 - 20",0,161,91,214,8281,25921,31,0.242120343839542,8,23,"8 - 23","#AC0000",5,9,"2029"
27,100,152,2029-06-25,1905,9,0,4,"NSH","Nashville Stars","away",0,1,"Western Division","PBE",11,21,-10,"11 - 21",5,166,91,218,8281,27556,32,0.231074029634177,7,25,"7 - 25","#AC0000",5,9,"2029"
27,100,158,2029-06-27,1905,9,5,7,"NSH","Nashville Stars","away",1,0,"Western Division","PBE",12,21,-9,"12 - 21",2,168,96,225,9216,28224,33,0.246153846153846,8,25,"8 - 25","#AC0000",5,9,"2029"
27,100,163,2029-06-28,1905,9,0,5,"NSH","Nashville Stars","away",0,1,"Western Division","PBE",12,22,-10,"12 - 22",1,169,96,230,9216,28561,34,0.243957963840432,8,26,"8 - 26","#AC0000",5,9,"2029"
27,100,168,2029-06-29,1905,9,2,4,"NSH","Nashville Stars","away",0,1,"Western Division","PBE",12,23,-11,"12 - 23",6,175,98,234,9604,30625,35,0.238733252131547,8,27,"8 - 27","#AC0000",5,9,"2029"
27,100,173,2029-06-30,1905,9,3,8,"NSH","Nashville Stars","away",1,0,"Western Division","PBE",13,23,-10,"13 - 23",1,176,101,242,10201,30976,36,0.24773538625932,9,27,"9 - 27","#AC0000",5,9,"2029"
27,100,176,2029-07-03,1905,9,2,5,"NSH","Nashville Stars","home",0,1,"Western Division","PBE",13,24,-11,"13 - 24",6,182,103,247,10609,33124,37,0.242585690439714,9,28,"9 - 28","#AC0000",5,9,"2029"
27,100,181,2029-07-04,1905,9,3,8,"NSH","Nashville Stars","home",0,1,"Western Division","PBE",13,25,-12,"13 - 25",10,192,106,255,11236,36864,38,0.233596673596674,9,29,"9 - 29","#AC0000",5,9,"2029"
27,100,186,2029-07-05,1905,13,5,8,"NSH","Nashville Stars","home",0,1,"Western Division","PBE",13,26,-13,"13 - 26",9,201,111,263,12321,40401,39,0.233697507681803,9,30,"9 - 30","#AC0000",5,9,"2029"
27,100,191,2029-07-06,1905,9,1,5,"NSH","Nashville Stars","home",0,1,"Western Division","PBE",13,27,-14,"13 - 27",7,208,112,268,12544,43264,40,0.224770642201835,9,31,"9 - 31","#AC0000",5,9,"2029"
27,100,197,2029-07-09,1905,15,3,8,"NSH","Nashville Stars","home",0,1,"Western Division","PBE",13,28,-15,"13 - 28",8,216,115,276,13225,46656,41,0.220854695145372,9,32,"9 - 32","#AC0000",5,9,"2029"
27,100,202,2029-07-10,1905,9,7,8,"NSH","Nashville Stars","home",1,0,"Western Division","PBE",14,28,-14,"14 - 28",6,222,122,284,14884,49284,42,0.231953621742925,10,32,"10 - 32","#AC0000",5,9,"2029"
27,100,207,2029-07-11,1905,9,7,7,"NSH","Nashville Stars","home",1,0,"Western Division","PBE",15,28,-13,"15 - 28",5,227,129,291,16641,51529,43,0.244110312454159,10,33,"10 - 33","#AC0000",5,9,"2029"
27,100,212,2029-07-12,1905,9,4,7,"NSH","Nashville Stars","home",1,0,"Western Division","PBE",16,28,-12,"16 - 28",3,230,133,298,17689,52900,44,0.250591451925937,11,33,"11 - 33","#AC0000",5,9,"2029"
27,100,214,2029-07-15,1905,9,3,6,"NSH","Nashville Stars","away",0,1,"Western Division","PBE",16,29,-13,"16 - 29",6,236,136,304,18496,55696,45,0.249299115807634,11,34,"11 - 34","#AC0000",5,9,"2029"
27,100,219,2029-07-16,1905,9,3,9,"NSH","Nashville Stars","away",0,1,"Western Division","PBE",16,30,-14,"16 - 30",13,249,139,313,19321,62001,46,0.237586384988072,11,35,"11 - 35","#AC0000",5,9,"2029"
27,100,224,2029-07-17,1905,9,0,1,"NSH","Nashville Stars","away",0,1,"Western Division","PBE",16,31,-15,"16 - 31",10,259,139,314,19321,67081,47,0.223617508853962,11,36,"11 - 36","#AC0000",5,9,"2029"
27,100,229,2029-07-18,1905,9,1,5,"NSH","Nashville Stars","away",0,1,"Western Division","PBE",16,32,-16,"16 - 32",6,265,140,319,19600,70225,48,0.218202059560256,10,38,"10 - 38","#AC0000",5,9,"2029"
27,100,238,2029-07-21,1905,9,3,5,"NSH","Nashville Stars","home",0,1,"Western Division","PBE",16,33,-17,"16 - 33",4,269,143,324,20449,72361,49,0.220331860790863,11,38,"11 - 38","#AC0000",5,9,"2029"
27,100,243,2029-07-22,1905,12,3,9,"NSH","Nashville Stars","home",1,0,"Western Division","PBE",17,33,-16,"17 - 33",2,271,146,333,21316,73441,50,0.224954356934052,11,39,"11 - 39","#AC0000",5,9,"2029"
27,100,248,2029-07-23,1905,9,5,10,"NSH","Nashville Stars","home",0,1,"Western Division","PBE",17,34,-17,"17 - 34",10,281,151,343,22801,78961,51,0.224062027082801,11,40,"11 - 40","#AC0000",5,9,"2029"
27,100,253,2029-07-24,1905,9,4,12,"NSH","Nashville Stars","home",1,0,"Western Division","PBE",18,34,-16,"18 - 34",2,283,155,355,24025,80089,52,0.230756670572642,12,40,"12 - 40","#AC0000",5,9,"2029"
28,101,304,2029-05-16,1905,9,4,8,"KC","Kansas City Hepcats","home",1,0,"West Division","MiLPBE",1,0,1,"1 - 0",2,2,4,8,16,4,1,0.8,1,0,"1 - 0","#6595E3",3,5,"2029"
28,101,307,2029-05-17,1905,9,5,7,"KC","Kansas City Hepcats","home",1,0,"West Division","MiLPBE",2,0,2,"2 - 0",4,6,9,15,81,36,2,0.692307692307692,1,1,"1 - 1","#6595E3",3,5,"2029"
28,101,310,2029-05-18,1905,9,4,18,"KC","Kansas City Hepcats","home",0,1,"West Division","MiLPBE",2,1,1,"2 - 1",9,15,13,33,169,225,3,0.428934010152284,1,2,"1 - 2","#6595E3",3,5,"2029"
28,101,313,2029-05-19,1905,14,6,13,"KC","Kansas City Hepcats","home",0,1,"West Division","MiLPBE",2,2,0,"2 - 2",7,22,19,46,361,484,4,0.427218934911243,2,2,"2 - 2","#6595E3",3,5,"2029"
28,101,315,2029-05-21,1905,9,7,14,"KC","Kansas City Hepcats","away",1,0,"West Division","MiLPBE",3,2,1,"3 - 2",4,26,26,60,676,676,5,0.5,2,3,"2 - 3","#6595E3",3,5,"2029"
28,101,318,2029-05-22,1905,9,10,15,"KC","Kansas City Hepcats","away",1,0,"West Division","MiLPBE",4,2,2,"4 - 2",7,33,36,75,1296,1089,6,0.543396226415094,3,3,"3 - 3","#6595E3",3,5,"2029"
28,101,321,2029-05-23,1905,9,4,8,"KC","Kansas City Hepcats","away",1,0,"West Division","MiLPBE",5,2,3,"5 - 2",3,36,40,83,1600,1296,7,0.552486187845304,4,3,"4 - 3","#6595E3",3,5,"2029"
28,101,324,2029-05-24,1905,9,7,13,"KC","Kansas City Hepcats","away",1,0,"West Division","MiLPBE",6,2,4,"6 - 2",1,37,47,96,2209,1369,8,0.617384013415316,5,3,"5 - 3","#6595E3",3,5,"2029"
28,101,326,2029-05-27,1905,10,4,10,"KC","Kansas City Hepcats","away",1,0,"West Division","MiLPBE",7,2,5,"7 - 2",3,40,51,106,2601,1600,9,0.619138300404666,6,3,"6 - 3","#6595E3",3,5,"2029"
28,101,329,2029-05-28,1905,9,0,5,"KC","Kansas City Hepcats","away",0,1,"West Division","MiLPBE",7,3,4,"7 - 3",10,50,51,111,2601,2500,10,0.509900019603999,5,5,"5 - 5","#6595E3",3,5,"2029"
28,101,332,2029-05-29,1905,9,4,5,"KC","Kansas City Hepcats","away",0,1,"West Division","MiLPBE",7,4,3,"7 - 4",6,56,55,116,3025,3136,11,0.490991722123032,5,6,"5 - 6","#6595E3",3,5,"2029"
28,101,335,2029-05-30,1905,9,2,7,"KC","Kansas City Hepcats","away",0,1,"West Division","MiLPBE",7,5,2,"7 - 5",7,63,57,123,3249,3969,12,0.450124688279302,5,7,"5 - 7","#6595E3",3,5,"2029"
28,101,339,2029-06-02,1905,9,4,13,"KC","Kansas City Hepcats","home",1,0,"West Division","MiLPBE",8,5,3,"8 - 5",0,63,61,136,3721,3969,13,0.483875162548765,6,7,"6 - 7","#6595E3",3,5,"2029"
28,101,342,2029-06-03,1905,9,2,7,"KC","Kansas City Hepcats","home",0,1,"West Division","MiLPBE",8,6,2,"8 - 6",3,66,63,143,3969,4356,14,0.476756756756757,7,7,"7 - 7","#6595E3",3,5,"2029"
28,101,345,2029-06-04,1905,9,8,10,"KC","Kansas City Hepcats","home",1,0,"West Division","MiLPBE",9,6,3,"9 - 6",3,69,71,153,5041,4761,15,0.514282799428688,8,7,"8 - 7","#6595E3",3,5,"2029"
28,101,348,2029-06-05,1905,9,0,5,"KC","Kansas City Hepcats","home",0,1,"West Division","MiLPBE",9,7,2,"9 - 7",5,74,71,158,5041,5476,16,0.479319197489778,8,8,"8 - 8","#6595E3",3,5,"2029"
28,101,352,2029-06-08,1905,9,4,11,"KC","Kansas City Hepcats","away",0,1,"West Division","MiLPBE",9,8,1,"9 - 8",8,82,75,169,5625,6724,17,0.455502469835614,8,9,"8 - 9","#6595E3",3,5,"2029"
28,101,355,2029-06-09,1905,9,5,9,"KC","Kansas City Hepcats","away",1,0,"West Division","MiLPBE",10,8,2,"10 - 8",2,84,80,178,6400,7056,18,0.475624256837099,9,9,"9 - 9","#6595E3",3,5,"2029"
28,101,358,2029-06-10,1905,9,3,5,"KC","Kansas City Hepcats","away",1,0,"West Division","MiLPBE",11,8,3,"11 - 8",2,86,83,183,6889,7396,19,0.482254112705635,9,10,"9 - 10","#6595E3",3,5,"2029"
28,101,361,2029-06-11,1905,9,4,8,"KC","Kansas City Hepcats","away",0,1,"West Division","MiLPBE",11,9,2,"11 - 9",5,91,87,191,7569,8281,20,0.477539432176656,10,10,"10 - 10","#6595E3",3,5,"2029"
28,101,364,2029-06-14,1905,9,0,6,"KC","Kansas City Hepcats","away",0,1,"West Division","MiLPBE",11,10,1,"11 - 10",8,99,87,197,7569,9801,21,0.435751295336788,9,12,"9 - 12","#6595E3",3,5,"2029"
28,101,367,2029-06-15,1905,10,5,12,"KC","Kansas City Hepcats","away",0,1,"West Division","MiLPBE",11,11,0,"11 - 11",6,105,92,209,8464,11025,22,0.434296269690595,10,12,"10 - 12","#6595E3",3,5,"2029"
28,101,370,2029-06-16,1905,9,5,7,"KC","Kansas City Hepcats","away",1,0,"West Division","MiLPBE",12,11,1,"12 - 11",3,108,97,216,9409,11664,23,0.446495515588668,10,13,"10 - 13","#6595E3",3,5,"2029"
28,101,373,2029-06-17,1905,9,4,11,"KC","Kansas City Hepcats","away",0,1,"West Division","MiLPBE",12,12,0,"12 - 12",7,115,101,227,10201,13225,24,0.435456330572868,10,14,"10 - 14","#6595E3",3,5,"2029"
28,101,375,2029-06-20,1905,9,2,10,"KC","Kansas City Hepcats","home",0,1,"West Division","MiLPBE",12,13,-1,"12 - 13",3,118,103,237,10609,13924,25,0.43243794073289,11,14,"11 - 14","#6595E3",3,5,"2029"
28,101,378,2029-06-21,1905,9,2,6,"KC","Kansas City Hepcats","home",1,0,"West Division","MiLPBE",13,13,0,"13 - 13",0,118,105,243,11025,13924,26,0.441901479017195,11,15,"11 - 15","#6595E3",3,5,"2029"
28,101,381,2029-06-22,1905,9,5,7,"KC","Kansas City Hepcats","home",1,0,"West Division","MiLPBE",14,13,1,"14 - 13",4,122,110,250,12100,14884,27,0.448413874888823,12,15,"12 - 15","#6595E3",3,5,"2029"
28,101,510,2029-06-23,1905,9,4,11,"KC","Kansas City Hepcats","home",1,0,"West Division","MiLPBE",15,13,2,"15 - 13",3,125,114,261,12996,15625,28,0.454072184759442,13,15,"13 - 15","#6595E3",3,5,"2029"
28,101,512,2029-07-15,1405,9,2,5,"KC","Kansas City Hepcats","home",0,1,"West Division","MiLPBE",15,14,1,"15 - 14",10,135,116,266,13456,18225,29,0.424734067737761,12,17,"12 - 17","#6595E3",3,5,"2029"
28,101,515,2029-06-25,1905,9,4,6,"KC","Kansas City Hepcats","home",0,1,"West Division","MiLPBE",15,15,0,"15 - 15",6,141,120,272,14400,19881,30,0.420057757941717,13,17,"13 - 17","#6595E3",3,5,"2029"
28,101,518,2029-06-26,1905,9,3,6,"KC","Kansas City Hepcats","home",0,1,"West Division","MiLPBE",15,16,-1,"15 - 16",8,149,123,278,15129,22201,31,0.405277256897937,13,18,"13 - 18","#6595E3",3,5,"2029"
28,101,521,2029-06-27,1905,9,1,9,"KC","Kansas City Hepcats","home",0,1,"West Division","MiLPBE",15,17,-2,"15 - 17",8,157,124,287,15376,24649,32,0.384159900062461,12,20,"12 - 20","#6595E3",3,5,"2029"
28,101,524,2029-06-28,1905,9,3,13,"KC","Kansas City Hepcats","home",1,0,"West Division","MiLPBE",16,17,-1,"16 - 17",0,157,127,300,16129,24649,33,0.395531904458286,13,20,"13 - 20","#6595E3",3,5,"2029"
28,101,528,2029-07-01,1905,9,5,11,"KC","Kansas City Hepcats","away",0,1,"West Division","MiLPBE",16,18,-2,"16 - 18",11,168,132,311,17424,28224,34,0.381703470031546,13,21,"13 - 21","#6595E3",3,5,"2029"
28,101,531,2029-07-02,1905,9,5,9,"KC","Kansas City Hepcats","away",0,1,"West Division","MiLPBE",16,19,-3,"16 - 19",6,174,137,320,18769,30276,35,0.382689366907942,13,22,"13 - 22","#6595E3",3,5,"2029"
28,101,534,2029-07-03,1905,9,1,6,"KC","Kansas City Hepcats","away",0,1,"West Division","MiLPBE",16,20,-4,"16 - 20",10,184,138,326,19044,33856,36,0.36,13,23,"13 - 23","#6595E3",3,5,"2029"
28,101,537,2029-07-04,1905,9,7,11,"KC","Kansas City Hepcats","away",0,1,"West Division","MiLPBE",16,21,-5,"16 - 21",8,192,145,337,21025,36864,37,0.363195080239769,13,24,"13 - 24","#6595E3",3,5,"2029"
28,101,541,2029-07-07,1905,9,0,5,"KC","Kansas City Hepcats","home",0,1,"West Division","MiLPBE",16,22,-6,"16 - 22",5,197,145,342,21025,38809,38,0.351388842464151,13,25,"13 - 25","#6595E3",3,5,"2029"
28,101,544,2029-07-08,1905,9,5,8,"KC","Kansas City Hepcats","home",1,0,"West Division","MiLPBE",17,22,-5,"17 - 22",4,201,150,350,22500,40401,39,0.357704964944913,14,25,"14 - 25","#6595E3",3,5,"2029"
28,101,547,2029-07-09,1905,9,6,11,"KC","Kansas City Hepcats","home",1,0,"West Division","MiLPBE",18,22,-4,"18 - 22",3,204,156,361,24336,41616,40,0.368995633187773,15,25,"15 - 25","#6595E3",3,5,"2029"
28,101,550,2029-07-10,1905,9,5,18,"KC","Kansas City Hepcats","home",1,0,"West Division","MiLPBE",19,22,-3,"19 - 22",4,208,161,379,25921,43264,41,0.374662137746621,15,26,"15 - 26","#6595E3",3,5,"2029"
28,101,553,2029-07-12,1905,9,3,6,"KC","Kansas City Hepcats","home",0,1,"West Division","MiLPBE",19,23,-4,"19 - 23",4,212,164,385,26896,44944,42,0.374387527839644,16,26,"16 - 26","#6595E3",3,5,"2029"
28,101,556,2029-07-13,1905,9,6,8,"KC","Kansas City Hepcats","home",1,0,"West Division","MiLPBE",20,23,-3,"20 - 23",4,216,170,393,28900,46656,43,0.382497750013235,16,27,"16 - 27","#6595E3",3,5,"2029"
28,101,559,2029-07-14,1905,9,3,8,"KC","Kansas City Hepcats","home",0,1,"West Division","MiLPBE",20,24,-4,"20 - 24",11,227,173,401,29929,51529,44,0.367416337253554,16,28,"16 - 28","#6595E3",3,5,"2029"
28,101,561,2029-07-18,1905,9,9,15,"KC","Kansas City Hepcats","away",1,0,"West Division","MiLPBE",21,24,-3,"21 - 24",1,228,182,416,33124,51984,45,0.389199605207501,18,27,"18 - 27","#6595E3",3,5,"2029"
28,101,564,2029-07-19,1905,9,5,9,"KC","Kansas City Hepcats","away",0,1,"West Division","MiLPBE",21,25,-4,"21 - 25",10,238,187,425,34969,56644,46,0.381703470031546,18,28,"18 - 28","#6595E3",3,5,"2029"
28,101,567,2029-07-20,1905,9,3,7,"KC","Kansas City Hepcats","away",0,1,"West Division","MiLPBE",21,26,-5,"21 - 26",6,244,190,432,36100,59536,47,0.377472918147978,18,29,"18 - 29","#6595E3",3,5,"2029"
28,101,570,2029-07-21,1905,9,4,10,"KC","Kansas City Hepcats","away",0,1,"West Division","MiLPBE",21,27,-6,"21 - 27",8,252,194,442,37636,63504,48,0.372117856436622,18,30,"18 - 30","#6595E3",3,5,"2029"
28,101,574,2029-07-24,1905,9,2,6,"KC","Kansas City Hepcats","home",0,1,"West Division","MiLPBE",21,28,-7,"21 - 28",9,261,196,448,38416,68121,49,0.360588340201057,18,31,"18 - 31","#6595E3",3,5,"2029"
28,101,577,2029-07-25,1905,9,9,18,"KC","Kansas City Hepcats","home",1,0,"West Division","MiLPBE",22,28,-6,"22 - 28",3,264,205,466,42025,69696,50,0.376160256352879,19,31,"19 - 31","#6595E3",3,5,"2029"
28,101,580,2029-07-26,1905,9,2,8,"KC","Kansas City Hepcats","home",0,1,"West Division","MiLPBE",22,29,-7,"22 - 29",7,271,207,474,42849,73441,51,0.368466764124172,19,32,"19 - 32","#6595E3",3,5,"2029"
28,101,583,2029-07-27,1905,9,3,6,"KC","Kansas City Hepcats","home",0,1,"West Division","MiLPBE",22,30,-8,"22 - 30",4,275,210,480,44100,75625,52,0.368344121946127,19,33,"19 - 33","#6595E3",3,5,"2029"
29,101,302,2029-05-16,1905,9,1,7,"DAL","Dallas Dynamos","home",0,1,"East Division","MiLPBE",0,1,-1,"0 - 1",5,5,1,7,1,25,1,0.0384615384615385,0,1,"0 - 1","#00FFFF",3,6,"2029"
29,101,305,2029-05-17,1905,9,2,6,"DAL","Dallas Dynamos","home",1,0,"East Division","MiLPBE",1,1,0,"1 - 1",0,5,3,13,9,25,2,0.264705882352941,1,1,"1 - 1","#00FFFF",3,6,"2029"
29,101,308,2029-05-18,1905,9,8,9,"DAL","Dallas Dynamos","home",1,0,"East Division","MiLPBE",2,1,1,"2 - 1",2,7,11,22,121,49,3,0.711764705882353,2,1,"2 - 1","#00FFFF",3,6,"2029"
29,101,311,2029-05-19,1905,9,4,10,"DAL","Dallas Dynamos","home",0,1,"East Division","MiLPBE",2,2,0,"2 - 2",9,16,15,32,225,256,4,0.467775467775468,2,2,"2 - 2","#00FFFF",3,6,"2029"
29,101,315,2029-05-21,1905,9,4,11,"DAL","Dallas Dynamos","home",0,1,"East Division","MiLPBE",2,3,-1,"2 - 3",7,23,19,43,361,529,5,0.40561797752809,2,3,"2 - 3","#00FFFF",3,6,"2029"
29,101,318,2029-05-22,1905,9,7,15,"DAL","Dallas Dynamos","home",0,1,"East Division","MiLPBE",2,4,-2,"2 - 4",10,33,26,58,676,1089,6,0.38300283286119,2,4,"2 - 4","#00FFFF",3,6,"2029"
29,101,321,2029-05-23,1905,9,3,8,"DAL","Dallas Dynamos","home",0,1,"East Division","MiLPBE",2,5,-3,"2 - 5",4,37,29,66,841,1369,7,0.380542986425339,3,4,"3 - 4","#00FFFF",3,6,"2029"
29,101,324,2029-05-24,1905,9,1,8,"DAL","Dallas Dynamos","home",0,1,"East Division","MiLPBE",2,6,-4,"2 - 6",7,44,30,74,900,1936,8,0.317348377997179,3,5,"3 - 5","#00FFFF",3,6,"2029"
29,101,328,2029-05-27,1905,9,1,3,"DAL","Dallas Dynamos","away",0,1,"East Division","MiLPBE",2,7,-5,"2 - 7",4,48,31,77,961,2304,9,0.294333843797856,3,6,"3 - 6","#00FFFF",3,6,"2029"
29,101,331,2029-05-28,1905,9,8,13,"DAL","Dallas Dynamos","away",1,0,"East Division","MiLPBE",3,7,-4,"3 - 7",4,52,39,90,1521,2704,10,0.36,4,6,"4 - 6","#00FFFF",3,6,"2029"
29,101,334,2029-05-29,1905,9,1,4,"DAL","Dallas Dynamos","away",0,1,"East Division","MiLPBE",3,8,-5,"3 - 8",2,54,40,94,1600,2916,11,0.354295837023915,4,7,"4 - 7","#00FFFF",3,6,"2029"
29,101,337,2029-05-30,1905,9,4,5,"DAL","Dallas Dynamos","away",1,0,"East Division","MiLPBE",4,8,-4,"4 - 8",3,57,44,99,1936,3249,12,0.373384763741562,4,8,"4 - 8","#00FFFF",3,6,"2029"
29,101,340,2029-06-02,1905,9,2,9,"DAL","Dallas Dynamos","home",0,1,"East Division","MiLPBE",4,9,-5,"4 - 9",5,62,46,108,2116,3844,13,0.35503355704698,5,8,"5 - 8","#00FFFF",3,6,"2029"
29,101,343,2029-06-03,1905,9,0,7,"DAL","Dallas Dynamos","home",0,1,"East Division","MiLPBE",4,10,-6,"4 - 10",5,67,46,115,2116,4489,14,0.320363361090083,4,10,"4 - 10","#00FFFF",3,6,"2029"
29,101,346,2029-06-04,1905,9,7,12,"DAL","Dallas Dynamos","home",0,1,"East Division","MiLPBE",4,11,-7,"4 - 11",12,79,53,127,2809,6241,15,0.310386740331492,5,10,"5 - 10","#00FFFF",3,6,"2029"
29,101,349,2029-06-05,1905,9,6,6,"DAL","Dallas Dynamos","home",0,1,"East Division","MiLPBE",4,12,-8,"4 - 12",7,86,59,133,3481,7396,16,0.320033097361405,5,11,"5 - 11","#00FFFF",3,6,"2029"
29,101,351,2029-06-08,1905,9,4,10,"DAL","Dallas Dynamos","home",1,0,"East Division","MiLPBE",5,12,-7,"5 - 12",2,88,63,143,3969,7744,17,0.338854264492444,6,11,"6 - 11","#00FFFF",3,6,"2029"
29,101,354,2029-06-09,1905,9,4,11,"DAL","Dallas Dynamos","home",0,1,"East Division","MiLPBE",5,13,-8,"5 - 13",7,95,67,154,4489,9025,18,0.332174041734498,6,12,"6 - 12","#00FFFF",3,6,"2029"
29,101,357,2029-06-10,1905,9,4,13,"DAL","Dallas Dynamos","home",0,1,"East Division","MiLPBE",5,14,-9,"5 - 14",16,111,71,167,5041,12321,19,0.290346734247207,6,13,"6 - 13","#00FFFF",3,6,"2029"
29,101,360,2029-06-11,1905,9,1,7,"DAL","Dallas Dynamos","home",0,1,"East Division","MiLPBE",5,15,-10,"5 - 15",10,121,72,174,5184,14641,20,0.261488020176545,5,15,"5 - 15","#00FFFF",3,6,"2029"
29,101,362,2029-06-14,1905,9,1,2,"DAL","Dallas Dynamos","away",0,1,"East Division","MiLPBE",5,16,-11,"5 - 16",5,126,73,176,5329,15876,21,0.251308653619429,5,16,"5 - 16","#00FFFF",3,6,"2029"
29,101,365,2029-06-15,1905,9,1,7,"DAL","Dallas Dynamos","away",0,1,"East Division","MiLPBE",5,17,-12,"5 - 17",3,129,74,183,5476,16641,22,0.24759234977619,5,17,"5 - 17","#00FFFF",3,6,"2029"
29,101,368,2029-06-16,1905,9,5,12,"DAL","Dallas Dynamos","away",1,0,"East Division","MiLPBE",6,17,-11,"6 - 17",1,130,79,195,6241,16900,23,0.269694481655935,6,17,"6 - 17","#00FFFF",3,6,"2029"
29,101,371,2029-06-17,1905,9,3,8,"DAL","Dallas Dynamos","away",0,1,"East Division","MiLPBE",6,18,-12,"6 - 18",11,141,82,203,6724,19881,24,0.252734448411953,6,18,"6 - 18","#00FFFF",3,6,"2029"
29,101,375,2029-06-20,1905,9,3,8,"DAL","Dallas Dynamos","away",1,0,"East Division","MiLPBE",7,18,-11,"7 - 18",2,143,85,211,7225,20449,25,0.261075377610754,7,18,"7 - 18","#00FFFF",3,6,"2029"
29,101,378,2029-06-21,1905,9,0,5,"DAL","Dallas Dynamos","away",0,1,"East Division","MiLPBE",7,19,-12,"7 - 19",2,145,85,216,7225,21025,26,0.255752212389381,7,19,"7 - 19","#00FFFF",3,6,"2029"
29,101,381,2029-06-22,1905,9,4,12,"DAL","Dallas Dynamos","away",0,1,"East Division","MiLPBE",7,20,-13,"7 - 20",5,150,89,228,7921,22500,27,0.260379343216857,7,20,"7 - 20","#00FFFF",3,6,"2029"
29,101,510,2029-06-23,1905,9,3,10,"DAL","Dallas Dynamos","away",0,1,"East Division","MiLPBE",7,21,-14,"7 - 21",4,154,92,238,8464,23716,28,0.263020509633313,7,21,"7 - 21","#00FFFF",3,6,"2029"
29,101,513,2029-07-15,1905,10,6,13,"DAL","Dallas Dynamos","home",0,1,"East Division","MiLPBE",7,22,-15,"7 - 22",8,162,98,251,9604,26244,29,0.267908948895336,8,21,"8 - 21","#00FFFF",3,6,"2029"
29,101,517,2029-06-25,1905,9,5,11,"DAL","Dallas Dynamos","home",1,0,"East Division","MiLPBE",8,22,-14,"8 - 22",2,164,103,262,10609,26896,30,0.282868950806559,8,22,"8 - 22","#00FFFF",3,6,"2029"
29,101,520,2029-06-26,1905,9,4,13,"DAL","Dallas Dynamos","home",1,0,"East Division","MiLPBE",9,22,-13,"9 - 22",2,166,107,275,11449,27556,31,0.293526470965261,9,22,"9 - 22","#00FFFF",3,6,"2029"
29,101,523,2029-06-27,1905,9,5,10,"DAL","Dallas Dynamos","home",0,1,"East Division","MiLPBE",9,23,-14,"9 - 23",8,174,112,285,12544,30276,32,0.292947220924802,9,23,"9 - 23","#00FFFF",3,6,"2029"
29,101,526,2029-06-28,1905,9,3,11,"DAL","Dallas Dynamos","home",0,1,"East Division","MiLPBE",9,24,-15,"9 - 24",7,181,115,296,13225,32761,33,0.287587526638542,9,24,"9 - 24","#00FFFF",3,6,"2029"
29,101,529,2029-07-01,1905,9,5,8,"DAL","Dallas Dynamos","away",0,1,"East Division","MiLPBE",9,25,-16,"9 - 25",6,187,120,304,14400,34969,34,0.29168101440175,10,24,"10 - 24","#00FFFF",3,6,"2029"
29,101,532,2029-07-02,1905,9,0,3,"DAL","Dallas Dynamos","away",0,1,"East Division","MiLPBE",9,26,-17,"9 - 26",12,199,120,307,14400,39601,35,0.266661728486509,9,26,"9 - 26","#00FFFF",3,6,"2029"
29,101,535,2029-07-03,1905,9,3,9,"DAL","Dallas Dynamos","away",0,1,"East Division","MiLPBE",9,27,-18,"9 - 27",6,205,123,316,15129,42025,36,0.264705882352941,10,26,"10 - 26","#00FFFF",3,6,"2029"
29,101,538,2029-07-04,1905,9,6,11,"DAL","Dallas Dynamos","away",0,1,"East Division","MiLPBE",9,28,-19,"9 - 28",15,220,129,327,16641,48400,37,0.255853999784751,9,28,"9 - 28","#00FFFF",3,6,"2029"
29,101,540,2029-07-07,1905,9,5,13,"DAL","Dallas Dynamos","away",1,0,"East Division","MiLPBE",10,28,-18,"10 - 28",2,222,134,340,17956,49284,38,0.267043426531826,10,28,"10 - 28","#00FFFF",3,6,"2029"
29,101,543,2029-07-08,1905,9,14,17,"DAL","Dallas Dynamos","away",1,0,"East Division","MiLPBE",11,28,-17,"11 - 28",5,227,148,357,21904,51529,39,0.298285511963286,12,27,"12 - 27","#00FFFF",3,6,"2029"
29,101,546,2029-07-09,1905,9,4,6,"DAL","Dallas Dynamos","away",0,1,"East Division","MiLPBE",11,29,-18,"11 - 29",9,236,152,363,23104,55696,40,0.293197969543147,12,28,"12 - 28","#00FFFF",3,6,"2029"
29,101,549,2029-07-10,1905,9,5,11,"DAL","Dallas Dynamos","away",0,1,"East Division","MiLPBE",11,30,-19,"11 - 30",11,247,157,374,24649,61009,41,0.287760629480025,12,29,"12 - 29","#00FFFF",3,6,"2029"
29,101,551,2029-07-12,1905,9,5,7,"DAL","Dallas Dynamos","home",1,0,"East Division","MiLPBE",12,30,-18,"12 - 30",4,251,162,381,26244,63001,42,0.294066894503894,12,30,"12 - 30","#00FFFF",3,6,"2029"
29,101,554,2029-07-13,1905,9,8,10,"DAL","Dallas Dynamos","home",1,0,"East Division","MiLPBE",13,30,-17,"13 - 30",0,251,170,391,28900,63001,43,0.314468830589439,14,29,"14 - 29","#00FFFF",3,6,"2029"
29,101,557,2029-07-14,1905,9,2,6,"DAL","Dallas Dynamos","home",0,1,"East Division","MiLPBE",13,31,-18,"13 - 31",4,255,172,397,29584,65025,44,0.312697523491423,14,30,"14 - 30","#00FFFF",3,6,"2029"
29,101,561,2029-07-18,1905,9,1,8,"DAL","Dallas Dynamos","home",0,1,"East Division","MiLPBE",13,32,-19,"13 - 32",9,264,173,405,29929,69696,45,0.300416562107905,14,31,"14 - 31","#00FFFF",3,6,"2029"
29,101,564,2029-07-19,1905,9,10,12,"DAL","Dallas Dynamos","home",1,0,"East Division","MiLPBE",14,32,-18,"14 - 32",5,269,183,417,33489,72361,46,0.31638167217761,15,31,"15 - 31","#00FFFF",3,6,"2029"
29,101,567,2029-07-20,1905,9,6,14,"DAL","Dallas Dynamos","home",1,0,"East Division","MiLPBE",15,32,-17,"15 - 32",3,272,189,431,35721,73984,47,0.325609589353266,15,32,"15 - 32","#00FFFF",3,6,"2029"
29,101,570,2029-07-21,1905,9,8,11,"DAL","Dallas Dynamos","home",1,0,"East Division","MiLPBE",16,32,-16,"16 - 32",4,276,197,442,38809,76176,48,0.337513588728965,16,32,"16 - 32","#00FFFF",3,6,"2029"
29,101,573,2029-07-24,1905,9,2,5,"DAL","Dallas Dynamos","away",0,1,"East Division","MiLPBE",16,33,-17,"16 - 33",6,282,199,447,39601,79524,49,0.332432318992655,16,33,"16 - 33","#00FFFF",3,6,"2029"
29,101,576,2029-07-25,1905,9,6,10,"DAL","Dallas Dynamos","away",1,0,"East Division","MiLPBE",17,33,-16,"17 - 33",5,287,205,457,42025,82369,50,0.337837837837838,17,33,"17 - 33","#00FFFF",3,6,"2029"
29,101,579,2029-07-26,1905,9,7,8,"DAL","Dallas Dynamos","away",0,1,"East Division","MiLPBE",17,34,-17,"17 - 34",9,296,212,465,44944,87616,51,0.339046469523235,17,34,"17 - 34","#00FFFF",3,6,"2029"
29,101,582,2029-07-27,1905,9,5,12,"DAL","Dallas Dynamos","away",0,1,"East Division","MiLPBE",17,35,-18,"17 - 35",6,302,217,477,47089,91204,52,0.340501688444101,18,34,"18 - 34","#00FFFF",3,6,"2029"
