"team_id","league_id","game_id","date","time","innings","runs","hits","team_abbr","team_name","home/away","win","loss","division","league_abbr","ttl_wins","ttl_losses","below.500","winloss","RA","ttl_ra","ttl_runs","ttl_hits","ttl_rs_sq","ttl_ra_sq","gp","wp","pythag_win","pythag_loss","pythag_record","Primary Color","Division Standing","League Standing","season"
1,100,1,2030-05-15,1905,9,0,3,"NYV","New York Voyagers","away",0,1,"Eastern Division","PBE",0,1,-1,"0 - 1",1,1,0,3,0,1,1,0,0,1,"0 - 1","#0E1540",4,8,"2030"
1,100,6,2030-05-16,1905,9,7,12,"NYV","New York Voyagers","away",1,0,"Eastern Division","PBE",1,1,0,"1 - 1",6,7,7,15,49,49,2,0.5,1,1,"1 - 1","#0E1540",4,8,"2030"
1,100,11,2030-05-17,1905,9,4,7,"NYV","New York Voyagers","away",1,0,"Eastern Division","PBE",2,1,1,"2 - 1",3,10,11,22,121,100,3,0.547511312217195,2,1,"2 - 1","#0E1540",4,8,"2030"
1,100,16,2030-05-18,1905,9,4,8,"NYV","New York Voyagers","away",0,1,"Eastern Division","PBE",2,2,0,"2 - 2",8,18,15,30,225,324,4,0.409836065573771,2,2,"2 - 2","#0E1540",4,8,"2030"
1,100,22,2030-05-21,1905,9,0,5,"NYV","New York Voyagers","home",0,1,"Eastern Division","PBE",2,3,-1,"2 - 3",3,21,15,35,225,441,5,0.337837837837838,2,3,"2 - 3","#0E1540",4,8,"2030"
1,100,27,2030-05-22,1905,9,1,8,"NYV","New York Voyagers","home",0,1,"Eastern Division","PBE",2,4,-2,"2 - 4",5,26,16,43,256,676,6,0.274678111587983,2,4,"2 - 4","#0E1540",4,8,"2030"
1,100,32,2030-05-23,1905,9,1,4,"NYV","New York Voyagers","home",0,1,"Eastern Division","PBE",2,5,-3,"2 - 5",7,33,17,47,289,1089,7,0.209724238026125,1,6,"1 - 6","#0E1540",4,8,"2030"
1,100,36,2030-05-24,1905,9,3,5,"NYV","New York Voyagers","home",0,1,"Eastern Division","PBE",2,6,-4,"2 - 6",9,42,20,52,400,1764,8,0.184842883548983,1,7,"1 - 7","#0E1540",4,8,"2030"
1,100,40,2030-05-26,1905,9,5,11,"NYV","New York Voyagers","away",1,0,"Eastern Division","PBE",3,6,-3,"3 - 6",3,45,25,63,625,2025,9,0.235849056603774,2,7,"2 - 7","#0E1540",4,8,"2030"
1,100,44,2030-05-27,1905,9,2,6,"NYV","New York Voyagers","away",0,1,"Eastern Division","PBE",3,7,-4,"3 - 7",8,53,27,69,729,2809,10,0.206048615036744,2,8,"2 - 8","#0E1540",4,8,"2030"
1,100,49,2030-05-28,1905,9,1,2,"NYV","New York Voyagers","away",0,1,"Eastern Division","PBE",3,8,-5,"3 - 8",5,58,28,71,784,3364,11,0.18900675024108,2,9,"2 - 9","#0E1540",4,8,"2030"
1,100,54,2030-05-29,1905,9,5,10,"NYV","New York Voyagers","away",0,1,"Eastern Division","PBE",3,9,-6,"3 - 9",9,67,33,81,1089,4489,12,0.195231265686626,2,10,"2 - 10","#0E1540",4,8,"2030"
1,100,59,2030-06-01,1905,9,8,12,"NYV","New York Voyagers","away",0,1,"Eastern Division","PBE",3,10,-7,"3 - 10",9,76,41,93,1681,5776,13,0.225425774440123,3,10,"3 - 10","#0E1540",4,8,"2030"
1,100,64,2030-06-02,1905,9,4,11,"NYV","New York Voyagers","away",0,1,"Eastern Division","PBE",3,11,-8,"3 - 11",5,81,45,104,2025,6561,14,0.235849056603774,3,11,"3 - 11","#0E1540",4,8,"2030"
1,100,69,2030-06-03,1905,9,4,6,"NYV","New York Voyagers","away",0,1,"Eastern Division","PBE",3,12,-9,"3 - 12",6,87,49,110,2401,7569,15,0.240822467402207,4,11,"4 - 11","#0E1540",4,8,"2030"
1,100,74,2030-06-04,1905,9,2,7,"NYV","New York Voyagers","away",0,1,"Eastern Division","PBE",3,13,-10,"3 - 13",15,102,51,117,2601,10404,16,0.2,3,13,"3 - 13","#0E1540",4,8,"2030"
1,100,81,2030-06-06,1905,9,7,9,"NYV","New York Voyagers","home",1,0,"Eastern Division","PBE",4,13,-9,"4 - 13",0,102,58,126,3364,10404,17,0.244334689134224,4,13,"4 - 13","#0E1540",4,8,"2030"
1,100,85,2030-06-07,1905,9,2,7,"NYV","New York Voyagers","home",0,1,"Eastern Division","PBE",4,14,-10,"4 - 14",6,108,60,133,3600,11664,18,0.235849056603774,4,14,"4 - 14","#0E1540",4,8,"2030"
1,100,90,2030-06-08,1905,9,1,5,"NYV","New York Voyagers","home",0,1,"Eastern Division","PBE",4,15,-11,"4 - 15",8,116,61,138,3721,13456,19,0.216626884787798,4,15,"4 - 15","#0E1540",4,8,"2030"
1,100,94,2030-06-09,1905,9,4,11,"NYV","New York Voyagers","home",0,1,"Eastern Division","PBE",4,16,-12,"4 - 16",5,121,65,149,4225,14641,20,0.223947842679953,4,16,"4 - 16","#0E1540",4,8,"2030"
1,100,97,2030-06-11,1905,9,12,16,"NYV","New York Voyagers","home",1,0,"Eastern Division","PBE",5,16,-11,"5 - 16",1,122,77,165,5929,14884,21,0.284870033152357,6,15,"6 - 15","#0E1540",4,8,"2030"
1,100,102,2030-06-12,1905,9,3,9,"NYV","New York Voyagers","home",0,1,"Eastern Division","PBE",5,17,-12,"5 - 17",4,126,80,174,6400,15876,22,0.287304722571377,6,16,"6 - 16","#0E1540",4,8,"2030"
1,100,107,2030-06-13,1905,9,1,6,"NYV","New York Voyagers","home",0,1,"Eastern Division","PBE",5,18,-13,"5 - 18",2,128,81,180,6561,16384,23,0.285944650250599,7,16,"7 - 16","#0E1540",4,8,"2030"
1,100,121,2030-06-17,1905,9,5,9,"NYV","New York Voyagers","away",1,0,"Eastern Division","PBE",6,18,-12,"6 - 18",2,130,86,189,7396,16900,24,0.304412248929865,7,17,"7 - 17","#0E1540",4,8,"2030"
1,100,126,2030-06-18,1905,9,12,16,"NYV","New York Voyagers","away",1,0,"Eastern Division","PBE",7,18,-11,"7 - 18",1,131,98,205,9604,17161,25,0.358826826078834,9,16,"9 - 16","#0E1540",4,8,"2030"
1,100,131,2030-06-19,1905,9,16,16,"NYV","New York Voyagers","away",1,0,"Eastern Division","PBE",8,18,-10,"8 - 18",6,137,114,221,12996,18769,26,0.409129545096805,11,15,"11 - 15","#0E1540",4,8,"2030"
1,100,137,2030-06-22,1905,9,1,3,"NYV","New York Voyagers","home",0,1,"Eastern Division","PBE",8,19,-11,"8 - 19",2,139,115,224,13225,19321,27,0.40634793830271,11,16,"11 - 16","#0E1540",4,8,"2030"
1,100,142,2030-06-23,1905,9,3,7,"NYV","New York Voyagers","home",1,0,"Eastern Division","PBE",9,19,-10,"9 - 19",2,141,118,231,13924,19881,28,0.411891731992309,12,16,"12 - 16","#0E1540",4,8,"2030"
1,100,147,2030-06-24,1905,9,6,11,"NYV","New York Voyagers","home",1,0,"Eastern Division","PBE",10,19,-9,"10 - 19",5,146,124,242,15376,21316,29,0.419055924997275,12,17,"12 - 17","#0E1540",4,8,"2030"
1,100,152,2030-06-25,1905,9,4,12,"NYV","New York Voyagers","home",1,0,"Eastern Division","PBE",11,19,-8,"11 - 19",3,149,128,254,16384,22201,30,0.424620966696903,13,17,"13 - 17","#0E1540",4,8,"2030"
1,100,160,2030-06-28,1905,9,3,8,"NYV","New York Voyagers","home",0,1,"Eastern Division","PBE",11,20,-9,"11 - 20",7,156,131,262,17161,24336,31,0.413547967322939,13,18,"13 - 18","#0E1540",4,8,"2030"
1,100,165,2030-06-29,1905,9,3,7,"NYV","New York Voyagers","home",0,1,"Eastern Division","PBE",11,21,-10,"11 - 21",4,160,134,269,17956,25600,32,0.412250895399027,13,19,"13 - 19","#0E1540",4,8,"2030"
1,100,170,2030-06-30,1905,9,4,7,"NYV","New York Voyagers","home",1,0,"Eastern Division","PBE",12,21,-9,"12 - 21",2,162,138,276,19044,26244,33,0.420508744038156,14,19,"14 - 19","#0E1540",4,8,"2030"
1,100,177,2030-07-03,1905,9,4,8,"NYV","New York Voyagers","away",0,1,"Eastern Division","PBE",12,22,-10,"12 - 22",6,168,142,284,20164,28224,34,0.416714887988758,14,20,"14 - 20","#0E1540",4,8,"2030"
1,100,182,2030-07-04,1905,9,6,9,"NYV","New York Voyagers","away",0,1,"Eastern Division","PBE",12,23,-11,"12 - 23",10,178,148,293,21904,31684,35,0.408748227215048,14,21,"14 - 21","#0E1540",4,8,"2030"
1,100,187,2030-07-05,1905,9,5,6,"NYV","New York Voyagers","away",1,0,"Eastern Division","PBE",13,23,-10,"13 - 23",3,181,153,299,23409,32761,36,0.416752714972405,15,21,"15 - 21","#0E1540",4,8,"2030"
1,100,192,2030-07-06,1905,9,1,4,"NYV","New York Voyagers","away",0,1,"Eastern Division","PBE",13,24,-11,"13 - 24",6,187,154,303,23716,34969,37,0.404123711340206,15,22,"15 - 22","#0E1540",4,8,"2030"
1,100,194,2030-07-09,1905,10,1,4,"NYV","New York Voyagers","home",0,1,"Eastern Division","PBE",13,25,-12,"13 - 25",2,189,155,307,24025,35721,38,0.402118970307636,15,23,"15 - 23","#0E1540",4,8,"2030"
1,100,199,2030-07-10,1905,9,10,16,"NYV","New York Voyagers","home",1,0,"Eastern Division","PBE",14,25,-11,"14 - 25",6,195,165,323,27225,38025,39,0.417241379310345,16,23,"16 - 23","#0E1540",4,8,"2030"
1,100,204,2030-07-11,1905,9,1,7,"NYV","New York Voyagers","home",1,0,"Eastern Division","PBE",15,25,-10,"15 - 25",0,195,166,330,27556,38025,40,0.420182674860097,17,23,"17 - 23","#0E1540",4,8,"2030"
1,100,209,2030-07-12,1905,9,3,6,"NYV","New York Voyagers","home",0,1,"Eastern Division","PBE",15,26,-11,"15 - 26",5,200,169,336,28561,40000,41,0.416577937894721,17,24,"17 - 24","#0E1540",4,8,"2030"
1,100,216,2030-07-15,1905,9,7,11,"NYV","New York Voyagers","away",1,0,"Eastern Division","PBE",16,26,-10,"16 - 26",5,205,176,347,30976,42025,42,0.424322954480076,18,24,"18 - 24","#0E1540",4,8,"2030"
1,100,221,2030-07-16,1905,9,0,1,"NYV","New York Voyagers","away",0,1,"Eastern Division","PBE",16,27,-11,"16 - 27",2,207,176,348,30976,42849,43,0.419586860819506,18,25,"18 - 25","#0E1540",4,8,"2030"
1,100,226,2030-07-17,1905,10,2,6,"NYV","New York Voyagers","away",1,0,"Eastern Division","PBE",17,27,-10,"17 - 27",1,208,178,354,31684,43264,44,0.422746437530021,19,25,"19 - 25","#0E1540",4,8,"2030"
1,100,231,2030-07-18,1905,9,1,5,"NYV","New York Voyagers","away",0,1,"Eastern Division","PBE",17,28,-11,"17 - 28",7,215,179,359,32041,46225,45,0.409385940255028,18,27,"18 - 27","#0E1540",4,8,"2030"
1,100,234,2030-07-21,1905,9,9,14,"NYV","New York Voyagers","away",1,0,"Eastern Division","PBE",18,28,-10,"18 - 28",8,223,188,373,35344,49729,46,0.415454962208926,19,27,"19 - 27","#0E1540",4,8,"2030"
1,100,239,2030-07-22,1905,9,2,7,"NYV","New York Voyagers","away",0,1,"Eastern Division","PBE",18,29,-11,"18 - 29",7,230,190,380,36100,52900,47,0.40561797752809,19,28,"19 - 28","#0E1540",4,8,"2030"
1,100,244,2030-07-23,1905,9,2,4,"NYV","New York Voyagers","away",0,1,"Eastern Division","PBE",18,30,-12,"18 - 30",11,241,192,384,36864,58081,48,0.388266891358155,19,29,"19 - 29","#0E1540",4,8,"2030"
1,100,249,2030-07-24,1905,9,3,11,"NYV","New York Voyagers","away",1,0,"Eastern Division","PBE",19,30,-11,"19 - 30",2,243,195,395,38025,59049,49,0.391711477841647,19,30,"19 - 30","#0E1540",4,8,"2030"
1,100,257,2030-08-12,1905,9,5,7,"NYV","New York Voyagers","home",1,0,"Eastern Division","PBE",20,30,-10,"20 - 30",4,247,200,402,40000,61009,50,0.396004316447049,20,30,"20 - 30","#0E1540",4,8,"2030"
1,100,262,2030-08-13,1905,9,2,9,"NYV","New York Voyagers","home",0,1,"Eastern Division","PBE",20,31,-11,"20 - 31",12,259,202,411,40804,67081,51,0.37821754646151,19,32,"19 - 32","#0E1540",4,8,"2030"
1,100,267,2030-08-14,1905,9,4,7,"NYV","New York Voyagers","home",0,1,"Eastern Division","PBE",20,32,-12,"20 - 32",12,271,206,418,42436,73441,52,0.366215901343666,19,33,"19 - 33","#0E1540",4,8,"2030"
1,100,272,2030-08-15,1905,9,5,7,"NYV","New York Voyagers","home",0,1,"Eastern Division","PBE",20,33,-13,"20 - 33",11,282,211,425,44521,79524,53,0.358910072957395,19,34,"19 - 34","#0E1540",4,8,"2030"
1,100,274,2030-08-17,1905,9,3,4,"NYV","New York Voyagers","away",0,1,"Eastern Division","PBE",20,34,-14,"20 - 34",7,289,214,429,45796,83521,54,0.354137507056303,19,35,"19 - 35","#0E1540",4,8,"2030"
1,100,278,2030-08-18,1905,9,3,4,"NYV","New York Voyagers","away",0,1,"Eastern Division","PBE",20,35,-15,"20 - 35",7,296,217,433,47089,87616,55,0.349571285401433,19,36,"19 - 36","#0E1540",4,8,"2030"
1,100,283,2030-08-19,1905,9,6,11,"NYV","New York Voyagers","away",1,0,"Eastern Division","PBE",21,35,-14,"21 - 35",2,298,223,444,49729,88804,56,0.35896862119495,20,36,"20 - 36","#0E1540",4,8,"2030"
1,100,288,2030-08-20,1905,9,5,9,"NYV","New York Voyagers","away",1,0,"Eastern Division","PBE",22,35,-13,"22 - 35",0,298,228,453,51984,88804,57,0.369236014433048,21,36,"21 - 36","#0E1540",4,8,"2030"
1,100,295,2030-08-23,1905,9,1,3,"NYV","New York Voyagers","away",0,1,"Eastern Division","PBE",22,36,-14,"22 - 36",9,307,229,456,52441,94249,58,0.357495398459336,21,37,"21 - 37","#0E1540",4,8,"2030"
1,100,300,2030-08-24,1905,9,3,10,"NYV","New York Voyagers","away",0,1,"Eastern Division","PBE",22,37,-15,"22 - 37",6,313,232,466,53824,97969,59,0.354588156239089,21,38,"21 - 38","#0E1540",4,8,"2030"
1,100,631,2030-08-25,1905,9,2,6,"NYV","New York Voyagers","away",0,1,"Eastern Division","PBE",22,38,-16,"22 - 38",9,322,234,472,54756,103684,60,0.345594546831608,21,39,"21 - 39","#0E1540",4,8,"2030"
1,100,635,2030-08-27,1905,9,2,6,"NYV","New York Voyagers","away",0,1,"Eastern Division","PBE",22,39,-17,"22 - 39",5,327,236,478,55696,106929,61,0.342481168332052,21,40,"21 - 40","#0E1540",4,8,"2030"
1,100,640,2030-08-28,1905,9,6,9,"NYV","New York Voyagers","away",1,0,"Eastern Division","PBE",23,39,-16,"23 - 39",5,332,242,487,58564,110224,62,0.346967793918999,22,40,"22 - 40","#0E1540",4,8,"2030"
1,100,645,2030-08-29,1905,10,3,10,"NYV","New York Voyagers","away",1,0,"Eastern Division","PBE",24,39,-15,"24 - 39",2,334,245,497,60025,111556,63,0.349834771915305,22,41,"22 - 41","#0E1540",4,8,"2030"
1,100,650,2030-08-30,1905,10,4,9,"NYV","New York Voyagers","away",0,1,"Eastern Division","PBE",24,40,-16,"24 - 40",5,339,249,506,62001,114921,64,0.350442567911283,22,42,"22 - 42","#0E1540",4,8,"2030"
1,100,658,2030-09-02,1905,9,3,9,"NYV","New York Voyagers","home",0,1,"Eastern Division","PBE",24,41,-17,"24 - 41",7,346,252,515,63504,119716,65,0.346599716188189,23,42,"23 - 42","#0E1540",4,8,"2030"
1,100,663,2030-09-03,1905,9,1,4,"NYV","New York Voyagers","home",0,1,"Eastern Division","PBE",24,42,-18,"24 - 42",10,356,253,519,64009,126736,66,0.335573671655876,22,44,"22 - 44","#0E1540",4,8,"2030"
1,100,668,2030-09-04,1905,9,4,8,"NYV","New York Voyagers","home",0,1,"Eastern Division","PBE",24,43,-19,"24 - 43",11,367,257,527,66049,134689,67,0.329030876067312,22,45,"22 - 45","#0E1540",4,8,"2030"
1,100,673,2030-09-05,1905,9,4,10,"NYV","New York Voyagers","home",0,1,"Eastern Division","PBE",24,44,-20,"24 - 44",9,376,261,537,68121,141376,68,0.325164560829033,22,46,"22 - 46","#0E1540",4,8,"2030"
1,100,675,2030-09-08,1905,9,0,3,"NYV","New York Voyagers","home",0,1,"Eastern Division","PBE",24,45,-21,"24 - 45",8,384,261,540,68121,147456,69,0.315993821233248,22,47,"22 - 47","#0E1540",4,8,"2030"
1,100,680,2030-09-09,1905,9,6,11,"NYV","New York Voyagers","home",1,0,"Eastern Division","PBE",25,45,-20,"25 - 45",5,389,267,551,71289,151321,70,0.320241678271416,22,48,"22 - 48","#0E1540",4,8,"2030"
1,100,685,2030-09-10,1905,9,2,5,"NYV","New York Voyagers","home",0,1,"Eastern Division","PBE",25,46,-21,"25 - 46",4,393,269,556,72361,154449,71,0.319037961289185,23,48,"23 - 48","#0E1540",4,8,"2030"
1,100,690,2030-09-11,1905,12,6,13,"NYV","New York Voyagers","home",1,0,"Eastern Division","PBE",26,46,-20,"26 - 46",5,398,275,569,75625,158404,72,0.32314371295865,23,49,"23 - 49","#0E1540",4,8,"2030"
1,100,696,2030-09-14,1905,9,8,14,"NYV","New York Voyagers","home",1,0,"Eastern Division","PBE",27,46,-19,"27 - 46",0,398,283,583,80089,158404,73,0.335812791151103,25,48,"25 - 48","#0E1540",4,8,"2030"
1,100,701,2030-09-15,1905,9,10,15,"NYV","New York Voyagers","home",1,0,"Eastern Division","PBE",28,46,-18,"28 - 46",0,398,293,598,85849,158404,74,0.351475723941978,26,48,"26 - 48","#0E1540",4,8,"2030"
1,100,706,2030-09-16,1905,9,8,14,"NYV","New York Voyagers","home",1,0,"Eastern Division","PBE",29,46,-17,"29 - 46",1,399,301,612,90601,159201,75,0.362691251471165,27,48,"27 - 48","#0E1540",4,8,"2030"
1,100,711,2030-09-17,1905,9,8,9,"NYV","New York Voyagers","home",1,0,"Eastern Division","PBE",30,46,-16,"30 - 46",3,402,309,621,95481,161604,76,0.371398564677052,28,48,"28 - 48","#0E1540",4,8,"2030"
1,100,714,2030-09-20,1905,9,2,8,"NYV","New York Voyagers","away",0,1,"Eastern Division","PBE",30,47,-17,"30 - 47",3,405,311,629,96721,164025,77,0.370939535026424,29,48,"29 - 48","#0E1540",4,8,"2030"
1,100,719,2030-09-21,1905,9,4,7,"NYV","New York Voyagers","away",0,1,"Eastern Division","PBE",30,48,-18,"30 - 48",5,410,315,636,99225,168100,78,0.371177405779482,29,49,"29 - 49","#0E1540",4,8,"2030"
1,100,724,2030-09-22,1905,9,6,7,"NYV","New York Voyagers","away",1,0,"Eastern Division","PBE",31,48,-17,"31 - 48",4,414,321,643,103041,171396,79,0.37546322106713,30,49,"30 - 49","#0E1540",4,8,"2030"
1,100,729,2030-09-23,1905,9,1,5,"NYV","New York Voyagers","away",0,1,"Eastern Division","PBE",31,49,-18,"31 - 49",10,424,322,648,103684,179776,80,0.365780004233402,29,51,"29 - 51","#0E1540",4,8,"2030"
1,100,733,2030-09-25,1905,9,9,8,"NYV","New York Voyagers","away",0,1,"Eastern Division","PBE",31,50,-19,"31 - 50",10,434,331,656,109561,188356,81,0.367756791321073,30,51,"30 - 51","#0E1540",4,8,"2030"
1,100,738,2030-09-26,1905,9,7,14,"NYV","New York Voyagers","away",1,0,"Eastern Division","PBE",32,50,-18,"32 - 50",2,436,338,670,114244,190096,82,0.3753827955576,31,51,"31 - 51","#0E1540",4,8,"2030"
1,100,743,2030-09-27,1905,10,5,8,"NYV","New York Voyagers","away",0,1,"Eastern Division","PBE",32,51,-19,"32 - 51",6,442,343,678,117649,195364,83,0.375859788571082,31,52,"31 - 52","#0E1540",4,8,"2030"
1,100,748,2030-09-28,1905,9,1,7,"NYV","New York Voyagers","away",0,1,"Eastern Division","PBE",32,52,-20,"32 - 52",6,448,344,685,118336,200704,84,0.370912738214644,31,53,"31 - 53","#0E1540",4,8,"2030"
1,100,752,2030-09-30,1905,10,3,9,"NYV","New York Voyagers","home",0,1,"Eastern Division","PBE",32,53,-21,"32 - 53",6,454,347,694,120409,206116,85,0.368758900543603,31,54,"31 - 54","#0E1540",4,8,"2030"
1,100,757,2030-10-01,1905,9,4,9,"NYV","New York Voyagers","home",0,1,"Eastern Division","PBE",32,54,-22,"32 - 54",8,462,351,703,123201,213444,86,0.365967116695629,31,55,"31 - 55","#0E1540",4,8,"2030"
1,100,762,2030-10-02,1905,9,1,2,"NYV","New York Voyagers","home",0,1,"Eastern Division","PBE",32,55,-23,"32 - 55",4,466,352,705,123904,217156,87,0.363290916554272,32,55,"32 - 55","#0E1540",4,8,"2030"
1,100,767,2030-10-03,1905,9,2,9,"NYV","New York Voyagers","home",0,1,"Eastern Division","PBE",32,56,-24,"32 - 56",7,473,354,714,125316,223729,88,0.359025340572133,32,56,"32 - 56","#0E1540",4,8,"2030"
1,100,773,2030-10-05,1905,9,5,14,"NYV","New York Voyagers","home",0,1,"Eastern Division","PBE",32,57,-25,"32 - 57",12,485,359,728,128881,235225,89,0.353965603423179,32,57,"32 - 57","#0E1540",4,8,"2030"
1,100,777,2030-10-06,1905,11,4,11,"NYV","New York Voyagers","home",0,1,"Eastern Division","PBE",32,58,-26,"32 - 58",7,492,363,739,131769,242064,90,0.352480920624985,32,58,"32 - 58","#0E1540",4,8,"2030"
2,100,2,2030-05-15,1905,9,4,7,"OBX","Outer Banks Aviators","home",1,0,"Eastern Division","PBE",1,0,1,"1 - 0",0,0,4,7,16,0,1,1,1,0,"1 - 0","#FF6700",2,4,"2030"
2,100,7,2030-05-16,1905,9,5,10,"OBX","Outer Banks Aviators","home",1,0,"Eastern Division","PBE",2,0,2,"2 - 0",3,3,9,17,81,9,2,0.9,2,0,"2 - 0","#FF6700",2,4,"2030"
2,100,12,2030-05-17,1905,9,8,12,"OBX","Outer Banks Aviators","home",1,0,"Eastern Division","PBE",3,0,3,"3 - 0",1,4,17,29,289,16,3,0.947540983606557,3,0,"3 - 0","#FF6700",2,4,"2030"
2,100,17,2030-05-18,1905,9,4,6,"OBX","Outer Banks Aviators","home",0,1,"Eastern Division","PBE",3,1,2,"3 - 1",9,13,21,35,441,169,4,0.722950819672131,3,1,"3 - 1","#FF6700",2,4,"2030"
2,100,21,2030-05-21,1905,9,3,7,"OBX","Outer Banks Aviators","away",0,1,"Eastern Division","PBE",3,2,1,"3 - 2",7,20,24,42,576,400,5,0.590163934426229,3,2,"3 - 2","#FF6700",2,4,"2030"
2,100,26,2030-05-22,1905,9,4,10,"OBX","Outer Banks Aviators","away",0,1,"Eastern Division","PBE",3,3,0,"3 - 3",7,27,28,52,784,729,6,0.518175809649703,3,3,"3 - 3","#FF6700",2,4,"2030"
2,100,31,2030-05-23,1905,9,3,6,"OBX","Outer Banks Aviators","away",1,0,"Eastern Division","PBE",4,3,1,"4 - 3",2,29,31,58,961,841,7,0.533296337402886,4,3,"4 - 3","#FF6700",2,4,"2030"
2,100,40,2030-05-26,1905,9,3,10,"OBX","Outer Banks Aviators","home",0,1,"Eastern Division","PBE",4,4,0,"4 - 4",5,34,34,68,1156,1156,8,0.5,4,4,"4 - 4","#FF6700",2,4,"2030"
2,100,44,2030-05-27,1905,9,8,9,"OBX","Outer Banks Aviators","home",1,0,"Eastern Division","PBE",5,4,1,"5 - 4",2,36,42,77,1764,1296,9,0.576470588235294,5,4,"5 - 4","#FF6700",2,4,"2030"
2,100,49,2030-05-28,1905,9,5,10,"OBX","Outer Banks Aviators","home",1,0,"Eastern Division","PBE",6,4,2,"6 - 4",1,37,47,87,2209,1369,10,0.617384013415316,6,4,"6 - 4","#FF6700",2,4,"2030"
2,100,54,2030-05-29,1905,9,9,17,"OBX","Outer Banks Aviators","home",1,0,"Eastern Division","PBE",7,4,3,"7 - 4",5,42,56,104,3136,1764,11,0.64,7,4,"7 - 4","#FF6700",2,4,"2030"
2,100,61,2030-06-01,1905,9,5,10,"OBX","Outer Banks Aviators","away",1,0,"Eastern Division","PBE",8,4,4,"8 - 4",4,46,61,114,3721,2116,12,0.637485009422649,8,4,"8 - 4","#FF6700",2,4,"2030"
2,100,66,2030-06-02,1905,9,3,8,"OBX","Outer Banks Aviators","away",1,0,"Eastern Division","PBE",9,4,5,"9 - 4",1,47,64,122,4096,2209,13,0.64964314036479,8,5,"8 - 5","#FF6700",2,4,"2030"
2,100,71,2030-06-03,1905,9,2,11,"OBX","Outer Banks Aviators","away",0,1,"Eastern Division","PBE",9,5,4,"9 - 5",12,59,66,133,4356,3481,14,0.55582493301008,8,6,"8 - 6","#FF6700",2,4,"2030"
2,100,76,2030-06-04,1905,9,0,6,"OBX","Outer Banks Aviators","away",0,1,"Eastern Division","PBE",9,6,3,"9 - 6",1,60,66,139,4356,3600,15,0.547511312217195,8,7,"8 - 7","#FF6700",2,4,"2030"
2,100,79,2030-06-06,1905,9,5,7,"OBX","Outer Banks Aviators","home",1,0,"Eastern Division","PBE",10,6,4,"10 - 6",3,63,71,146,5041,3969,16,0.559489456159822,9,7,"9 - 7","#FF6700",2,4,"2030"
2,100,83,2030-06-07,1905,9,6,12,"OBX","Outer Banks Aviators","home",1,0,"Eastern Division","PBE",11,6,5,"11 - 6",3,66,77,158,5929,4356,17,0.576470588235294,10,7,"10 - 7","#FF6700",2,4,"2030"
2,100,88,2030-06-08,1905,9,8,13,"OBX","Outer Banks Aviators","home",1,0,"Eastern Division","PBE",12,6,6,"12 - 6",3,69,85,171,7225,4761,18,0.602786584348406,11,7,"11 - 7","#FF6700",2,4,"2030"
2,100,93,2030-06-09,1905,9,13,18,"OBX","Outer Banks Aviators","home",1,0,"Eastern Division","PBE",13,6,7,"13 - 6",5,74,98,189,9604,5476,19,0.636870026525199,12,7,"12 - 7","#FF6700",2,4,"2030"
2,100,99,2030-06-11,1905,12,1,7,"OBX","Outer Banks Aviators","home",0,1,"Eastern Division","PBE",13,7,6,"13 - 7",3,77,99,196,9801,5929,20,0.623076923076923,12,8,"12 - 8","#FF6700",2,4,"2030"
2,100,104,2030-06-12,1905,9,3,8,"OBX","Outer Banks Aviators","home",1,0,"Eastern Division","PBE",14,7,7,"14 - 7",2,79,102,204,10404,6241,21,0.62505256833884,13,8,"13 - 8","#FF6700",2,4,"2030"
2,100,109,2030-06-13,1905,9,2,6,"OBX","Outer Banks Aviators","home",0,1,"Eastern Division","PBE",14,8,6,"14 - 8",4,83,104,210,10816,6889,22,0.61090087545891,13,9,"13 - 9","#FF6700",2,4,"2030"
2,100,113,2030-06-14,1905,9,1,7,"OBX","Outer Banks Aviators","home",0,1,"Eastern Division","PBE",14,9,5,"14 - 9",4,87,105,217,11025,7569,23,0.592933204259439,14,9,"14 - 9","#FF6700",2,4,"2030"
2,100,116,2030-06-16,1905,9,6,15,"OBX","Outer Banks Aviators","home",0,1,"Eastern Division","PBE",14,10,4,"14 - 10",7,94,111,232,12321,8836,24,0.58236044807865,14,10,"14 - 10","#FF6700",2,4,"2030"
2,100,120,2030-06-17,1905,9,2,5,"OBX","Outer Banks Aviators","home",0,1,"Eastern Division","PBE",14,11,3,"14 - 11",7,101,113,237,12769,10201,25,0.555898998693949,14,11,"14 - 11","#FF6700",2,4,"2030"
2,100,125,2030-06-18,1905,9,7,10,"OBX","Outer Banks Aviators","home",1,0,"Eastern Division","PBE",15,11,4,"15 - 11",5,106,120,247,14400,11236,26,0.561710095178655,15,11,"15 - 11","#FF6700",2,4,"2030"
2,100,130,2030-06-19,1905,9,2,8,"OBX","Outer Banks Aviators","home",1,0,"Eastern Division","PBE",16,11,5,"16 - 11",0,106,122,255,14884,11236,27,0.569831546707504,15,12,"15 - 12","#FF6700",2,4,"2030"
2,100,136,2030-06-22,1905,9,1,5,"OBX","Outer Banks Aviators","away",0,1,"Eastern Division","PBE",16,12,4,"16 - 12",2,108,123,260,15129,11664,28,0.564662411823984,16,12,"16 - 12","#FF6700",2,4,"2030"
2,100,141,2030-06-23,1905,10,4,10,"OBX","Outer Banks Aviators","away",1,0,"Eastern Division","PBE",17,12,5,"17 - 12",3,111,127,270,16129,12321,29,0.566924428822496,16,13,"16 - 13","#FF6700",2,4,"2030"
2,100,146,2030-06-24,1905,9,9,18,"OBX","Outer Banks Aviators","away",1,0,"Eastern Division","PBE",18,12,6,"18 - 12",3,114,136,288,18496,12996,30,0.587323764765655,18,12,"18 - 12","#FF6700",2,4,"2030"
2,100,151,2030-06-25,1905,9,9,15,"OBX","Outer Banks Aviators","away",1,0,"Eastern Division","PBE",19,12,7,"19 - 12",3,117,145,303,21025,13689,31,0.605663421098116,19,12,"19 - 12","#FF6700",2,4,"2030"
2,100,160,2030-06-28,1905,9,7,10,"OBX","Outer Banks Aviators","away",1,0,"Eastern Division","PBE",20,12,8,"20 - 12",3,120,152,313,23104,14400,32,0.616040955631399,20,12,"20 - 12","#FF6700",2,4,"2030"
2,100,165,2030-06-29,1905,9,4,7,"OBX","Outer Banks Aviators","away",1,0,"Eastern Division","PBE",21,12,9,"21 - 12",3,123,156,320,24336,15129,33,0.616647662485747,20,13,"20 - 13","#FF6700",2,4,"2030"
2,100,170,2030-06-30,1905,9,2,8,"OBX","Outer Banks Aviators","away",0,1,"Eastern Division","PBE",21,13,8,"21 - 13",4,127,158,328,24964,16129,34,0.607500060837612,21,13,"21 - 13","#FF6700",2,4,"2030"
2,100,176,2030-07-03,1905,9,0,1,"OBX","Outer Banks Aviators","away",0,1,"Eastern Division","PBE",21,14,7,"21 - 14",3,130,158,329,24964,16900,35,0.596311866997898,21,14,"21 - 14","#FF6700",2,4,"2030"
2,100,181,2030-07-04,1905,9,3,10,"OBX","Outer Banks Aviators","away",0,1,"Eastern Division","PBE",21,15,6,"21 - 15",12,142,161,339,25921,20164,36,0.562460670500163,20,16,"20 - 16","#FF6700",2,4,"2030"
2,100,186,2030-07-05,1905,9,8,15,"OBX","Outer Banks Aviators","away",1,0,"Eastern Division","PBE",22,15,7,"22 - 15",7,149,169,354,28561,22201,37,0.562645285843741,21,16,"21 - 16","#FF6700",2,4,"2030"
2,100,191,2030-07-06,1905,9,8,14,"OBX","Outer Banks Aviators","away",1,0,"Eastern Division","PBE",23,15,8,"23 - 15",3,152,177,368,31329,23104,38,0.575551595539471,22,16,"22 - 16","#FF6700",2,4,"2030"
2,100,195,2030-07-09,1905,9,7,13,"OBX","Outer Banks Aviators","away",1,0,"Eastern Division","PBE",24,15,9,"24 - 15",5,157,184,381,33856,24649,39,0.578685582428852,23,16,"23 - 16","#FF6700",2,4,"2030"
2,100,200,2030-07-10,1905,9,0,2,"OBX","Outer Banks Aviators","away",0,1,"Eastern Division","PBE",24,16,8,"24 - 16",5,162,184,383,33856,26244,40,0.563327787021631,23,17,"23 - 17","#FF6700",2,4,"2030"
2,100,205,2030-07-11,1905,9,6,9,"OBX","Outer Banks Aviators","away",1,0,"Eastern Division","PBE",25,16,9,"25 - 16",5,167,190,392,36100,27889,41,0.564159464908031,23,18,"23 - 18","#FF6700",2,4,"2030"
2,100,210,2030-07-12,1905,9,8,13,"OBX","Outer Banks Aviators","away",1,0,"Eastern Division","PBE",26,16,10,"26 - 16",2,169,198,405,39204,28561,42,0.57852873902457,24,18,"24 - 18","#FF6700",2,4,"2030"
2,100,217,2030-07-15,1905,9,4,10,"OBX","Outer Banks Aviators","away",0,1,"Eastern Division","PBE",26,17,9,"26 - 17",5,174,202,415,40804,30276,43,0.574057400112549,25,18,"25 - 18","#FF6700",2,4,"2030"
2,100,222,2030-07-16,1905,9,9,9,"OBX","Outer Banks Aviators","away",1,0,"Eastern Division","PBE",27,17,10,"27 - 17",8,182,211,424,44521,33124,44,0.573391718719815,25,19,"25 - 19","#FF6700",2,4,"2030"
2,100,227,2030-07-17,1905,9,1,4,"OBX","Outer Banks Aviators","away",0,1,"Eastern Division","PBE",27,18,9,"27 - 18",5,187,212,428,44944,34969,45,0.562411622639621,25,20,"25 - 20","#FF6700",2,4,"2030"
2,100,232,2030-07-18,1905,9,5,10,"OBX","Outer Banks Aviators","away",1,0,"Eastern Division","PBE",28,18,10,"28 - 18",4,191,217,438,47089,36481,46,0.563467751585497,26,20,"26 - 20","#FF6700",2,4,"2030"
2,100,235,2030-07-21,1905,9,12,13,"OBX","Outer Banks Aviators","home",1,0,"Eastern Division","PBE",29,18,11,"29 - 18",3,194,229,451,52441,37636,47,0.58217969070906,27,20,"27 - 20","#FF6700",2,4,"2030"
2,100,240,2030-07-22,1905,11,4,8,"OBX","Outer Banks Aviators","home",0,1,"Eastern Division","PBE",29,19,10,"29 - 19",5,199,233,459,54289,39601,48,0.578219192672276,28,20,"28 - 20","#FF6700",2,4,"2030"
2,100,245,2030-07-23,1905,9,4,8,"OBX","Outer Banks Aviators","home",1,0,"Eastern Division","PBE",30,19,11,"30 - 19",0,199,237,467,56169,39601,49,0.586498903623264,29,20,"29 - 20","#FF6700",2,4,"2030"
2,100,250,2030-07-24,1905,9,2,10,"OBX","Outer Banks Aviators","home",1,0,"Eastern Division","PBE",31,19,12,"31 - 19",0,199,239,477,57121,39601,50,0.59056884679804,30,20,"30 - 20","#FF6700",2,4,"2030"
2,100,255,2030-08-12,1905,10,5,8,"OBX","Outer Banks Aviators","home",1,0,"Eastern Division","PBE",32,19,13,"32 - 19",4,203,244,485,59536,41209,51,0.590957367611296,30,21,"30 - 21","#FF6700",2,4,"2030"
2,100,260,2030-08-13,1905,9,5,6,"OBX","Outer Banks Aviators","home",0,1,"Eastern Division","PBE",32,20,12,"32 - 20",6,209,249,491,62001,43681,52,0.586675119698719,31,21,"31 - 21","#FF6700",2,4,"2030"
2,100,265,2030-08-14,1905,9,7,6,"OBX","Outer Banks Aviators","home",1,0,"Eastern Division","PBE",33,20,13,"33 - 20",6,215,256,497,65536,46225,53,0.586394180438615,31,22,"31 - 22","#FF6700",2,4,"2030"
2,100,270,2030-08-15,1905,9,8,10,"OBX","Outer Banks Aviators","home",1,0,"Eastern Division","PBE",34,20,14,"34 - 20",6,221,264,507,69696,48841,54,0.587968313691084,32,22,"32 - 22","#FF6700",2,4,"2030"
2,100,273,2030-08-17,1905,9,0,6,"OBX","Outer Banks Aviators","home",0,1,"Eastern Division","PBE",34,21,13,"34 - 21",2,223,264,513,69696,49729,55,0.583596399413858,32,23,"32 - 23","#FF6700",2,4,"2030"
2,100,277,2030-08-18,1905,9,7,11,"OBX","Outer Banks Aviators","home",1,0,"Eastern Division","PBE",35,21,14,"35 - 21",5,228,271,524,73441,51984,56,0.585537173609727,33,23,"33 - 23","#FF6700",2,4,"2030"
2,100,282,2030-08-19,1905,9,2,5,"OBX","Outer Banks Aviators","home",0,1,"Eastern Division","PBE",35,22,13,"35 - 22",6,234,273,529,74529,54756,57,0.576470588235294,33,24,"33 - 24","#FF6700",2,4,"2030"
2,100,287,2030-08-20,1905,9,5,13,"OBX","Outer Banks Aviators","home",0,1,"Eastern Division","PBE",35,23,12,"35 - 23",11,245,278,542,77284,60025,58,0.562847300613944,33,25,"33 - 25","#FF6700",2,4,"2030"
2,100,292,2030-08-22,1905,9,6,11,"OBX","Outer Banks Aviators","home",1,0,"Eastern Division","PBE",36,23,13,"36 - 23",1,246,284,553,80656,60516,59,0.571331425495141,34,25,"34 - 25","#FF6700",2,4,"2030"
2,100,296,2030-08-23,1905,14,3,8,"OBX","Outer Banks Aviators","home",1,0,"Eastern Division","PBE",37,23,14,"37 - 23",2,248,287,561,82369,61504,60,0.572511868105899,34,26,"34 - 26","#FF6700",2,4,"2030"
2,100,301,2030-08-24,1905,9,7,10,"OBX","Outer Banks Aviators","home",1,0,"Eastern Division","PBE",38,23,15,"38 - 23",2,250,294,571,86436,62500,61,0.580356663264758,35,26,"35 - 26","#FF6700",2,4,"2030"
2,100,636,2030-08-27,1905,9,5,11,"OBX","Outer Banks Aviators","away",1,0,"Eastern Division","PBE",39,23,16,"39 - 23",2,252,299,582,89401,63504,62,0.58468330008829,36,26,"36 - 26","#FF6700",2,4,"2030"
2,100,641,2030-08-28,1905,9,4,8,"OBX","Outer Banks Aviators","away",1,0,"Eastern Division","PBE",40,23,17,"40 - 23",3,255,303,590,91809,65025,63,0.585389647652932,37,26,"37 - 26","#FF6700",2,4,"2030"
2,100,646,2030-08-29,1905,9,2,4,"OBX","Outer Banks Aviators","away",1,0,"Eastern Division","PBE",41,23,18,"41 - 23",1,256,305,594,93025,65536,64,0.586682727782998,38,26,"38 - 26","#FF6700",2,4,"2030"
2,100,651,2030-08-30,1905,9,2,7,"OBX","Outer Banks Aviators","away",0,1,"Eastern Division","PBE",41,24,17,"41 - 24",3,259,307,601,94249,67081,65,0.584200086778652,38,27,"38 - 27","#FF6700",2,4,"2030"
2,100,655,2030-09-02,1905,9,0,3,"OBX","Outer Banks Aviators","away",0,1,"Eastern Division","PBE",41,25,16,"41 - 25",1,260,307,604,94249,67600,66,0.582326736649593,38,28,"38 - 28","#FF6700",2,4,"2030"
2,100,660,2030-09-03,1905,9,3,3,"OBX","Outer Banks Aviators","away",0,1,"Eastern Division","PBE",41,26,15,"41 - 26",4,264,310,607,96100,69696,67,0.579627976549495,39,28,"39 - 28","#FF6700",2,4,"2030"
2,100,665,2030-09-04,1905,9,8,13,"OBX","Outer Banks Aviators","away",1,0,"Eastern Division","PBE",42,26,16,"42 - 26",6,270,318,620,101124,72900,68,0.581092263136119,40,28,"40 - 28","#FF6700",2,4,"2030"
2,100,670,2030-09-05,1905,9,3,6,"OBX","Outer Banks Aviators","away",1,0,"Eastern Division","PBE",43,26,17,"43 - 26",1,271,321,626,103041,73441,69,0.583861243639578,40,29,"40 - 29","#FF6700",2,4,"2030"
2,100,675,2030-09-08,1905,9,8,15,"OBX","Outer Banks Aviators","away",1,0,"Eastern Division","PBE",44,26,18,"44 - 26",0,271,329,641,108241,73441,70,0.595771733028038,42,28,"42 - 28","#FF6700",2,4,"2030"
2,100,680,2030-09-09,1905,9,5,10,"OBX","Outer Banks Aviators","away",0,1,"Eastern Division","PBE",44,27,17,"44 - 27",6,277,334,651,111556,76729,71,0.592484796983297,42,29,"42 - 29","#FF6700",2,4,"2030"
2,100,685,2030-09-10,1905,9,4,6,"OBX","Outer Banks Aviators","away",1,0,"Eastern Division","PBE",45,27,18,"45 - 27",2,279,338,657,114244,77841,72,0.594757529218835,43,29,"43 - 29","#FF6700",2,4,"2030"
2,100,690,2030-09-11,1905,12,5,9,"OBX","Outer Banks Aviators","away",0,1,"Eastern Division","PBE",45,28,17,"45 - 28",6,285,343,666,117649,81225,73,0.591575570461699,43,30,"43 - 30","#FF6700",2,4,"2030"
2,100,697,2030-09-14,1905,9,3,4,"OBX","Outer Banks Aviators","home",1,0,"Eastern Division","PBE",46,28,18,"46 - 28",2,287,346,670,119716,82369,74,0.592404186357226,44,30,"44 - 30","#FF6700",2,4,"2030"
2,100,702,2030-09-15,1905,9,3,5,"OBX","Outer Banks Aviators","home",1,0,"Eastern Division","PBE",47,28,19,"47 - 28",2,289,349,675,121801,83521,75,0.593219430942617,44,31,"44 - 31","#FF6700",2,4,"2030"
2,100,707,2030-09-16,1905,9,4,8,"OBX","Outer Banks Aviators","home",1,0,"Eastern Division","PBE",48,28,20,"48 - 28",3,292,353,683,124609,85264,76,0.593735258942313,45,31,"45 - 31","#FF6700",2,4,"2030"
2,100,712,2030-09-17,1905,9,3,5,"OBX","Outer Banks Aviators","home",0,1,"Eastern Division","PBE",48,29,19,"48 - 29",13,305,356,688,126736,93025,77,0.576699232347869,44,33,"44 - 33","#FF6700",2,4,"2030"
2,100,714,2030-09-20,1905,9,3,6,"OBX","Outer Banks Aviators","home",1,0,"Eastern Division","PBE",49,29,20,"49 - 29",2,307,359,694,128881,94249,78,0.577604983641823,45,33,"45 - 33","#FF6700",2,4,"2030"
2,100,719,2030-09-21,1905,9,5,9,"OBX","Outer Banks Aviators","home",1,0,"Eastern Division","PBE",50,29,21,"50 - 29",4,311,364,703,132496,96721,79,0.578037405602551,46,33,"46 - 33","#FF6700",2,4,"2030"
2,100,724,2030-09-22,1905,9,4,10,"OBX","Outer Banks Aviators","home",0,1,"Eastern Division","PBE",50,30,20,"50 - 30",6,317,368,713,135424,100489,80,0.57404212569888,46,34,"46 - 34","#FF6700",2,4,"2030"
2,100,729,2030-09-23,1905,9,10,14,"OBX","Outer Banks Aviators","home",1,0,"Eastern Division","PBE",51,30,21,"51 - 30",1,318,378,727,142884,101124,81,0.585570964886397,47,34,"47 - 34","#FF6700",2,4,"2030"
2,100,737,2030-09-25,1905,9,4,9,"OBX","Outer Banks Aviators","home",0,1,"Eastern Division","PBE",51,31,20,"51 - 31",6,324,382,736,145924,104976,82,0.581602231964926,48,34,"48 - 34","#FF6700",2,4,"2030"
2,100,742,2030-09-26,1905,9,4,10,"OBX","Outer Banks Aviators","home",1,0,"Eastern Division","PBE",52,31,21,"52 - 31",2,326,386,746,148996,106276,83,0.583675452066815,48,35,"48 - 35","#FF6700",2,4,"2030"
2,100,747,2030-09-27,1905,9,1,6,"OBX","Outer Banks Aviators","home",0,1,"Eastern Division","PBE",52,32,20,"52 - 32",12,338,387,752,149769,114244,84,0.567278883994349,48,36,"48 - 36","#FF6700",2,4,"2030"
2,100,751,2030-09-28,1905,9,2,6,"OBX","Outer Banks Aviators","home",0,1,"Eastern Division","PBE",52,33,19,"52 - 33",14,352,389,758,151321,123904,85,0.549808338632028,47,38,"47 - 38","#FF6700",2,4,"2030"
2,100,754,2030-09-30,1905,9,5,9,"OBX","Outer Banks Aviators","away",1,0,"Eastern Division","PBE",53,33,20,"53 - 33",4,356,394,767,155236,126736,86,0.550536932745095,47,39,"47 - 39","#FF6700",2,4,"2030"
2,100,759,2030-10-01,1905,9,4,11,"OBX","Outer Banks Aviators","away",1,0,"Eastern Division","PBE",54,33,21,"54 - 33",0,356,398,778,158404,126736,87,0.555530616539244,48,39,"48 - 39","#FF6700",2,4,"2030"
2,100,764,2030-10-02,1905,9,3,10,"OBX","Outer Banks Aviators","away",1,0,"Eastern Division","PBE",55,33,22,"55 - 33",1,357,401,788,160801,127449,88,0.557852558542931,49,39,"49 - 39","#FF6700",2,4,"2030"
2,100,769,2030-10-03,1905,9,3,9,"OBX","Outer Banks Aviators","away",0,1,"Eastern Division","PBE",55,34,21,"55 - 34",4,361,404,797,163216,130321,89,0.556032118608557,49,40,"49 - 40","#FF6700",2,4,"2030"
2,100,772,2030-10-05,1905,9,1,1,"OBX","Outer Banks Aviators","away",0,1,"Eastern Division","PBE",55,35,20,"55 - 35",4,365,405,798,164025,133225,90,0.551808242220353,50,40,"50 - 40","#FF6700",2,4,"2030"
2,100,776,2030-10-06,1905,9,7,12,"OBX","Outer Banks Aviators","away",0,1,"Eastern Division","PBE",55,36,19,"55 - 36",10,375,412,810,169744,140625,91,0.546910290654028,50,41,"50 - 41","#FF6700",2,4,"2030"
3,100,2,2030-05-15,1905,9,0,5,"PRO","Providence Crabs","away",0,1,"Eastern Division","PBE",0,1,-1,"0 - 1",4,4,0,5,0,16,1,0,0,1,"0 - 1","#005CAD",3,5,"2030"
3,100,7,2030-05-16,1905,9,3,11,"PRO","Providence Crabs","away",0,1,"Eastern Division","PBE",0,2,-2,"0 - 2",5,9,3,16,9,81,2,0.1,0,2,"0 - 2","#005CAD",3,5,"2030"
3,100,12,2030-05-17,1905,9,1,3,"PRO","Providence Crabs","away",0,1,"Eastern Division","PBE",0,3,-3,"0 - 3",8,17,4,19,16,289,3,0.0524590163934426,0,3,"0 - 3","#005CAD",3,5,"2030"
3,100,17,2030-05-18,1905,9,9,15,"PRO","Providence Crabs","away",1,0,"Eastern Division","PBE",1,3,-2,"1 - 3",4,21,13,34,169,441,4,0.277049180327869,1,3,"1 - 3","#005CAD",3,5,"2030"
3,100,23,2030-05-21,1905,9,2,4,"PRO","Providence Crabs","home",0,1,"Eastern Division","PBE",1,4,-3,"1 - 4",4,25,15,38,225,625,5,0.264705882352941,1,4,"1 - 4","#005CAD",3,5,"2030"
3,100,28,2030-05-22,1905,9,2,9,"PRO","Providence Crabs","home",0,1,"Eastern Division","PBE",1,5,-4,"1 - 5",8,33,17,47,289,1089,6,0.209724238026125,1,5,"1 - 5","#005CAD",3,5,"2030"
3,100,33,2030-05-23,1905,9,5,13,"PRO","Providence Crabs","home",1,0,"Eastern Division","PBE",2,5,-3,"2 - 5",4,37,22,60,484,1369,7,0.261198057204533,2,5,"2 - 5","#005CAD",3,5,"2030"
3,100,37,2030-05-24,1905,9,6,7,"PRO","Providence Crabs","home",1,0,"Eastern Division","PBE",3,5,-2,"3 - 5",5,42,28,67,784,1764,8,0.307692307692308,2,6,"2 - 6","#005CAD",3,5,"2030"
3,100,41,2030-05-26,1905,10,3,10,"PRO","Providence Crabs","away",1,0,"Eastern Division","PBE",4,5,-1,"4 - 5",2,44,31,77,961,1936,9,0.331722471522264,3,6,"3 - 6","#005CAD",3,5,"2030"
3,100,45,2030-05-27,1905,9,7,11,"PRO","Providence Crabs","away",1,0,"Eastern Division","PBE",5,5,0,"5 - 5",0,44,38,88,1444,1936,10,0.427218934911243,4,6,"4 - 6","#005CAD",3,5,"2030"
3,100,50,2030-05-28,1905,10,3,6,"PRO","Providence Crabs","away",0,1,"Eastern Division","PBE",5,6,-1,"5 - 6",4,48,41,94,1681,2304,11,0.421831869510665,5,6,"5 - 6","#005CAD",3,5,"2030"
3,100,55,2030-05-29,1905,9,15,17,"PRO","Providence Crabs","away",1,0,"Eastern Division","PBE",6,6,0,"6 - 6",11,59,56,111,3136,3481,12,0.473930784343358,6,6,"6 - 6","#005CAD",3,5,"2030"
3,100,59,2030-06-01,1905,9,9,11,"PRO","Providence Crabs","home",1,0,"Eastern Division","PBE",7,6,1,"7 - 6",8,67,65,122,4225,4489,13,0.484851962359422,6,7,"6 - 7","#005CAD",3,5,"2030"
3,100,64,2030-06-02,1905,9,5,9,"PRO","Providence Crabs","home",1,0,"Eastern Division","PBE",8,6,2,"8 - 6",4,71,70,131,4900,5041,14,0.492908158132985,7,7,"7 - 7","#005CAD",3,5,"2030"
3,100,69,2030-06-03,1905,9,6,7,"PRO","Providence Crabs","home",1,0,"Eastern Division","PBE",9,6,3,"9 - 6",4,75,76,138,5776,5625,15,0.506622226120516,8,7,"8 - 7","#005CAD",3,5,"2030"
3,100,74,2030-06-04,1905,9,15,15,"PRO","Providence Crabs","home",1,0,"Eastern Division","PBE",10,6,4,"10 - 6",2,77,91,153,8281,5929,16,0.582758620689655,9,7,"9 - 7","#005CAD",3,5,"2030"
3,100,80,2030-06-06,1905,9,1,5,"PRO","Providence Crabs","home",0,1,"Eastern Division","PBE",10,7,3,"10 - 7",10,87,92,158,8464,7569,17,0.527911183184682,9,8,"9 - 8","#005CAD",3,5,"2030"
3,100,84,2030-06-07,1905,9,3,6,"PRO","Providence Crabs","home",0,1,"Eastern Division","PBE",10,8,2,"10 - 8",7,94,95,164,9025,8836,18,0.50529085717485,9,9,"9 - 9","#005CAD",3,5,"2030"
3,100,89,2030-06-08,1905,9,4,11,"PRO","Providence Crabs","home",0,1,"Eastern Division","PBE",10,9,1,"10 - 9",6,100,99,175,9801,10000,19,0.494975001262562,9,10,"9 - 10","#005CAD",3,5,"2030"
3,100,97,2030-06-11,1905,9,1,6,"PRO","Providence Crabs","away",0,1,"Eastern Division","PBE",10,10,0,"10 - 10",12,112,100,181,10000,12544,20,0.443577004968062,9,11,"9 - 11","#005CAD",3,5,"2030"
3,100,102,2030-06-12,1905,9,4,8,"PRO","Providence Crabs","away",1,0,"Eastern Division","PBE",11,10,1,"11 - 10",3,115,104,189,10816,13225,21,0.449898090761616,9,12,"9 - 12","#005CAD",3,5,"2030"
3,100,107,2030-06-13,1905,9,2,6,"PRO","Providence Crabs","away",1,0,"Eastern Division","PBE",12,10,2,"12 - 10",1,116,106,195,11236,13456,22,0.455046168799611,10,12,"10 - 12","#005CAD",3,5,"2030"
3,100,117,2030-06-16,1905,9,1,6,"PRO","Providence Crabs","away",0,1,"Eastern Division","PBE",12,11,1,"12 - 11",5,121,107,201,11449,14641,23,0.438827136834036,10,13,"10 - 13","#005CAD",3,5,"2030"
3,100,122,2030-06-17,1905,9,3,6,"PRO","Providence Crabs","away",0,1,"Eastern Division","PBE",12,12,0,"12 - 12",5,126,110,207,12100,15876,24,0.432513583071204,10,14,"10 - 14","#005CAD",3,5,"2030"
3,100,127,2030-06-18,1905,9,1,6,"PRO","Providence Crabs","away",0,1,"Eastern Division","PBE",12,13,-1,"12 - 13",3,129,111,213,12321,16641,25,0.425419515226849,11,14,"11 - 14","#005CAD",3,5,"2030"
3,100,132,2030-06-19,1905,9,5,9,"PRO","Providence Crabs","away",1,0,"Eastern Division","PBE",13,13,0,"13 - 13",1,130,116,222,13456,16900,26,0.443273158518909,12,14,"12 - 14","#005CAD",3,5,"2030"
3,100,136,2030-06-22,1905,9,2,7,"PRO","Providence Crabs","home",1,0,"Eastern Division","PBE",14,13,1,"14 - 13",1,131,118,229,13924,17161,27,0.447933086697764,12,15,"12 - 15","#005CAD",3,5,"2030"
3,100,141,2030-06-23,1905,10,3,10,"PRO","Providence Crabs","home",0,1,"Eastern Division","PBE",14,14,0,"14 - 14",4,135,121,239,14641,18225,28,0.445475567455729,12,16,"12 - 16","#005CAD",3,5,"2030"
3,100,146,2030-06-24,1905,9,3,9,"PRO","Providence Crabs","home",0,1,"Eastern Division","PBE",14,15,-1,"14 - 15",9,144,124,248,15376,20736,29,0.425786442179885,12,17,"12 - 17","#005CAD",3,5,"2030"
3,100,151,2030-06-25,1905,9,3,5,"PRO","Providence Crabs","home",0,1,"Eastern Division","PBE",14,16,-2,"14 - 16",9,153,127,253,16129,23409,30,0.407936668521422,12,18,"12 - 18","#005CAD",3,5,"2030"
3,100,155,2030-06-27,1905,9,6,7,"PRO","Providence Crabs","away",0,1,"Eastern Division","PBE",14,17,-3,"14 - 17",7,160,133,260,17689,25600,31,0.408625747880524,13,18,"13 - 18","#005CAD",3,5,"2030"
3,100,159,2030-06-28,1905,9,1,8,"PRO","Providence Crabs","away",0,1,"Eastern Division","PBE",14,18,-4,"14 - 18",2,162,134,268,17956,26244,32,0.406244343891403,13,19,"13 - 19","#005CAD",3,5,"2030"
3,100,164,2030-06-29,1905,10,7,12,"PRO","Providence Crabs","away",1,0,"Eastern Division","PBE",15,18,-3,"15 - 18",6,168,141,280,19881,28224,33,0.413283442469598,14,19,"14 - 19","#005CAD",3,5,"2030"
3,100,169,2030-06-30,1905,9,5,10,"PRO","Providence Crabs","away",1,0,"Eastern Division","PBE",16,18,-2,"16 - 18",2,170,146,290,21316,28900,34,0.424486219531623,14,20,"14 - 20","#005CAD",3,5,"2030"
3,100,174,2030-07-03,1905,9,6,6,"PRO","Providence Crabs","home",1,0,"Eastern Division","PBE",17,18,-1,"17 - 18",5,175,152,296,23104,30625,35,0.430009864319083,15,20,"15 - 20","#005CAD",3,5,"2030"
3,100,179,2030-07-04,1905,9,5,7,"PRO","Providence Crabs","home",1,0,"Eastern Division","PBE",18,18,0,"18 - 18",3,178,157,303,24649,31684,36,0.43755880212309,16,20,"16 - 20","#005CAD",3,5,"2030"
3,100,184,2030-07-05,1905,9,7,9,"PRO","Providence Crabs","home",1,0,"Eastern Division","PBE",19,18,1,"19 - 18",5,183,164,312,26896,33489,37,0.445408627970522,16,21,"16 - 21","#005CAD",3,5,"2030"
3,100,189,2030-07-06,1905,10,4,12,"PRO","Providence Crabs","home",1,0,"Eastern Division","PBE",20,18,2,"20 - 18",3,186,168,324,28224,34596,38,0.449283667621777,17,21,"17 - 21","#005CAD",3,5,"2030"
3,100,196,2030-07-09,1905,9,5,10,"PRO","Providence Crabs","home",1,0,"Eastern Division","PBE",21,18,3,"21 - 18",2,188,173,334,29929,35344,39,0.458520368299297,18,21,"18 - 21","#005CAD",3,5,"2030"
3,100,201,2030-07-10,1905,9,1,7,"PRO","Providence Crabs","home",0,1,"Eastern Division","PBE",21,19,2,"21 - 19",2,190,174,341,30276,36100,40,0.456128721224539,18,22,"18 - 22","#005CAD",3,5,"2030"
3,100,206,2030-07-11,1905,9,5,9,"PRO","Providence Crabs","home",1,0,"Eastern Division","PBE",22,19,3,"22 - 19",3,193,179,350,32041,37249,41,0.462418819454467,19,22,"19 - 22","#005CAD",3,5,"2030"
3,100,211,2030-07-12,1905,9,5,10,"PRO","Providence Crabs","home",1,0,"Eastern Division","PBE",23,19,4,"23 - 19",2,195,184,360,33856,38025,42,0.471000681682225,20,22,"20 - 22","#005CAD",3,5,"2030"
3,100,218,2030-07-15,1905,9,0,6,"PRO","Providence Crabs","away",0,1,"Eastern Division","PBE",23,20,3,"23 - 20",8,203,184,366,33856,41209,43,0.451022447212416,19,24,"19 - 24","#005CAD",3,5,"2030"
3,100,223,2030-07-16,1905,9,3,4,"PRO","Providence Crabs","away",0,1,"Eastern Division","PBE",23,21,2,"23 - 21",10,213,187,370,34969,45369,44,0.435273469590978,19,25,"19 - 25","#005CAD",3,5,"2030"
3,100,228,2030-07-17,1905,9,1,8,"PRO","Providence Crabs","away",0,1,"Eastern Division","PBE",23,22,1,"23 - 22",7,220,188,378,35344,48400,45,0.4220481467329,19,26,"19 - 26","#005CAD",3,5,"2030"
3,100,233,2030-07-18,1905,9,3,6,"PRO","Providence Crabs","away",0,1,"Eastern Division","PBE",23,23,0,"23 - 23",4,224,191,384,36481,50176,46,0.420981571021383,19,27,"19 - 27","#005CAD",3,5,"2030"
3,100,237,2030-07-21,1905,9,4,7,"PRO","Providence Crabs","away",1,0,"Eastern Division","PBE",24,23,1,"24 - 23",3,227,195,391,38025,51529,47,0.424604149451727,20,27,"20 - 27","#005CAD",3,5,"2030"
3,100,242,2030-07-22,1905,9,4,5,"PRO","Providence Crabs","away",1,0,"Eastern Division","PBE",25,23,2,"25 - 23",2,229,199,396,39601,52441,48,0.430249234045327,21,27,"21 - 27","#005CAD",3,5,"2030"
3,100,247,2030-07-23,1905,9,3,10,"PRO","Providence Crabs","away",1,0,"Eastern Division","PBE",26,23,3,"26 - 23",1,230,202,406,40804,52900,49,0.435456330572868,21,28,"21 - 28","#005CAD",3,5,"2030"
3,100,252,2030-07-24,1905,9,5,7,"PRO","Providence Crabs","away",0,1,"Eastern Division","PBE",26,24,2,"26 - 24",8,238,207,413,42849,56644,50,0.430673514719629,22,28,"22 - 28","#005CAD",3,5,"2030"
3,100,254,2030-08-12,1905,9,5,12,"PRO","Providence Crabs","away",1,0,"Eastern Division","PBE",27,24,3,"27 - 24",2,240,212,425,44944,57600,51,0.438289904821345,22,29,"22 - 29","#005CAD",3,5,"2030"
3,100,259,2030-08-13,1905,9,5,7,"PRO","Providence Crabs","away",1,0,"Eastern Division","PBE",28,24,4,"28 - 24",4,244,217,432,47089,59536,52,0.441631887456038,23,29,"23 - 29","#005CAD",3,5,"2030"
3,100,264,2030-08-14,1905,9,5,7,"PRO","Providence Crabs","away",1,0,"Eastern Division","PBE",29,24,5,"29 - 24",0,244,222,439,49284,59536,53,0.452894688476383,24,29,"24 - 29","#005CAD",3,5,"2030"
3,100,269,2030-08-15,1905,10,5,11,"PRO","Providence Crabs","away",1,0,"Eastern Division","PBE",30,24,6,"30 - 24",4,248,227,450,51529,61504,54,0.455875717710757,25,29,"25 - 29","#005CAD",3,5,"2030"
3,100,275,2030-08-17,1905,9,9,10,"PRO","Providence Crabs","away",0,1,"Eastern Division","PBE",30,25,5,"30 - 25",18,266,236,460,55696,70756,55,0.44045171290292,24,31,"24 - 31","#005CAD",3,5,"2030"
3,100,279,2030-08-18,1905,9,9,14,"PRO","Providence Crabs","away",1,0,"Eastern Division","PBE",31,25,6,"31 - 25",4,270,245,474,60025,72900,56,0.45157043445552,25,31,"25 - 31","#005CAD",3,5,"2030"
3,100,284,2030-08-19,1905,9,10,11,"PRO","Providence Crabs","away",1,0,"Eastern Division","PBE",32,25,7,"32 - 25",8,278,255,485,65025,77284,57,0.456928233632448,26,31,"26 - 31","#005CAD",3,5,"2030"
3,100,289,2030-08-20,1905,9,20,22,"PRO","Providence Crabs","away",1,0,"Eastern Division","PBE",33,25,8,"33 - 25",14,292,275,507,75625,85264,58,0.47004456488635,27,31,"27 - 31","#005CAD",3,5,"2030"
3,100,292,2030-08-22,1905,9,1,10,"PRO","Providence Crabs","away",0,1,"Eastern Division","PBE",33,26,7,"33 - 26",6,298,276,517,76176,88804,59,0.461728694387198,27,32,"27 - 32","#005CAD",3,5,"2030"
3,100,296,2030-08-23,1905,14,2,12,"PRO","Providence Crabs","away",0,1,"Eastern Division","PBE",33,27,6,"33 - 27",3,301,278,529,77284,90601,60,0.460338922476695,28,32,"28 - 32","#005CAD",3,5,"2030"
3,100,301,2030-08-24,1905,9,2,8,"PRO","Providence Crabs","away",0,1,"Eastern Division","PBE",33,28,5,"33 - 28",7,308,280,537,78400,94864,61,0.452488687782805,28,33,"28 - 33","#005CAD",3,5,"2030"
3,100,636,2030-08-27,1905,9,2,5,"PRO","Providence Crabs","home",0,1,"Eastern Division","PBE",33,29,4,"33 - 29",5,313,282,542,79524,97969,62,0.448040204402427,28,34,"28 - 34","#005CAD",3,5,"2030"
3,100,641,2030-08-28,1905,9,3,8,"PRO","Providence Crabs","home",0,1,"Eastern Division","PBE",33,30,3,"33 - 30",4,317,285,550,81225,100489,63,0.446993627348471,28,35,"28 - 35","#005CAD",3,5,"2030"
3,100,646,2030-08-29,1905,9,1,7,"PRO","Providence Crabs","home",0,1,"Eastern Division","PBE",33,31,2,"33 - 31",2,319,286,557,81796,101761,64,0.445616348055372,29,35,"29 - 35","#005CAD",3,5,"2030"
3,100,651,2030-08-30,1905,9,3,6,"PRO","Providence Crabs","home",1,0,"Eastern Division","PBE",34,31,3,"34 - 31",2,321,289,563,83521,103041,65,0.447684951919469,29,36,"29 - 36","#005CAD",3,5,"2030"
3,100,656,2030-09-02,1905,9,4,10,"PRO","Providence Crabs","home",0,1,"Eastern Division","PBE",34,32,2,"34 - 32",8,329,293,573,85849,108241,66,0.442315420681127,29,37,"29 - 37","#005CAD",3,5,"2030"
3,100,661,2030-09-03,1905,9,4,5,"PRO","Providence Crabs","home",1,0,"Eastern Division","PBE",35,32,3,"35 - 32",3,332,297,578,88209,110224,67,0.444527875907737,30,37,"30 - 37","#005CAD",3,5,"2030"
3,100,666,2030-09-04,1905,11,8,17,"PRO","Providence Crabs","home",1,0,"Eastern Division","PBE",36,32,4,"36 - 32",7,339,305,595,93025,114921,68,0.447351716310965,30,38,"30 - 38","#005CAD",3,5,"2030"
3,100,671,2030-09-05,1905,9,5,10,"PRO","Providence Crabs","home",0,1,"Eastern Division","PBE",36,33,3,"36 - 33",12,351,310,605,96100,123201,69,0.438210496076169,30,39,"30 - 39","#005CAD",3,5,"2030"
3,100,674,2030-09-08,1905,9,1,8,"PRO","Providence Crabs","away",0,1,"Eastern Division","PBE",36,34,2,"36 - 34",7,358,311,613,96721,128164,70,0.430090935366965,30,40,"30 - 40","#005CAD",3,5,"2030"
3,100,679,2030-09-09,1905,10,5,10,"PRO","Providence Crabs","away",1,0,"Eastern Division","PBE",37,34,3,"37 - 34",2,360,316,623,99856,129600,71,0.43518583083467,31,40,"31 - 40","#005CAD",3,5,"2030"
3,100,684,2030-09-10,1905,9,5,11,"PRO","Providence Crabs","away",1,0,"Eastern Division","PBE",38,34,4,"38 - 34",0,360,321,634,103041,129600,72,0.442918488142675,32,40,"32 - 40","#005CAD",3,5,"2030"
3,100,689,2030-09-11,1905,9,3,13,"PRO","Providence Crabs","away",0,1,"Eastern Division","PBE",38,35,3,"38 - 35",6,366,324,647,104976,133956,73,0.439355130329968,32,41,"32 - 41","#005CAD",3,5,"2030"
3,100,698,2030-09-14,1905,11,4,13,"PRO","Providence Crabs","home",1,0,"Eastern Division","PBE",39,35,4,"39 - 35",3,369,328,660,107584,136161,74,0.441379310344828,33,41,"33 - 41","#005CAD",3,5,"2030"
3,100,703,2030-09-15,1905,9,0,8,"PRO","Providence Crabs","home",0,1,"Eastern Division","PBE",39,36,3,"39 - 36",7,376,328,668,107584,141376,75,0.432133676092545,32,43,"32 - 43","#005CAD",3,5,"2030"
3,100,708,2030-09-16,1905,9,1,7,"PRO","Providence Crabs","home",0,1,"Eastern Division","PBE",39,37,2,"39 - 37",6,382,329,675,108241,145924,76,0.425869022091948,32,44,"32 - 44","#005CAD",3,5,"2030"
3,100,713,2030-09-17,1905,9,1,4,"PRO","Providence Crabs","home",0,1,"Eastern Division","PBE",39,38,1,"39 - 38",4,386,330,679,108900,148996,77,0.422263237894345,33,44,"33 - 44","#005CAD",3,5,"2030"
3,100,715,2030-09-20,1905,12,4,11,"PRO","Providence Crabs","home",0,1,"Eastern Division","PBE",39,39,0,"39 - 39",6,392,334,690,111556,153664,78,0.420616846391675,33,45,"33 - 45","#005CAD",3,5,"2030"
3,100,720,2030-09-21,1905,9,8,10,"PRO","Providence Crabs","home",1,0,"Eastern Division","PBE",40,39,1,"40 - 39",2,394,342,700,116964,155236,79,0.429698750918442,34,45,"34 - 45","#005CAD",3,5,"2030"
3,100,725,2030-09-22,1905,9,2,6,"PRO","Providence Crabs","home",0,1,"Eastern Division","PBE",40,40,0,"40 - 40",3,397,344,706,118336,157609,80,0.428839080251499,34,46,"34 - 46","#005CAD",3,5,"2030"
3,100,733,2030-09-25,1905,9,10,14,"PRO","Providence Crabs","home",1,0,"Eastern Division","PBE",41,40,1,"41 - 40",9,406,354,720,125316,164836,81,0.431897763930629,35,46,"35 - 46","#005CAD",3,5,"2030"
3,100,738,2030-09-26,1905,9,2,13,"PRO","Providence Crabs","home",0,1,"Eastern Division","PBE",41,41,0,"41 - 41",7,413,356,733,126736,170569,82,0.426282773582684,35,47,"35 - 47","#005CAD",3,5,"2030"
3,100,743,2030-09-27,1905,10,6,10,"PRO","Providence Crabs","home",1,0,"Eastern Division","PBE",42,41,1,"42 - 41",5,418,362,743,131044,174724,83,0.428573297401952,36,47,"36 - 47","#005CAD",3,5,"2030"
3,100,748,2030-09-28,1905,9,6,10,"PRO","Providence Crabs","home",1,0,"Eastern Division","PBE",43,41,2,"43 - 41",1,419,368,753,135424,175561,84,0.435467948614885,37,47,"37 - 47","#005CAD",3,5,"2030"
3,100,753,2030-09-30,1905,9,5,11,"PRO","Providence Crabs","away",1,0,"Eastern Division","PBE",44,41,3,"44 - 41",3,422,373,764,139129,178084,85,0.438598039802908,37,48,"37 - 48","#005CAD",3,5,"2030"
3,100,758,2030-10-01,1905,9,8,14,"PRO","Providence Crabs","away",1,0,"Eastern Division","PBE",45,41,4,"45 - 41",0,422,381,778,145161,178084,86,0.449074231619979,39,47,"39 - 47","#005CAD",3,5,"2030"
3,100,763,2030-10-02,1905,9,6,9,"PRO","Providence Crabs","away",1,0,"Eastern Division","PBE",46,41,5,"46 - 41",3,425,387,787,149769,180625,87,0.453304236759747,39,48,"39 - 48","#005CAD",3,5,"2030"
3,100,768,2030-10-03,1905,9,5,8,"PRO","Providence Crabs","away",1,0,"Eastern Division","PBE",47,41,6,"47 - 41",0,425,392,795,153664,180625,88,0.459674114314261,40,48,"40 - 48","#005CAD",3,5,"2030"
3,100,774,2030-10-05,1905,9,0,6,"PRO","Providence Crabs","home",0,1,"Eastern Division","PBE",47,42,5,"47 - 42",6,431,392,801,153664,185761,89,0.452718568166753,40,49,"40 - 49","#005CAD",3,5,"2030"
3,100,779,2030-10-06,1905,9,1,1,"PRO","Providence Crabs","home",0,1,"Eastern Division","PBE",47,43,4,"47 - 43",10,441,393,802,154449,194481,90,0.442636058808357,40,50,"40 - 50","#005CAD",3,5,"2030"
9,100,4,2030-05-15,1905,9,2,6,"SAS","San Antonio Sloths","home",0,1,"Western Division","PBE",0,1,-1,"0 - 1",11,11,2,6,4,121,1,0.032,0,1,"0 - 1","#87795E",4,7,"2030"
9,100,9,2030-05-16,1905,9,11,10,"SAS","San Antonio Sloths","home",1,0,"Western Division","PBE",1,1,0,"1 - 1",3,14,13,16,169,196,2,0.463013698630137,1,1,"1 - 1","#87795E",4,7,"2030"
9,100,14,2030-05-17,1905,9,2,8,"SAS","San Antonio Sloths","home",0,1,"Western Division","PBE",1,2,-1,"1 - 2",18,32,15,24,225,1024,3,0.180144115292234,1,2,"1 - 2","#87795E",4,7,"2030"
9,100,19,2030-05-18,1905,9,8,16,"SAS","San Antonio Sloths","home",1,0,"Western Division","PBE",2,2,0,"2 - 2",6,38,23,40,529,1444,4,0.268119614799797,1,3,"1 - 3","#87795E",4,7,"2030"
9,100,23,2030-05-21,1905,9,4,10,"SAS","San Antonio Sloths","away",1,0,"Western Division","PBE",3,2,1,"3 - 2",2,40,27,50,729,1600,5,0.31300987548304,2,3,"2 - 3","#87795E",4,7,"2030"
9,100,28,2030-05-22,1905,9,8,12,"SAS","San Antonio Sloths","away",1,0,"Western Division","PBE",4,2,2,"4 - 2",2,42,35,62,1225,1764,6,0.409836065573771,2,4,"2 - 4","#87795E",4,7,"2030"
9,100,33,2030-05-23,1905,9,4,10,"SAS","San Antonio Sloths","away",0,1,"Western Division","PBE",4,3,1,"4 - 3",5,47,39,72,1521,2209,7,0.407774798927614,3,4,"3 - 4","#87795E",4,7,"2030"
9,100,37,2030-05-24,1905,9,5,8,"SAS","San Antonio Sloths","away",0,1,"Western Division","PBE",4,4,0,"4 - 4",6,53,44,80,1936,2809,8,0.408008429926238,3,5,"3 - 5","#87795E",4,7,"2030"
9,100,43,2030-05-26,1905,9,3,5,"SAS","San Antonio Sloths","home",0,1,"Western Division","PBE",4,5,-1,"4 - 5",6,59,47,85,2209,3481,9,0.388224956063269,3,6,"3 - 6","#87795E",4,7,"2030"
9,100,48,2030-05-27,1905,13,5,9,"SAS","San Antonio Sloths","home",1,0,"Western Division","PBE",5,5,0,"5 - 5",2,61,52,94,2704,3721,10,0.420856031128405,4,6,"4 - 6","#87795E",4,7,"2030"
9,100,53,2030-05-28,1905,9,2,7,"SAS","San Antonio Sloths","home",0,1,"Western Division","PBE",5,6,-1,"5 - 6",10,71,54,101,2916,5041,11,0.366469775040845,4,7,"4 - 7","#87795E",4,7,"2030"
9,100,58,2030-05-29,1905,9,8,17,"SAS","San Antonio Sloths","home",0,1,"Western Division","PBE",5,7,-2,"5 - 7",9,80,62,118,3844,6400,12,0.375244045294807,5,7,"5 - 7","#87795E",4,7,"2030"
9,100,62,2030-06-01,1905,9,6,11,"SAS","San Antonio Sloths","home",1,0,"Western Division","PBE",6,7,-1,"6 - 7",0,80,68,129,4624,6400,13,0.41944847605225,5,8,"5 - 8","#87795E",4,7,"2030"
9,100,67,2030-06-02,1905,9,3,6,"SAS","San Antonio Sloths","home",0,1,"Western Division","PBE",6,8,-2,"6 - 8",4,84,71,135,5041,7056,14,0.416714887988758,6,8,"6 - 8","#87795E",4,7,"2030"
9,100,72,2030-06-03,1905,9,4,9,"SAS","San Antonio Sloths","home",1,0,"Western Division","PBE",7,8,-1,"7 - 8",0,84,75,144,5625,7056,15,0.443577004968062,7,8,"7 - 8","#87795E",4,7,"2030"
9,100,77,2030-06-04,1905,9,13,15,"SAS","San Antonio Sloths","home",1,0,"Western Division","PBE",8,8,0,"8 - 8",9,93,88,159,7744,8649,16,0.472396754712377,8,8,"8 - 8","#87795E",4,7,"2030"
9,100,82,2030-06-06,1905,9,2,6,"SAS","San Antonio Sloths","away",0,1,"Western Division","PBE",8,9,-1,"8 - 9",7,100,90,165,8100,10000,17,0.447513812154696,8,9,"8 - 9","#87795E",4,7,"2030"
9,100,86,2030-06-07,1905,9,1,6,"SAS","San Antonio Sloths","away",0,1,"Western Division","PBE",8,10,-2,"8 - 10",3,103,91,171,8281,10609,18,0.438380095288512,8,10,"8 - 10","#87795E",4,7,"2030"
9,100,91,2030-06-08,1905,9,4,5,"SAS","San Antonio Sloths","away",0,1,"Western Division","PBE",8,11,-3,"8 - 11",7,110,95,176,9025,12100,19,0.427218934911243,8,11,"8 - 11","#87795E",4,7,"2030"
9,100,95,2030-06-09,1905,9,7,8,"SAS","San Antonio Sloths","away",0,1,"Western Division","PBE",8,12,-4,"8 - 12",13,123,102,184,10404,15129,20,0.407472682410998,8,12,"8 - 12","#87795E",4,7,"2030"
9,100,101,2030-06-11,1905,9,4,7,"SAS","San Antonio Sloths","away",0,1,"Western Division","PBE",8,13,-5,"8 - 13",5,128,106,191,11236,16384,21,0.406806661839247,9,12,"9 - 12","#87795E",4,7,"2030"
9,100,106,2030-06-12,1905,9,1,2,"SAS","San Antonio Sloths","away",0,1,"Western Division","PBE",8,14,-6,"8 - 14",3,131,107,193,11449,17161,22,0.400174764068507,9,13,"9 - 13","#87795E",4,7,"2030"
9,100,111,2030-06-13,1905,9,5,6,"SAS","San Antonio Sloths","away",0,1,"Western Division","PBE",8,15,-7,"8 - 15",7,138,112,199,12544,19044,23,0.397112827656072,9,14,"9 - 14","#87795E",4,7,"2030"
9,100,115,2030-06-14,1905,9,1,9,"SAS","San Antonio Sloths","away",0,1,"Western Division","PBE",8,16,-8,"8 - 16",6,144,113,208,12769,20736,24,0.381107297418296,9,15,"9 - 15","#87795E",4,7,"2030"
9,100,118,2030-06-16,1905,9,4,8,"SAS","San Antonio Sloths","away",0,1,"Western Division","PBE",8,17,-9,"8 - 17",5,149,117,216,13689,22201,25,0.381415436054611,10,15,"10 - 15","#87795E",4,7,"2030"
9,100,123,2030-06-17,1905,10,5,10,"SAS","San Antonio Sloths","away",1,0,"Western Division","PBE",9,17,-8,"9 - 17",3,152,122,226,14884,23104,26,0.391807939349268,10,16,"10 - 16","#87795E",4,7,"2030"
9,100,128,2030-06-18,1905,9,4,8,"SAS","San Antonio Sloths","away",1,0,"Western Division","PBE",10,17,-7,"10 - 17",3,155,126,234,15876,24025,27,0.397884764792862,11,16,"11 - 16","#87795E",4,7,"2030"
9,100,133,2030-06-19,1905,9,2,5,"SAS","San Antonio Sloths","away",1,0,"Western Division","PBE",11,17,-6,"11 - 17",1,156,128,239,16384,24336,28,0.402357563850688,11,17,"11 - 17","#87795E",4,7,"2030"
9,100,137,2030-06-22,1905,9,2,5,"SAS","San Antonio Sloths","away",1,0,"Western Division","PBE",12,17,-5,"12 - 17",1,157,130,244,16900,24649,29,0.406748658210787,12,17,"12 - 17","#87795E",4,7,"2030"
9,100,142,2030-06-23,1905,9,2,10,"SAS","San Antonio Sloths","away",0,1,"Western Division","PBE",12,18,-6,"12 - 18",3,160,132,254,17424,25600,30,0.404983265154332,12,18,"12 - 18","#87795E",4,7,"2030"
9,100,147,2030-06-24,1905,9,5,7,"SAS","San Antonio Sloths","away",0,1,"Western Division","PBE",12,19,-7,"12 - 19",6,166,137,261,18769,27556,31,0.405159201295197,13,18,"13 - 18","#87795E",4,7,"2030"
9,100,152,2030-06-25,1905,9,3,5,"SAS","San Antonio Sloths","away",0,1,"Western Division","PBE",12,20,-8,"12 - 20",4,170,140,266,19600,28900,32,0.404123711340206,13,19,"13 - 19","#87795E",4,7,"2030"
9,100,158,2030-06-27,1905,9,1,6,"SAS","San Antonio Sloths","away",1,0,"Western Division","PBE",13,20,-7,"13 - 20",0,170,141,272,19881,28900,33,0.407556220659683,13,20,"13 - 20","#87795E",4,7,"2030"
9,100,163,2030-06-28,1905,9,4,9,"SAS","San Antonio Sloths","away",1,0,"Western Division","PBE",14,20,-6,"14 - 20",1,171,145,281,21025,29241,34,0.418274778180082,14,20,"14 - 20","#87795E",4,7,"2030"
9,100,168,2030-06-29,1905,9,7,13,"SAS","San Antonio Sloths","away",0,1,"Western Division","PBE",14,21,-7,"14 - 21",11,182,152,294,23104,33124,35,0.410898484740699,14,21,"14 - 21","#87795E",4,7,"2030"
9,100,173,2030-06-30,1905,14,6,14,"SAS","San Antonio Sloths","away",0,1,"Western Division","PBE",14,22,-8,"14 - 22",9,191,158,308,24964,36481,36,0.40628204084954,15,21,"15 - 21","#87795E",4,7,"2030"
9,100,176,2030-07-03,1905,9,3,5,"SAS","San Antonio Sloths","home",1,0,"Western Division","PBE",15,22,-7,"15 - 22",0,191,161,313,25921,36481,37,0.415387327329252,15,22,"15 - 22","#87795E",4,7,"2030"
9,100,181,2030-07-04,1905,9,12,14,"SAS","San Antonio Sloths","home",1,0,"Western Division","PBE",16,22,-6,"16 - 22",3,194,173,327,29929,37636,38,0.442966032709243,17,21,"17 - 21","#87795E",4,7,"2030"
9,100,186,2030-07-05,1905,9,7,10,"SAS","San Antonio Sloths","home",0,1,"Western Division","PBE",16,23,-7,"16 - 23",8,202,180,337,32400,40804,39,0.442598765094804,17,22,"17 - 22","#87795E",4,7,"2030"
9,100,191,2030-07-06,1905,9,3,7,"SAS","San Antonio Sloths","home",0,1,"Western Division","PBE",16,24,-8,"16 - 24",8,210,183,344,33489,44100,40,0.43162046166338,17,23,"17 - 23","#87795E",4,7,"2030"
9,100,197,2030-07-09,1905,9,3,5,"SAS","San Antonio Sloths","home",0,1,"Western Division","PBE",16,25,-9,"16 - 25",4,214,186,349,34596,45796,41,0.430341327495273,18,23,"18 - 23","#87795E",4,7,"2030"
9,100,202,2030-07-10,1905,9,4,7,"SAS","San Antonio Sloths","home",0,1,"Western Division","PBE",16,26,-10,"16 - 26",7,221,190,356,36100,48841,42,0.425000882965823,18,24,"18 - 24","#87795E",4,7,"2030"
9,100,207,2030-07-11,1905,9,1,6,"SAS","San Antonio Sloths","home",0,1,"Western Division","PBE",16,27,-11,"16 - 27",3,224,191,362,36481,50176,43,0.420981571021383,18,25,"18 - 25","#87795E",4,7,"2030"
9,100,212,2030-07-12,1905,9,3,3,"SAS","San Antonio Sloths","home",1,0,"Western Division","PBE",17,27,-10,"17 - 27",2,226,194,365,37636,51076,44,0.424249256019479,19,25,"19 - 25","#87795E",4,7,"2030"
9,100,214,2030-07-15,1905,9,0,4,"SAS","San Antonio Sloths","away",0,1,"Western Division","PBE",17,28,-11,"17 - 28",6,232,194,369,37636,53824,45,0.411502296085721,19,26,"19 - 26","#87795E",4,7,"2030"
9,100,219,2030-07-16,1905,10,3,7,"SAS","San Antonio Sloths","away",1,0,"Western Division","PBE",18,28,-10,"18 - 28",1,233,197,376,38809,54289,46,0.416861801542461,19,27,"19 - 27","#87795E",4,7,"2030"
9,100,224,2030-07-17,1905,11,3,7,"SAS","San Antonio Sloths","away",0,1,"Western Division","PBE",18,29,-11,"18 - 29",5,238,200,383,40000,56644,47,0.413890153553247,19,28,"19 - 28","#87795E",4,7,"2030"
9,100,229,2030-07-18,1905,9,5,11,"SAS","San Antonio Sloths","away",1,0,"Western Division","PBE",19,29,-10,"19 - 29",4,242,205,394,42025,58564,48,0.417789221485451,20,28,"20 - 28","#87795E",4,7,"2030"
9,100,238,2030-07-21,1905,9,7,11,"SAS","San Antonio Sloths","home",0,1,"Western Division","PBE",19,30,-11,"19 - 30",10,252,212,405,44944,63504,49,0.414429035113603,20,29,"20 - 29","#87795E",4,7,"2030"
9,100,243,2030-07-22,1905,10,5,11,"SAS","San Antonio Sloths","home",1,0,"Western Division","PBE",20,30,-10,"20 - 30",4,256,217,416,47089,65536,50,0.418104328523862,21,29,"21 - 29","#87795E",4,7,"2030"
9,100,248,2030-07-23,1905,9,2,7,"SAS","San Antonio Sloths","home",1,0,"Western Division","PBE",21,30,-9,"21 - 30",0,256,219,423,47961,65536,51,0.422575046036459,22,29,"22 - 29","#87795E",4,7,"2030"
9,100,253,2030-07-24,1905,9,7,8,"SAS","San Antonio Sloths","home",1,0,"Western Division","PBE",22,30,-8,"22 - 30",3,259,226,431,51076,67081,52,0.432272315647824,22,30,"22 - 30","#87795E",4,7,"2030"
9,100,255,2030-08-12,1905,10,4,7,"SAS","San Antonio Sloths","away",0,1,"Western Division","PBE",22,31,-9,"22 - 31",5,264,230,438,52900,69696,53,0.431498580704101,23,30,"23 - 30","#87795E",4,7,"2030"
9,100,260,2030-08-13,1905,9,6,8,"SAS","San Antonio Sloths","away",1,0,"Western Division","PBE",23,31,-8,"23 - 31",5,269,236,446,55696,72361,54,0.43493131964672,23,31,"23 - 31","#87795E",4,7,"2030"
9,100,265,2030-08-14,1905,9,6,9,"SAS","San Antonio Sloths","away",0,1,"Western Division","PBE",23,32,-9,"23 - 32",7,276,242,455,58564,76176,55,0.434644500519519,24,31,"24 - 31","#87795E",4,7,"2030"
9,100,270,2030-08-15,1905,9,6,11,"SAS","San Antonio Sloths","away",0,1,"Western Division","PBE",23,33,-10,"23 - 33",8,284,248,466,61504,80656,56,0.432639279684862,24,32,"24 - 32","#87795E",4,7,"2030"
9,100,275,2030-08-17,1905,9,18,22,"SAS","San Antonio Sloths","home",1,0,"Western Division","PBE",24,33,-9,"24 - 33",9,293,266,488,70756,85849,57,0.451811883400913,26,31,"26 - 31","#87795E",4,7,"2030"
9,100,279,2030-08-18,1905,9,4,11,"SAS","San Antonio Sloths","home",0,1,"Western Division","PBE",24,34,-10,"24 - 34",9,302,270,499,72900,91204,58,0.44423048798323,26,32,"26 - 32","#87795E",4,7,"2030"
9,100,284,2030-08-19,1905,9,8,8,"SAS","San Antonio Sloths","home",0,1,"Western Division","PBE",24,35,-11,"24 - 35",10,312,278,507,77284,97344,59,0.442563620954257,26,33,"26 - 33","#87795E",4,7,"2030"
9,100,289,2030-08-20,1905,9,14,13,"SAS","San Antonio Sloths","home",0,1,"Western Division","PBE",24,36,-12,"24 - 36",20,332,292,520,85264,110224,60,0.436159764282207,26,34,"26 - 34","#87795E",4,7,"2030"
9,100,298,2030-08-23,1905,9,3,8,"SAS","San Antonio Sloths","home",1,0,"Western Division","PBE",25,36,-11,"25 - 36",2,334,295,528,87025,111556,61,0.438234272160982,27,34,"27 - 34","#87795E",4,7,"2030"
9,100,629,2030-08-24,1905,9,3,6,"SAS","San Antonio Sloths","home",0,1,"Western Division","PBE",25,37,-12,"25 - 37",7,341,298,534,88804,116281,62,0.433010702879294,27,35,"27 - 35","#87795E",4,7,"2030"
9,100,633,2030-08-25,1905,9,10,12,"SAS","San Antonio Sloths","home",1,0,"Western Division","PBE",26,37,-11,"26 - 37",1,342,308,546,94864,116964,63,0.447835035972582,28,35,"28 - 35","#87795E",4,7,"2030"
9,100,635,2030-08-27,1905,9,5,8,"SAS","San Antonio Sloths","home",1,0,"Western Division","PBE",27,37,-10,"27 - 37",2,344,313,554,97969,118336,64,0.452920644460368,29,35,"29 - 35","#87795E",4,7,"2030"
9,100,640,2030-08-28,1905,9,5,13,"SAS","San Antonio Sloths","home",0,1,"Western Division","PBE",27,38,-11,"27 - 38",6,350,318,567,101124,122500,65,0.452205487783064,29,36,"29 - 36","#87795E",4,7,"2030"
9,100,645,2030-08-29,1905,10,2,3,"SAS","San Antonio Sloths","home",0,1,"Western Division","PBE",27,39,-12,"27 - 39",3,353,320,570,102400,124609,66,0.451083437220551,30,36,"30 - 36","#87795E",4,7,"2030"
9,100,650,2030-08-30,1905,10,5,9,"SAS","San Antonio Sloths","home",1,0,"Western Division","PBE",28,39,-11,"28 - 39",4,357,325,579,105625,127449,67,0.453182251130542,30,37,"30 - 37","#87795E",4,7,"2030"
9,100,657,2030-09-02,1905,9,5,7,"SAS","San Antonio Sloths","away",0,1,"Western Division","PBE",28,40,-12,"28 - 40",6,363,330,586,108900,131769,68,0.452488687782805,31,37,"31 - 37","#87795E",4,7,"2030"
9,100,662,2030-09-03,1905,9,2,9,"SAS","San Antonio Sloths","away",0,1,"Western Division","PBE",28,41,-13,"28 - 41",4,367,332,595,110224,134689,69,0.450053692535717,31,38,"31 - 38","#87795E",4,7,"2030"
9,100,667,2030-09-04,1905,9,6,9,"SAS","San Antonio Sloths","away",1,0,"Western Division","PBE",29,41,-12,"29 - 41",2,369,338,604,114244,136161,70,0.45623689622811,32,38,"32 - 38","#87795E",4,7,"2030"
9,100,672,2030-09-05,1905,9,10,11,"SAS","San Antonio Sloths","away",1,0,"Western Division","PBE",30,41,-11,"30 - 41",9,378,348,615,121104,142884,71,0.458748124914769,33,38,"33 - 38","#87795E",4,7,"2030"
9,100,678,2030-09-08,1905,9,7,10,"SAS","San Antonio Sloths","away",1,0,"Western Division","PBE",31,41,-10,"31 - 41",6,384,355,625,126025,147456,72,0.460818118991813,33,39,"33 - 39","#87795E",4,7,"2030"
9,100,683,2030-09-09,1905,10,3,8,"SAS","San Antonio Sloths","away",0,1,"Western Division","PBE",31,42,-11,"31 - 42",4,388,358,633,128164,150544,73,0.459850452803651,34,39,"34 - 39","#87795E",4,7,"2030"
9,100,688,2030-09-10,1905,9,0,1,"SAS","San Antonio Sloths","away",0,1,"Western Division","PBE",31,43,-12,"31 - 43",3,391,358,634,128164,152881,74,0.4560266149549,34,40,"34 - 40","#87795E",4,7,"2030"
9,100,693,2030-09-11,1905,9,7,11,"SAS","San Antonio Sloths","away",0,1,"Western Division","PBE",31,44,-13,"31 - 44",10,401,365,645,133225,160801,75,0.453106187888146,34,41,"34 - 41","#87795E",4,7,"2030"
9,100,694,2030-09-14,1905,9,4,7,"SAS","San Antonio Sloths","home",1,0,"Western Division","PBE",32,44,-12,"32 - 44",3,404,369,652,136161,163216,76,0.454814498107737,35,41,"35 - 41","#87795E",4,7,"2030"
9,100,699,2030-09-15,1905,9,2,7,"SAS","San Antonio Sloths","home",0,1,"Western Division","PBE",32,45,-13,"32 - 45",3,407,371,659,137641,165649,77,0.453826370800224,35,42,"35 - 42","#87795E",4,7,"2030"
9,100,704,2030-09-16,1905,9,5,6,"SAS","San Antonio Sloths","home",1,0,"Western Division","PBE",33,45,-12,"33 - 45",1,408,376,665,141376,166464,78,0.459251559251559,36,42,"36 - 42","#87795E",4,7,"2030"
9,100,709,2030-09-17,1905,9,4,7,"SAS","San Antonio Sloths","home",1,0,"Western Division","PBE",34,45,-11,"34 - 45",3,411,380,672,144400,168921,79,0.460869204426132,36,43,"36 - 43","#87795E",4,7,"2030"
9,100,717,2030-09-20,1905,9,0,3,"SAS","San Antonio Sloths","away",0,1,"Western Division","PBE",34,46,-12,"34 - 46",2,413,380,675,144400,170569,80,0.458457816483527,37,43,"37 - 43","#87795E",4,7,"2030"
9,100,722,2030-09-21,1905,9,8,10,"SAS","San Antonio Sloths","away",1,0,"Western Division","PBE",35,46,-11,"35 - 46",2,415,388,685,150544,172225,81,0.466414060829881,38,43,"38 - 43","#87795E",4,7,"2030"
9,100,727,2030-09-22,1905,13,6,10,"SAS","San Antonio Sloths","away",1,0,"Western Division","PBE",36,46,-10,"36 - 46",4,419,394,695,155236,175561,82,0.469278741947478,38,44,"38 - 44","#87795E",4,7,"2030"
9,100,731,2030-09-23,1905,10,4,11,"SAS","San Antonio Sloths","away",0,1,"Western Division","PBE",36,47,-11,"36 - 47",5,424,398,706,158404,179776,83,0.468401443018511,39,44,"39 - 44","#87795E",4,7,"2030"
9,100,735,2030-09-25,1905,9,4,7,"SAS","San Antonio Sloths","home",0,1,"Western Division","PBE",36,48,-12,"36 - 48",6,430,402,713,161604,184900,84,0.466384226444716,39,45,"39 - 45","#87795E",4,7,"2030"
9,100,740,2030-09-26,1905,9,8,9,"SAS","San Antonio Sloths","home",1,0,"Western Division","PBE",37,48,-11,"37 - 48",2,432,410,722,168100,186624,85,0.473889559206594,40,45,"40 - 45","#87795E",4,7,"2030"
9,100,745,2030-09-27,1905,9,20,15,"SAS","San Antonio Sloths","home",1,0,"Western Division","PBE",38,48,-10,"38 - 48",0,432,430,737,184900,186624,86,0.497679826875249,43,43,"43 - 43","#87795E",4,7,"2030"
9,100,749,2030-09-28,1905,9,3,9,"SAS","San Antonio Sloths","home",1,0,"Western Division","PBE",39,48,-9,"39 - 48",2,434,433,746,187489,188356,87,0.498846598996927,43,44,"43 - 44","#87795E",4,7,"2030"
9,100,755,2030-09-30,1905,9,6,6,"SAS","San Antonio Sloths","home",0,1,"Western Division","PBE",39,49,-10,"39 - 49",14,448,439,752,192721,200704,88,0.489854483065387,43,45,"43 - 45","#87795E",4,7,"2030"
9,100,760,2030-10-01,1905,9,3,8,"SAS","San Antonio Sloths","home",1,0,"Western Division","PBE",40,49,-9,"40 - 49",0,448,442,760,195364,200704,89,0.493258733348819,44,45,"44 - 45","#87795E",4,7,"2030"
9,100,765,2030-10-02,1905,9,4,8,"SAS","San Antonio Sloths","home",1,0,"Western Division","PBE",41,49,-8,"41 - 49",1,449,446,768,198916,201601,90,0.496648082353558,45,45,"45 - 45","#87795E",4,7,"2030"
9,100,770,2030-10-03,1905,9,5,12,"SAS","San Antonio Sloths","home",0,1,"Western Division","PBE",41,50,-9,"41 - 50",8,457,451,780,203401,208849,91,0.493392359005458,45,46,"45 - 46","#87795E",4,7,"2030"
9,100,778,2030-10-06,1905,9,5,12,"SAS","San Antonio Sloths","away",1,0,"Western Division","PBE",42,50,-8,"42 - 50",0,457,456,792,207936,208849,92,0.498904711062058,46,46,"46 - 46","#87795E",4,7,"2030"
10,100,5,2030-05-15,1905,9,0,1,"DV","Death Valley Scorpions","away",0,1,"Western Division","PBE",0,1,-1,"0 - 1",2,2,0,1,0,4,1,0,0,1,"0 - 1","#97162B",1,1,"2030"
10,100,10,2030-05-16,1905,9,1,3,"DV","Death Valley Scorpions","away",0,1,"Western Division","PBE",0,2,-2,"0 - 2",7,9,1,4,1,81,2,0.0121951219512195,0,2,"0 - 2","#97162B",1,1,"2030"
10,100,15,2030-05-17,1905,9,6,8,"DV","Death Valley Scorpions","away",1,0,"Western Division","PBE",1,2,-1,"1 - 2",1,10,7,12,49,100,3,0.328859060402685,1,2,"1 - 2","#97162B",1,1,"2030"
10,100,20,2030-05-18,1905,9,5,13,"DV","Death Valley Scorpions","away",1,0,"Western Division","PBE",2,2,0,"2 - 2",3,13,12,25,144,169,4,0.460063897763578,2,2,"2 - 2","#97162B",1,1,"2030"
10,100,24,2030-05-21,1905,9,7,7,"DV","Death Valley Scorpions","away",1,0,"Western Division","PBE",3,2,1,"3 - 2",5,18,19,32,361,324,5,0.527007299270073,3,2,"3 - 2","#97162B",1,1,"2030"
10,100,29,2030-05-22,1905,9,6,10,"DV","Death Valley Scorpions","away",1,0,"Western Division","PBE",4,2,2,"4 - 2",0,18,25,42,625,324,6,0.658587987355111,4,2,"4 - 2","#97162B",1,1,"2030"
10,100,34,2030-05-23,1905,9,16,16,"DV","Death Valley Scorpions","away",1,0,"Western Division","PBE",5,2,3,"5 - 2",7,25,41,58,1681,625,7,0.72896790980052,5,2,"5 - 2","#97162B",1,1,"2030"
10,100,38,2030-05-24,1905,9,23,19,"DV","Death Valley Scorpions","away",1,0,"Western Division","PBE",6,2,4,"6 - 2",2,27,64,77,4096,729,8,0.848911917098446,7,1,"7 - 1","#97162B",1,1,"2030"
10,100,42,2030-05-26,1905,9,6,9,"DV","Death Valley Scorpions","home",1,0,"Western Division","PBE",7,2,5,"7 - 2",0,27,70,86,4900,729,9,0.87049209451057,8,1,"8 - 1","#97162B",1,1,"2030"
10,100,46,2030-05-27,1905,9,13,15,"DV","Death Valley Scorpions","home",1,0,"Western Division","PBE",8,2,6,"8 - 2",2,29,83,101,6889,841,10,0.891203104786546,9,1,"9 - 1","#97162B",1,1,"2030"
10,100,51,2030-05-28,1905,9,7,11,"DV","Death Valley Scorpions","home",0,1,"Western Division","PBE",8,3,5,"8 - 3",8,37,90,112,8100,1369,11,0.855422959129792,9,2,"9 - 2","#97162B",1,1,"2030"
10,100,56,2030-05-29,1905,9,6,7,"DV","Death Valley Scorpions","home",1,0,"Western Division","PBE",9,3,6,"9 - 3",5,42,96,119,9216,1764,12,0.839344262295082,10,2,"10 - 2","#97162B",1,1,"2030"
10,100,63,2030-06-01,1905,9,10,15,"DV","Death Valley Scorpions","away",1,0,"Western Division","PBE",10,3,7,"10 - 3",4,46,106,134,11236,2116,13,0.841521869382864,11,2,"11 - 2","#97162B",1,1,"2030"
10,100,68,2030-06-02,1905,9,3,5,"DV","Death Valley Scorpions","away",1,0,"Western Division","PBE",11,3,8,"11 - 3",2,48,109,139,11881,2304,14,0.83757490306662,12,2,"12 - 2","#97162B",1,1,"2030"
10,100,73,2030-06-03,1905,9,7,12,"DV","Death Valley Scorpions","away",1,0,"Western Division","PBE",12,3,9,"12 - 3",6,54,116,151,13456,2916,15,0.821891033471781,12,3,"12 - 3","#97162B",1,1,"2030"
10,100,78,2030-06-04,1905,9,14,16,"DV","Death Valley Scorpions","away",1,0,"Western Division","PBE",13,3,10,"13 - 3",2,56,130,167,16900,3136,16,0.843481732880815,13,3,"13 - 3","#97162B",1,1,"2030"
10,100,82,2030-06-06,1905,9,7,10,"DV","Death Valley Scorpions","home",1,0,"Western Division","PBE",14,3,11,"14 - 3",2,58,137,177,18769,3364,17,0.84800975918312,14,3,"14 - 3","#97162B",1,1,"2030"
10,100,86,2030-06-07,1905,9,3,2,"DV","Death Valley Scorpions","home",1,0,"Western Division","PBE",15,3,12,"15 - 3",1,59,140,179,19600,3481,18,0.849183310948399,15,3,"15 - 3","#97162B",1,1,"2030"
10,100,91,2030-06-08,1905,9,7,11,"DV","Death Valley Scorpions","home",1,0,"Western Division","PBE",16,3,13,"16 - 3",4,63,147,190,21609,3969,19,0.844827586206897,16,3,"16 - 3","#97162B",1,1,"2030"
10,100,95,2030-06-09,1905,9,13,15,"DV","Death Valley Scorpions","home",1,0,"Western Division","PBE",17,3,14,"17 - 3",7,70,160,205,25600,4900,20,0.839344262295082,17,3,"17 - 3","#97162B",1,1,"2030"
10,100,99,2030-06-11,1905,12,3,8,"DV","Death Valley Scorpions","away",1,0,"Western Division","PBE",18,3,15,"18 - 3",1,71,163,213,26569,5041,21,0.840525150268902,18,3,"18 - 3","#97162B",1,1,"2030"
10,100,104,2030-06-12,1905,9,2,3,"DV","Death Valley Scorpions","away",0,1,"Western Division","PBE",18,4,14,"18 - 4",3,74,165,216,27225,5476,22,0.832543347298248,18,4,"18 - 4","#97162B",1,1,"2030"
10,100,109,2030-06-13,1905,9,4,6,"DV","Death Valley Scorpions","away",1,0,"Western Division","PBE",19,4,15,"19 - 4",2,76,169,222,28561,5776,23,0.831784955004805,19,4,"19 - 4","#97162B",1,1,"2030"
10,100,113,2030-06-14,1905,9,4,11,"DV","Death Valley Scorpions","away",1,0,"Western Division","PBE",20,4,16,"20 - 4",1,77,173,233,29929,5929,24,0.834653354899883,20,4,"20 - 4","#97162B",1,1,"2030"
10,100,119,2030-06-16,1905,9,7,13,"DV","Death Valley Scorpions","home",1,0,"Western Division","PBE",21,4,17,"21 - 4",4,81,180,246,32400,6561,25,0.831600831600832,21,4,"21 - 4","#97162B",1,1,"2030"
10,100,124,2030-06-17,1905,9,2,7,"DV","Death Valley Scorpions","home",0,1,"Western Division","PBE",21,5,16,"21 - 5",7,88,182,253,33124,7744,26,0.810511891944798,21,5,"21 - 5","#97162B",1,1,"2030"
10,100,129,2030-06-18,1905,9,13,16,"DV","Death Valley Scorpions","home",1,0,"Western Division","PBE",22,5,17,"22 - 5",2,90,195,269,38025,8100,27,0.824390243902439,22,5,"22 - 5","#97162B",1,1,"2030"
10,100,134,2030-06-19,1905,9,9,10,"DV","Death Valley Scorpions","home",1,0,"Western Division","PBE",23,5,18,"23 - 5",7,97,204,279,41616,9409,28,0.815600195982362,23,5,"23 - 5","#97162B",1,1,"2030"
10,100,139,2030-06-22,1905,9,9,9,"DV","Death Valley Scorpions","home",1,0,"Western Division","PBE",24,5,19,"24 - 5",6,103,213,288,45369,10609,29,0.810479116795884,24,5,"24 - 5","#97162B",1,1,"2030"
10,100,144,2030-06-23,1905,9,3,6,"DV","Death Valley Scorpions","home",0,1,"Western Division","PBE",24,6,18,"24 - 6",6,109,216,294,46656,11881,30,0.79703435433999,24,6,"24 - 6","#97162B",1,1,"2030"
10,100,149,2030-06-24,1905,9,6,8,"DV","Death Valley Scorpions","home",1,0,"Western Division","PBE",25,6,19,"25 - 6",5,114,222,302,49284,12996,31,0.791329479768786,25,6,"25 - 6","#97162B",1,1,"2030"
10,100,154,2030-06-25,1905,9,6,10,"DV","Death Valley Scorpions","home",1,0,"Western Division","PBE",26,6,20,"26 - 6",2,116,228,312,51984,13456,32,0.794376528117359,25,7,"25 - 7","#97162B",1,1,"2030"
10,100,156,2030-06-27,1905,9,14,16,"DV","Death Valley Scorpions","away",1,0,"Western Division","PBE",27,6,21,"27 - 6",0,116,242,328,58564,13456,33,0.813163010274924,27,6,"27 - 6","#97162B",1,1,"2030"
10,100,161,2030-06-28,1905,9,8,12,"DV","Death Valley Scorpions","away",1,0,"Western Division","PBE",28,6,22,"28 - 6",2,118,250,340,62500,13924,34,0.817805924840364,28,6,"28 - 6","#97162B",1,1,"2030"
10,100,166,2030-06-29,1905,9,5,8,"DV","Death Valley Scorpions","away",0,1,"Western Division","PBE",28,7,21,"28 - 7",6,124,255,348,65025,15376,35,0.808758597529881,28,7,"28 - 7","#97162B",1,1,"2030"
10,100,171,2030-06-30,1905,9,8,6,"DV","Death Valley Scorpions","away",1,0,"Western Division","PBE",29,7,22,"29 - 7",2,126,263,354,69169,15876,36,0.813322358751249,29,7,"29 - 7","#97162B",1,1,"2030"
10,100,178,2030-07-03,1905,9,11,11,"DV","Death Valley Scorpions","home",1,0,"Western Division","PBE",30,7,23,"30 - 7",0,126,274,365,75076,15876,37,0.825446389304248,31,6,"31 - 6","#97162B",1,1,"2030"
10,100,183,2030-07-04,1905,9,7,10,"DV","Death Valley Scorpions","home",1,0,"Western Division","PBE",31,7,24,"31 - 7",2,128,281,375,78961,16384,38,0.828160889401647,31,7,"31 - 7","#97162B",1,1,"2030"
10,100,188,2030-07-05,1905,9,9,11,"DV","Death Valley Scorpions","home",1,0,"Western Division","PBE",32,7,25,"32 - 7",1,129,290,386,84100,16641,39,0.834814028052134,33,6,"33 - 6","#97162B",1,1,"2030"
10,100,193,2030-07-06,1905,9,7,11,"DV","Death Valley Scorpions","home",1,0,"Western Division","PBE",33,7,26,"33 - 7",1,130,297,397,88209,16900,40,0.839214529678714,34,6,"34 - 6","#97162B",1,1,"2030"
10,100,197,2030-07-09,1905,9,4,9,"DV","Death Valley Scorpions","away",1,0,"Western Division","PBE",34,7,27,"34 - 7",3,133,301,406,90601,17689,41,0.836651583710407,34,7,"34 - 7","#97162B",1,1,"2030"
10,100,202,2030-07-10,1905,9,7,9,"DV","Death Valley Scorpions","away",1,0,"Western Division","PBE",35,7,28,"35 - 7",4,137,308,415,94864,18769,42,0.834827910906163,35,7,"35 - 7","#97162B",1,1,"2030"
10,100,207,2030-07-11,1905,9,3,9,"DV","Death Valley Scorpions","away",1,0,"Western Division","PBE",36,7,29,"36 - 7",1,138,311,424,96721,19044,43,0.835494320390446,36,7,"36 - 7","#97162B",1,1,"2030"
10,100,212,2030-07-12,1905,9,2,8,"DV","Death Valley Scorpions","away",0,1,"Western Division","PBE",36,8,28,"36 - 8",3,141,313,432,97969,19881,44,0.831302503182011,37,7,"37 - 7","#97162B",1,1,"2030"
10,100,218,2030-07-15,1905,9,8,10,"DV","Death Valley Scorpions","home",1,0,"Western Division","PBE",37,8,29,"37 - 8",0,141,321,442,103041,19881,45,0.838263288914922,38,7,"38 - 7","#97162B",1,1,"2030"
10,100,223,2030-07-16,1905,9,10,16,"DV","Death Valley Scorpions","home",1,0,"Western Division","PBE",38,8,30,"38 - 8",3,144,331,458,109561,20736,46,0.840855890772619,39,7,"39 - 7","#97162B",1,1,"2030"
10,100,228,2030-07-17,1905,9,7,7,"DV","Death Valley Scorpions","home",1,0,"Western Division","PBE",39,8,31,"39 - 8",1,145,338,465,114244,21025,47,0.844568969978339,40,7,"40 - 7","#97162B",1,1,"2030"
10,100,233,2030-07-18,1905,9,4,5,"DV","Death Valley Scorpions","home",1,0,"Western Division","PBE",40,8,32,"40 - 8",3,148,342,470,116964,21904,48,0.842267477028545,40,8,"40 - 8","#97162B",1,1,"2030"
10,100,234,2030-07-21,1905,9,8,9,"DV","Death Valley Scorpions","home",0,1,"Western Division","PBE",40,9,31,"40 - 9",9,157,350,479,122500,24649,49,0.832489517427913,41,8,"41 - 8","#97162B",1,1,"2030"
10,100,239,2030-07-22,1905,9,7,11,"DV","Death Valley Scorpions","home",1,0,"Western Division","PBE",41,9,32,"41 - 9",2,159,357,490,127449,25281,50,0.834472598703595,42,8,"42 - 8","#97162B",1,1,"2030"
10,100,244,2030-07-23,1905,9,11,14,"DV","Death Valley Scorpions","home",1,0,"Western Division","PBE",42,9,33,"42 - 9",2,161,368,504,135424,25921,51,0.839344262295082,43,8,"43 - 8","#97162B",1,1,"2030"
10,100,249,2030-07-24,1905,9,2,5,"DV","Death Valley Scorpions","home",0,1,"Western Division","PBE",42,10,32,"42 - 10",3,164,370,509,136900,26896,52,0.835795745927861,43,9,"43 - 9","#97162B",1,1,"2030"
10,100,258,2030-08-12,1905,9,5,10,"DV","Death Valley Scorpions","home",1,0,"Western Division","PBE",43,10,33,"43 - 10",3,167,375,519,140625,27889,53,0.834500397593078,44,9,"44 - 9","#97162B",1,1,"2030"
10,100,263,2030-08-13,1905,9,8,10,"DV","Death Valley Scorpions","home",1,0,"Western Division","PBE",44,10,34,"44 - 10",3,170,383,529,146689,28900,54,0.835411102062202,45,9,"45 - 9","#97162B",1,1,"2030"
10,100,268,2030-08-14,1905,9,5,7,"DV","Death Valley Scorpions","home",0,1,"Western Division","PBE",44,11,33,"44 - 11",6,176,388,536,150544,30976,55,0.829352137505509,46,9,"46 - 9","#97162B",1,1,"2030"
10,100,276,2030-08-17,1905,12,2,9,"DV","Death Valley Scorpions","away",1,0,"Western Division","PBE",45,11,34,"45 - 11",1,177,390,545,152100,31329,56,0.829203670084883,46,10,"46 - 10","#97162B",1,1,"2030"
10,100,280,2030-08-18,1905,9,11,9,"DV","Death Valley Scorpions","away",1,0,"Western Division","PBE",46,11,35,"46 - 11",1,178,401,554,160801,31684,57,0.835394965841494,48,9,"48 - 9","#97162B",1,1,"2030"
10,100,285,2030-08-19,1905,12,9,10,"DV","Death Valley Scorpions","away",1,0,"Western Division","PBE",47,11,36,"47 - 11",5,183,410,564,168100,33489,58,0.8338748642039,48,10,"48 - 10","#97162B",1,1,"2030"
10,100,290,2030-08-20,1905,15,3,5,"DV","Death Valley Scorpions","away",1,0,"Western Division","PBE",48,11,37,"48 - 11",2,185,413,569,170569,34225,59,0.832880846118539,49,10,"49 - 10","#97162B",1,1,"2030"
10,100,294,2030-08-22,1905,9,2,6,"DV","Death Valley Scorpions","away",0,1,"Western Division","PBE",48,12,36,"48 - 12",4,189,415,575,172225,35721,60,0.828219826301059,50,10,"50 - 10","#97162B",1,1,"2030"
10,100,299,2030-08-23,1905,9,12,14,"DV","Death Valley Scorpions","away",1,0,"Western Division","PBE",49,12,37,"49 - 12",5,194,427,589,182329,37636,61,0.828900052281045,51,10,"51 - 10","#97162B",1,1,"2030"
10,100,630,2030-08-24,1905,9,4,6,"DV","Death Valley Scorpions","away",1,0,"Western Division","PBE",50,12,38,"50 - 12",3,197,431,595,185761,38809,62,0.827185287438215,51,11,"51 - 11","#97162B",1,1,"2030"
10,100,638,2030-08-27,1905,9,1,5,"DV","Death Valley Scorpions","home",0,1,"Western Division","PBE",50,13,37,"50 - 13",4,201,432,600,186624,40401,63,0.822041625371655,52,11,"52 - 11","#97162B",1,1,"2030"
10,100,643,2030-08-28,1905,9,7,7,"DV","Death Valley Scorpions","home",1,0,"Western Division","PBE",51,13,38,"51 - 13",3,204,439,607,192721,41616,64,0.822409606677563,53,11,"53 - 11","#97162B",1,1,"2030"
10,100,648,2030-08-29,1905,10,6,12,"DV","Death Valley Scorpions","home",1,0,"Western Division","PBE",52,13,39,"52 - 13",5,209,445,619,198025,43681,65,0.81928044814775,53,12,"53 - 12","#97162B",1,1,"2030"
10,100,653,2030-08-30,1905,10,3,8,"DV","Death Valley Scorpions","home",1,0,"Western Division","PBE",53,13,40,"53 - 13",2,211,448,627,200704,44521,66,0.818448363747579,54,12,"54 - 12","#97162B",1,1,"2030"
10,100,658,2030-09-02,1905,9,7,9,"DV","Death Valley Scorpions","away",1,0,"Western Division","PBE",54,13,41,"54 - 13",3,214,455,636,207025,45796,67,0.818859983941207,55,12,"55 - 12","#97162B",1,1,"2030"
10,100,663,2030-09-03,1905,9,10,14,"DV","Death Valley Scorpions","away",1,0,"Western Division","PBE",55,13,42,"55 - 13",1,215,465,650,216225,46225,68,0.823871213564488,56,12,"56 - 12","#97162B",1,1,"2030"
10,100,668,2030-09-04,1905,9,11,16,"DV","Death Valley Scorpions","away",1,0,"Western Division","PBE",56,13,43,"56 - 13",4,219,476,666,226576,47961,69,0.825302236128464,57,12,"57 - 12","#97162B",1,1,"2030"
10,100,673,2030-09-05,1905,9,9,14,"DV","Death Valley Scorpions","away",1,0,"Western Division","PBE",57,13,44,"57 - 13",4,223,485,680,235225,49729,70,0.825484113225292,58,12,"58 - 12","#97162B",1,1,"2030"
10,100,676,2030-09-08,1905,11,5,12,"DV","Death Valley Scorpions","home",1,0,"Western Division","PBE",58,13,45,"58 - 13",4,227,490,692,240100,51529,71,0.823306324131002,58,13,"58 - 13","#97162B",1,1,"2030"
10,100,681,2030-09-09,1905,9,7,8,"DV","Death Valley Scorpions","home",1,0,"Western Division","PBE",59,13,46,"59 - 13",3,230,497,700,247009,52900,72,0.82361316265934,59,13,"59 - 13","#97162B",1,1,"2030"
10,100,686,2030-09-10,1905,9,4,8,"DV","Death Valley Scorpions","home",1,0,"Western Division","PBE",60,13,47,"60 - 13",1,231,501,708,251001,53361,73,0.824679164941747,60,13,"60 - 13","#97162B",1,1,"2030"
10,100,691,2030-09-11,1905,9,3,7,"DV","Death Valley Scorpions","home",1,0,"Western Division","PBE",61,13,48,"61 - 13",1,232,504,715,254016,53824,74,0.825155925155925,61,13,"61 - 13","#97162B",1,1,"2030"
10,100,698,2030-09-14,1905,11,3,8,"DV","Death Valley Scorpions","away",0,1,"Western Division","PBE",61,14,47,"61 - 14",4,236,507,723,257049,55696,75,0.821912420662201,62,13,"62 - 13","#97162B",1,1,"2030"
10,100,703,2030-09-15,1905,9,7,12,"DV","Death Valley Scorpions","away",1,0,"Western Division","PBE",62,14,48,"62 - 14",0,236,514,735,264196,55696,76,0.825891238292924,63,13,"63 - 13","#97162B",1,1,"2030"
10,100,708,2030-09-16,1905,9,6,10,"DV","Death Valley Scorpions","away",1,0,"Western Division","PBE",63,14,49,"63 - 14",1,237,520,745,270400,56169,77,0.828002657937526,64,13,"64 - 13","#97162B",1,1,"2030"
10,100,713,2030-09-17,1905,9,4,8,"DV","Death Valley Scorpions","away",1,0,"Western Division","PBE",64,14,50,"64 - 14",1,238,524,753,274576,56644,78,0.828983757019504,65,13,"65 - 13","#97162B",1,1,"2030"
10,100,718,2030-09-20,1905,9,2,5,"DV","Death Valley Scorpions","away",0,1,"Western Division","PBE",64,15,49,"64 - 15",5,243,526,758,276676,59049,79,0.824114975053988,65,14,"65 - 14","#97162B",1,1,"2030"
10,100,723,2030-09-21,1905,9,6,6,"DV","Death Valley Scorpions","away",1,0,"Western Division","PBE",65,15,50,"65 - 15",3,246,532,764,283024,60516,80,0.823845840367934,66,14,"66 - 14","#97162B",1,1,"2030"
10,100,728,2030-09-22,1905,9,8,8,"DV","Death Valley Scorpions","away",1,0,"Western Division","PBE",66,15,51,"66 - 15",2,248,540,772,291600,61504,81,0.825819022157778,67,14,"67 - 14","#97162B",1,1,"2030"
10,100,732,2030-09-23,1905,9,3,9,"DV","Death Valley Scorpions","away",0,1,"Western Division","PBE",66,16,50,"66 - 16",7,255,543,781,294849,65025,82,0.819311759115691,67,15,"67 - 15","#97162B",1,1,"2030"
10,100,736,2030-09-25,1905,9,3,9,"DV","Death Valley Scorpions","home",1,0,"Western Division","PBE",67,16,51,"67 - 16",2,257,546,790,298116,66049,83,0.818628918210152,68,15,"68 - 15","#97162B",1,1,"2030"
10,100,741,2030-09-26,1905,9,7,8,"DV","Death Valley Scorpions","home",1,0,"Western Division","PBE",68,16,52,"68 - 16",3,260,553,798,305809,67600,84,0.818965263290387,69,15,"69 - 15","#97162B",1,1,"2030"
10,100,746,2030-09-27,1905,9,6,10,"DV","Death Valley Scorpions","home",1,0,"Western Division","PBE",69,16,53,"69 - 16",0,260,559,808,312481,67600,85,0.822143174744331,70,15,"70 - 15","#97162B",1,1,"2030"
10,100,750,2030-09-28,1905,9,7,5,"DV","Death Valley Scorpions","home",1,0,"Western Division","PBE",70,16,54,"70 - 16",6,266,566,813,320356,70756,86,0.819090183885946,70,16,"70 - 16","#97162B",1,1,"2030"
10,100,755,2030-09-30,1905,9,14,12,"DV","Death Valley Scorpions","away",1,0,"Western Division","PBE",71,16,55,"71 - 16",6,272,580,825,336400,73984,87,0.819720067059145,71,16,"71 - 16","#97162B",1,1,"2030"
10,100,760,2030-10-01,1905,9,0,7,"DV","Death Valley Scorpions","away",0,1,"Western Division","PBE",71,17,54,"71 - 17",3,275,580,832,336400,75625,88,0.816455312177659,72,16,"72 - 16","#97162B",1,1,"2030"
10,100,765,2030-10-02,1905,9,1,3,"DV","Death Valley Scorpions","away",0,1,"Western Division","PBE",71,18,53,"71 - 18",4,279,581,835,337561,77841,89,0.812612842499555,72,17,"72 - 17","#97162B",1,1,"2030"
10,100,770,2030-10-03,1905,9,8,8,"DV","Death Valley Scorpions","away",1,0,"Western Division","PBE",72,18,54,"72 - 18",5,284,589,843,346921,80656,90,0.81136497051993,73,17,"73 - 17","#97162B",1,1,"2030"
10,100,775,2030-10-05,1905,9,5,8,"DV","Death Valley Scorpions","away",0,1,"Western Division","PBE",72,19,53,"72 - 19",6,290,594,851,352836,84100,91,0.807523298606661,73,18,"73 - 18","#97162B",1,1,"2030"
10,100,780,2030-10-06,1905,9,2,4,"DV","Death Valley Scorpions","away",0,1,"Western Division","PBE",72,20,52,"72 - 20",15,305,596,855,355216,93025,92,0.792466552591128,73,19,"73 - 19","#97162B",1,1,"2030"
11,100,5,2030-05-15,1905,9,2,9,"VAN","Vancouver Vandals","home",1,0,"Western Division","PBE",1,0,1,"1 - 0",0,0,2,9,4,0,1,1,1,0,"1 - 0","#183013",2,2,"2030"
11,100,10,2030-05-16,1905,9,7,10,"VAN","Vancouver Vandals","home",1,0,"Western Division","PBE",2,0,2,"2 - 0",1,1,9,19,81,1,2,0.98780487804878,2,0,"2 - 0","#183013",2,2,"2030"
11,100,15,2030-05-17,1905,9,1,6,"VAN","Vancouver Vandals","home",0,1,"Western Division","PBE",2,1,1,"2 - 1",6,7,10,25,100,49,3,0.671140939597315,2,1,"2 - 1","#183013",2,2,"2030"
11,100,20,2030-05-18,1905,9,3,11,"VAN","Vancouver Vandals","home",0,1,"Western Division","PBE",2,2,0,"2 - 2",5,12,13,36,169,144,4,0.539936102236422,2,2,"2 - 2","#183013",2,2,"2030"
11,100,25,2030-05-21,1905,11,8,9,"VAN","Vancouver Vandals","away",1,0,"Western Division","PBE",3,2,1,"3 - 2",7,19,21,45,441,361,5,0.549875311720698,3,2,"3 - 2","#183013",2,2,"2030"
11,100,30,2030-05-22,1905,10,6,10,"VAN","Vancouver Vandals","away",1,0,"Western Division","PBE",4,2,2,"4 - 2",4,23,27,55,729,529,6,0.579491255961844,3,3,"3 - 3","#183013",2,2,"2030"
11,100,35,2030-05-23,1905,9,6,13,"VAN","Vancouver Vandals","away",1,0,"Western Division","PBE",5,2,3,"5 - 2",1,24,33,68,1089,576,7,0.654054054054054,5,2,"5 - 2","#183013",2,2,"2030"
11,100,39,2030-05-24,1905,9,7,9,"VAN","Vancouver Vandals","away",1,0,"Western Division","PBE",6,2,4,"6 - 2",3,27,40,77,1600,729,8,0.68699012451696,5,3,"5 - 3","#183013",2,2,"2030"
11,100,43,2030-05-26,1905,9,6,7,"VAN","Vancouver Vandals","away",1,0,"Western Division","PBE",7,2,5,"7 - 2",3,30,46,84,2116,900,9,0.70159151193634,6,3,"6 - 3","#183013",2,2,"2030"
11,100,48,2030-05-27,1905,13,2,7,"VAN","Vancouver Vandals","away",0,1,"Western Division","PBE",7,3,4,"7 - 3",5,35,48,91,2304,1225,10,0.65287616888637,7,3,"7 - 3","#183013",2,2,"2030"
11,100,53,2030-05-28,1905,9,10,11,"VAN","Vancouver Vandals","away",1,0,"Western Division","PBE",8,3,5,"8 - 3",2,37,58,102,3364,1369,11,0.710754278470315,8,3,"8 - 3","#183013",2,2,"2030"
11,100,58,2030-05-29,1905,9,9,10,"VAN","Vancouver Vandals","away",1,0,"Western Division","PBE",9,3,6,"9 - 3",8,45,67,112,4489,2025,12,0.689131102241326,8,4,"8 - 4","#183013",2,2,"2030"
11,100,61,2030-06-01,1905,9,4,10,"VAN","Vancouver Vandals","home",0,1,"Western Division","PBE",9,4,5,"9 - 4",5,50,71,122,5041,2500,13,0.668478981567431,9,4,"9 - 4","#183013",2,2,"2030"
11,100,66,2030-06-02,1905,9,1,7,"VAN","Vancouver Vandals","home",0,1,"Western Division","PBE",9,5,4,"9 - 5",3,53,72,129,5184,2809,14,0.64856749655949,9,5,"9 - 5","#183013",2,2,"2030"
11,100,71,2030-06-03,1905,9,12,15,"VAN","Vancouver Vandals","home",1,0,"Western Division","PBE",10,5,5,"10 - 5",2,55,84,144,7056,3025,15,0.699930562444202,10,5,"10 - 5","#183013",2,2,"2030"
11,100,76,2030-06-04,1905,9,1,5,"VAN","Vancouver Vandals","home",1,0,"Western Division","PBE",11,5,6,"11 - 5",0,55,85,149,7225,3025,16,0.704878048780488,11,5,"11 - 5","#183013",2,2,"2030"
11,100,87,2030-06-07,1905,12,2,10,"VAN","Vancouver Vandals","home",0,1,"Western Division","PBE",11,6,5,"11 - 6",4,59,87,159,7569,3481,17,0.684977375565611,12,5,"12 - 5","#183013",2,2,"2030"
11,100,92,2030-06-08,1905,9,3,6,"VAN","Vancouver Vandals","home",1,0,"Western Division","PBE",12,6,6,"12 - 6",0,59,90,165,8100,3481,18,0.699421466194629,13,5,"13 - 5","#183013",2,2,"2030"
11,100,96,2030-06-09,1905,9,5,7,"VAN","Vancouver Vandals","home",1,0,"Western Division","PBE",13,6,7,"13 - 6",2,61,95,172,9025,3721,19,0.708065275380512,13,6,"13 - 6","#183013",2,2,"2030"
11,100,101,2030-06-11,1905,9,5,8,"VAN","Vancouver Vandals","home",1,0,"Western Division","PBE",14,6,8,"14 - 6",4,65,100,180,10000,4225,20,0.70298769771529,14,6,"14 - 6","#183013",2,2,"2030"
11,100,106,2030-06-12,1905,9,3,7,"VAN","Vancouver Vandals","home",1,0,"Western Division","PBE",15,6,9,"15 - 6",1,66,103,187,10609,4356,21,0.70892081523555,15,6,"15 - 6","#183013",2,2,"2030"
11,100,111,2030-06-13,1905,9,7,17,"VAN","Vancouver Vandals","home",1,0,"Western Division","PBE",16,6,10,"16 - 6",5,71,110,204,12100,5041,22,0.705909806895747,16,6,"16 - 6","#183013",2,2,"2030"
11,100,115,2030-06-14,1905,9,6,7,"VAN","Vancouver Vandals","home",1,0,"Western Division","PBE",17,6,11,"17 - 6",1,72,116,211,13456,5184,23,0.721888412017167,17,6,"17 - 6","#183013",2,2,"2030"
11,100,117,2030-06-16,1905,9,5,9,"VAN","Vancouver Vandals","home",1,0,"Western Division","PBE",18,6,12,"18 - 6",1,73,121,220,14641,5329,24,0.73314972458688,18,6,"18 - 6","#183013",2,2,"2030"
11,100,122,2030-06-17,1905,9,5,8,"VAN","Vancouver Vandals","home",1,0,"Western Division","PBE",19,6,13,"19 - 6",3,76,126,228,15876,5776,25,0.733234805098836,18,7,"18 - 7","#183013",2,2,"2030"
11,100,127,2030-06-18,1905,9,3,5,"VAN","Vancouver Vandals","home",1,0,"Western Division","PBE",20,6,14,"20 - 6",1,77,129,233,16641,5929,26,0.737306158617634,19,7,"19 - 7","#183013",2,2,"2030"
11,100,132,2030-06-19,1905,9,1,6,"VAN","Vancouver Vandals","home",0,1,"Western Division","PBE",20,7,13,"20 - 7",5,82,130,239,16900,6724,27,0.715374195733153,19,8,"19 - 8","#183013",2,2,"2030"
11,100,139,2030-06-22,1905,9,6,9,"VAN","Vancouver Vandals","away",0,1,"Western Division","PBE",20,8,12,"20 - 8",9,91,136,248,18496,8281,28,0.690742054748478,19,9,"19 - 9","#183013",2,2,"2030"
11,100,144,2030-06-23,1905,9,6,9,"VAN","Vancouver Vandals","away",1,0,"Western Division","PBE",21,8,13,"21 - 8",3,94,142,257,20164,8836,29,0.695310344827586,20,9,"20 - 9","#183013",2,2,"2030"
11,100,149,2030-06-24,1905,9,5,7,"VAN","Vancouver Vandals","away",0,1,"Western Division","PBE",21,9,12,"21 - 9",6,100,147,264,21609,10000,30,0.683634407921794,21,9,"21 - 9","#183013",2,2,"2030"
11,100,154,2030-06-25,1905,9,2,9,"VAN","Vancouver Vandals","away",0,1,"Western Division","PBE",21,10,11,"21 - 10",6,106,149,273,22201,11236,31,0.66396506863654,21,10,"21 - 10","#183013",2,2,"2030"
11,100,157,2030-06-27,1905,9,11,13,"VAN","Vancouver Vandals","away",1,0,"Western Division","PBE",22,10,12,"22 - 10",1,107,160,286,25600,11449,32,0.69097681448892,22,10,"22 - 10","#183013",2,2,"2030"
11,100,162,2030-06-28,1905,9,8,11,"VAN","Vancouver Vandals","away",1,0,"Western Division","PBE",23,10,13,"23 - 10",0,107,168,297,28224,11449,33,0.711415824364177,23,10,"23 - 10","#183013",2,2,"2030"
11,100,167,2030-06-29,1905,9,10,17,"VAN","Vancouver Vandals","away",1,0,"Western Division","PBE",24,10,14,"24 - 10",6,113,178,314,31684,12769,34,0.712752795086946,24,10,"24 - 10","#183013",2,2,"2030"
11,100,172,2030-06-30,1905,9,2,4,"VAN","Vancouver Vandals","away",0,1,"Western Division","PBE",24,11,13,"24 - 11",3,116,180,318,32400,13456,35,0.706559665038381,25,10,"25 - 10","#183013",2,2,"2030"
11,100,177,2030-07-03,1905,9,6,10,"VAN","Vancouver Vandals","home",1,0,"Western Division","PBE",25,11,14,"25 - 11",4,120,186,328,34596,14400,36,0.706098457016899,25,11,"25 - 11","#183013",2,2,"2030"
11,100,182,2030-07-04,1905,9,10,10,"VAN","Vancouver Vandals","home",1,0,"Western Division","PBE",26,11,15,"26 - 11",6,126,196,338,38416,15876,37,0.707581227436823,26,11,"26 - 11","#183013",2,2,"2030"
11,100,187,2030-07-05,1905,9,3,7,"VAN","Vancouver Vandals","home",0,1,"Western Division","PBE",26,12,14,"26 - 12",5,131,199,345,39601,17161,38,0.697667453578098,27,11,"27 - 11","#183013",2,2,"2030"
11,100,192,2030-07-06,1905,9,6,12,"VAN","Vancouver Vandals","home",1,0,"Western Division","PBE",27,12,15,"27 - 12",1,132,205,357,42025,17424,39,0.706908442530572,28,11,"28 - 11","#183013",2,2,"2030"
11,100,198,2030-07-09,1905,9,13,18,"VAN","Vancouver Vandals","home",1,0,"Western Division","PBE",28,12,16,"28 - 12",4,136,218,375,47524,18496,40,0.719842471978188,29,11,"29 - 11","#183013",2,2,"2030"
11,100,203,2030-07-10,1905,9,3,7,"VAN","Vancouver Vandals","home",1,0,"Western Division","PBE",29,12,17,"29 - 12",1,137,221,382,48841,18769,41,0.722393137109895,30,11,"30 - 11","#183013",2,2,"2030"
11,100,208,2030-07-11,1905,9,0,5,"VAN","Vancouver Vandals","home",0,1,"Western Division","PBE",29,13,16,"29 - 13",3,140,221,387,48841,19600,42,0.713621951754066,30,12,"30 - 12","#183013",2,2,"2030"
11,100,213,2030-07-12,1905,9,4,8,"VAN","Vancouver Vandals","home",0,1,"Western Division","PBE",29,14,15,"29 - 14",7,147,225,395,50625,21609,43,0.700847246449041,30,13,"30 - 13","#183013",2,2,"2030"
11,100,215,2030-07-15,1905,9,8,12,"VAN","Vancouver Vandals","away",1,0,"Western Division","PBE",30,14,16,"30 - 14",7,154,233,407,54289,23716,44,0.695968207166207,31,13,"31 - 13","#183013",2,2,"2030"
11,100,220,2030-07-16,1905,9,13,19,"VAN","Vancouver Vandals","away",1,0,"Western Division","PBE",31,14,17,"31 - 14",2,156,246,426,60516,24336,45,0.713194739075095,32,13,"32 - 13","#183013",2,2,"2030"
11,100,225,2030-07-17,1905,9,6,9,"VAN","Vancouver Vandals","away",1,0,"Western Division","PBE",32,14,18,"32 - 14",2,158,252,435,63504,24964,46,0.717818872360628,33,13,"33 - 13","#183013",2,2,"2030"
11,100,230,2030-07-18,1905,9,5,7,"VAN","Vancouver Vandals","away",1,0,"Western Division","PBE",33,14,19,"33 - 14",1,159,257,442,66049,25281,47,0.72319062739516,34,13,"34 - 13","#183013",2,2,"2030"
11,100,236,2030-07-21,1905,9,4,5,"VAN","Vancouver Vandals","away",0,1,"Western Division","PBE",33,15,18,"33 - 15",5,164,261,447,68121,26896,48,0.716934864287443,34,14,"34 - 14","#183013",2,2,"2030"
11,100,241,2030-07-22,1905,9,6,10,"VAN","Vancouver Vandals","away",1,0,"Western Division","PBE",34,15,19,"34 - 15",2,166,267,457,71289,27556,49,0.721220092063331,35,14,"35 - 14","#183013",2,2,"2030"
11,100,246,2030-07-23,1905,9,4,9,"VAN","Vancouver Vandals","away",1,0,"Western Division","PBE",35,15,20,"35 - 15",1,167,271,466,73441,27889,50,0.724770551662884,36,14,"36 - 14","#183013",2,2,"2030"
11,100,251,2030-07-24,1905,9,1,4,"VAN","Vancouver Vandals","away",0,1,"Western Division","PBE",35,16,19,"35 - 16",4,171,272,470,73984,29241,51,0.716725599418745,37,14,"37 - 14","#183013",2,2,"2030"
11,100,257,2030-08-12,1905,9,4,9,"VAN","Vancouver Vandals","away",0,1,"Western Division","PBE",35,17,18,"35 - 17",5,176,276,479,76176,30976,52,0.710915335224727,37,15,"37 - 15","#183013",2,2,"2030"
11,100,262,2030-08-13,1905,9,12,11,"VAN","Vancouver Vandals","away",1,0,"Western Division","PBE",36,17,19,"36 - 17",2,178,288,490,82944,31684,53,0.72359283944586,38,15,"38 - 15","#183013",2,2,"2030"
11,100,267,2030-08-14,1905,9,12,15,"VAN","Vancouver Vandals","away",1,0,"Western Division","PBE",37,17,20,"37 - 17",4,182,300,505,90000,33124,54,0.730970403820539,39,15,"39 - 15","#183013",2,2,"2030"
11,100,272,2030-08-15,1905,9,11,15,"VAN","Vancouver Vandals","away",1,0,"Western Division","PBE",38,17,21,"38 - 17",5,187,311,520,96721,34969,55,0.734459715999696,40,15,"40 - 15","#183013",2,2,"2030"
11,100,281,2030-08-18,1905,9,9,12,"VAN","Vancouver Vandals","away",1,0,"Western Division","PBE",39,17,22,"39 - 17",5,192,320,532,102400,36864,56,0.735294117647059,41,15,"41 - 15","#183013",2,2,"2030"
11,100,286,2030-08-19,1905,9,9,12,"VAN","Vancouver Vandals","away",1,0,"Western Division","PBE",40,17,23,"40 - 17",4,196,329,544,108241,38416,57,0.738055462746408,42,15,"42 - 15","#183013",2,2,"2030"
11,100,291,2030-08-20,1905,9,2,7,"VAN","Vancouver Vandals","away",0,1,"Western Division","PBE",40,18,22,"40 - 18",7,203,331,551,109561,41209,58,0.726676394508191,42,16,"42 - 16","#183013",2,2,"2030"
11,100,294,2030-08-22,1905,9,4,9,"VAN","Vancouver Vandals","home",1,0,"Western Division","PBE",41,18,23,"41 - 18",2,205,335,560,112225,42025,59,0.727552674230146,43,16,"43 - 16","#183013",2,2,"2030"
11,100,299,2030-08-23,1905,9,5,9,"VAN","Vancouver Vandals","home",0,1,"Western Division","PBE",41,19,22,"41 - 19",12,217,340,569,115600,47089,60,0.710558181561138,43,17,"43 - 17","#183013",2,2,"2030"
11,100,630,2030-08-24,1905,9,3,5,"VAN","Vancouver Vandals","home",0,1,"Western Division","PBE",41,20,21,"41 - 20",4,221,343,574,117649,48841,61,0.706643041624122,43,18,"43 - 18","#183013",2,2,"2030"
11,100,638,2030-08-27,1905,9,4,8,"VAN","Vancouver Vandals","away",1,0,"Western Division","PBE",42,20,22,"42 - 20",1,222,347,582,120409,49284,62,0.70956963457538,44,18,"44 - 18","#183013",2,2,"2030"
11,100,643,2030-08-28,1905,9,3,7,"VAN","Vancouver Vandals","away",0,1,"Western Division","PBE",42,21,21,"42 - 21",7,229,350,589,122500,52441,63,0.700236079592548,44,19,"44 - 19","#183013",2,2,"2030"
11,100,648,2030-08-29,1905,10,5,10,"VAN","Vancouver Vandals","away",0,1,"Western Division","PBE",42,22,20,"42 - 22",6,235,355,599,126025,55225,64,0.695310344827586,44,20,"44 - 20","#183013",2,2,"2030"
11,100,653,2030-08-30,1905,10,2,6,"VAN","Vancouver Vandals","away",0,1,"Western Division","PBE",42,23,19,"42 - 23",3,238,357,605,127449,56644,65,0.692307692307692,45,20,"45 - 20","#183013",2,2,"2030"
11,100,654,2030-09-02,1905,9,0,2,"VAN","Vancouver Vandals","home",0,1,"Western Division","PBE",42,24,18,"42 - 24",3,241,357,607,127449,58081,66,0.6869455074651,45,21,"45 - 21","#183013",2,2,"2030"
11,100,659,2030-09-03,1905,9,7,10,"VAN","Vancouver Vandals","home",1,0,"Western Division","PBE",43,24,19,"43 - 24",5,246,364,617,132496,60516,67,0.686465090253456,46,21,"46 - 21","#183013",2,2,"2030"
11,100,664,2030-09-04,1905,9,5,10,"VAN","Vancouver Vandals","home",1,0,"Western Division","PBE",44,24,20,"44 - 24",4,250,369,627,136161,62500,68,0.685393710894438,47,21,"47 - 21","#183013",2,2,"2030"
11,100,669,2030-09-05,1905,9,5,11,"VAN","Vancouver Vandals","home",1,0,"Western Division","PBE",45,24,21,"45 - 24",2,252,374,638,139876,63504,69,0.687756908250565,47,22,"47 - 22","#183013",2,2,"2030"
11,100,677,2030-09-08,1905,9,11,16,"VAN","Vancouver Vandals","away",1,0,"Western Division","PBE",46,24,22,"46 - 24",0,252,385,654,148225,63504,70,0.700069428373062,49,21,"49 - 21","#183013",2,2,"2030"
11,100,682,2030-09-09,1905,9,10,13,"VAN","Vancouver Vandals","away",1,0,"Western Division","PBE",47,24,23,"47 - 24",1,253,395,667,156025,64009,71,0.709094958051937,50,21,"50 - 21","#183013",2,2,"2030"
11,100,687,2030-09-10,1905,10,3,12,"VAN","Vancouver Vandals","away",1,0,"Western Division","PBE",48,24,24,"48 - 24",2,255,398,679,158404,65025,72,0.708967949549969,51,21,"51 - 21","#183013",2,2,"2030"
11,100,692,2030-09-11,1905,9,4,7,"VAN","Vancouver Vandals","away",1,0,"Western Division","PBE",49,24,25,"49 - 24",1,256,402,686,161604,65536,73,0.71147310029057,52,21,"52 - 21","#183013",2,2,"2030"
11,100,695,2030-09-14,1905,9,6,11,"VAN","Vancouver Vandals","home",1,0,"Western Division","PBE",50,24,26,"50 - 24",3,259,408,697,166464,67081,74,0.712770558136548,53,21,"53 - 21","#183013",2,2,"2030"
11,100,700,2030-09-15,1905,9,9,8,"VAN","Vancouver Vandals","home",1,0,"Western Division","PBE",51,24,27,"51 - 24",4,263,417,705,173889,69169,75,0.715421833471846,54,21,"54 - 21","#183013",2,2,"2030"
11,100,705,2030-09-16,1905,9,3,8,"VAN","Vancouver Vandals","home",0,1,"Western Division","PBE",51,25,26,"51 - 25",5,268,420,713,176400,71824,76,0.710648446564393,54,22,"54 - 22","#183013",2,2,"2030"
11,100,710,2030-09-17,1905,9,3,7,"VAN","Vancouver Vandals","home",1,0,"Western Division","PBE",52,25,27,"52 - 25",1,269,423,720,178929,72361,77,0.712041863981854,55,22,"55 - 22","#183013",2,2,"2030"
11,100,717,2030-09-20,1905,9,2,7,"VAN","Vancouver Vandals","home",1,0,"Western Division","PBE",53,25,28,"53 - 25",0,269,425,727,180625,72361,78,0.713972314673539,56,22,"56 - 22","#183013",2,2,"2030"
11,100,722,2030-09-21,1905,9,2,7,"VAN","Vancouver Vandals","home",0,1,"Western Division","PBE",53,26,27,"53 - 26",8,277,427,734,182329,76729,79,0.703815361810869,56,23,"56 - 23","#183013",2,2,"2030"
11,100,727,2030-09-22,1905,13,4,10,"VAN","Vancouver Vandals","home",0,1,"Western Division","PBE",53,27,26,"53 - 27",6,283,431,744,185761,80089,80,0.698743652435584,56,24,"56 - 24","#183013",2,2,"2030"
11,100,731,2030-09-23,1905,10,5,14,"VAN","Vancouver Vandals","home",1,0,"Western Division","PBE",54,27,27,"54 - 27",4,287,436,758,190096,82369,81,0.697689611509735,57,24,"57 - 24","#183013",2,2,"2030"
11,100,737,2030-09-25,1905,9,6,12,"VAN","Vancouver Vandals","away",1,0,"Western Division","PBE",55,27,28,"55 - 27",4,291,442,770,195364,84681,82,0.697616454498384,57,25,"57 - 25","#183013",2,2,"2030"
11,100,742,2030-09-26,1905,9,2,8,"VAN","Vancouver Vandals","away",0,1,"Western Division","PBE",55,28,27,"55 - 28",4,295,444,778,197136,87025,83,0.693747558602342,58,25,"58 - 25","#183013",2,2,"2030"
11,100,747,2030-09-27,1905,9,12,9,"VAN","Vancouver Vandals","away",1,0,"Western Division","PBE",56,28,28,"56 - 28",1,296,456,787,207936,87616,84,0.703551320918146,59,25,"59 - 25","#183013",2,2,"2030"
11,100,751,2030-09-28,1905,9,14,14,"VAN","Vancouver Vandals","away",1,0,"Western Division","PBE",57,28,29,"57 - 28",2,298,470,801,220900,88804,85,0.713261695037843,61,24,"61 - 24","#183013",2,2,"2030"
11,100,756,2030-09-30,1905,9,1,6,"VAN","Vancouver Vandals","home",0,1,"Western Division","PBE",57,29,28,"57 - 29",5,303,471,807,221841,91809,86,0.707288378766141,61,25,"61 - 25","#183013",2,2,"2030"
11,100,761,2030-10-01,1905,9,3,6,"VAN","Vancouver Vandals","home",1,0,"Western Division","PBE",58,29,29,"58 - 29",2,305,474,813,224676,93025,87,0.707193241443999,62,25,"62 - 25","#183013",2,2,"2030"
11,100,766,2030-10-02,1905,9,3,6,"VAN","Vancouver Vandals","home",0,1,"Western Division","PBE",58,30,28,"58 - 30",8,313,477,819,227529,97969,88,0.699018119927004,62,26,"62 - 26","#183013",2,2,"2030"
11,100,771,2030-10-03,1905,9,4,5,"VAN","Vancouver Vandals","home",1,0,"Western Division","PBE",59,30,29,"59 - 30",3,316,481,824,231361,99856,89,0.698517890084144,62,27,"62 - 27","#183013",2,2,"2030"
11,100,774,2030-10-05,1905,9,6,11,"VAN","Vancouver Vandals","away",1,0,"Western Division","PBE",60,30,30,"60 - 30",0,316,487,835,237169,99856,90,0.703713374378755,63,27,"63 - 27","#183013",2,2,"2030"
11,100,779,2030-10-06,1905,9,10,12,"VAN","Vancouver Vandals","away",1,0,"Western Division","PBE",61,30,31,"61 - 30",1,317,497,847,247009,100489,91,0.710821357245222,65,26,"65 - 26","#183013",2,2,"2030"
16,101,302,2030-05-15,1905,11,3,11,"ANC","Anchorage Wheelers","away",0,1,"West Division","MiLPBE",0,1,-1,"0 - 1",5,5,3,11,9,25,1,0.264705882352941,0,1,"0 - 1","#007EF3",2,2,"2030"
16,101,305,2030-05-16,1905,9,10,11,"ANC","Anchorage Wheelers","away",1,0,"West Division","MiLPBE",1,1,0,"1 - 1",3,8,13,22,169,64,2,0.725321888412017,1,1,"1 - 1","#007EF3",2,2,"2030"
16,101,308,2030-05-17,1905,9,3,8,"ANC","Anchorage Wheelers","away",0,1,"West Division","MiLPBE",1,2,-1,"1 - 2",4,12,16,30,256,144,3,0.64,2,1,"2 - 1","#007EF3",2,2,"2030"
16,101,311,2030-05-18,1905,9,7,10,"ANC","Anchorage Wheelers","away",1,0,"West Division","MiLPBE",2,2,0,"2 - 2",1,13,23,40,529,169,4,0.757879656160458,3,1,"3 - 1","#007EF3",2,2,"2030"
16,101,314,2030-05-20,1905,9,1,7,"ANC","Anchorage Wheelers","away",0,1,"West Division","MiLPBE",2,3,-1,"2 - 3",8,21,24,47,576,441,5,0.566371681415929,3,2,"3 - 2","#007EF3",2,2,"2030"
16,101,317,2030-05-21,1905,9,3,14,"ANC","Anchorage Wheelers","away",0,1,"West Division","MiLPBE",2,4,-2,"2 - 4",6,27,27,61,729,729,6,0.5,3,3,"3 - 3","#007EF3",2,2,"2030"
16,101,320,2030-05-22,1905,9,9,11,"ANC","Anchorage Wheelers","away",1,0,"West Division","MiLPBE",3,4,-1,"3 - 4",5,32,36,72,1296,1024,7,0.558620689655172,4,3,"4 - 3","#007EF3",2,2,"2030"
16,101,323,2030-05-23,1905,9,11,17,"ANC","Anchorage Wheelers","away",1,0,"West Division","MiLPBE",4,4,0,"4 - 4",4,36,47,89,2209,1296,8,0.630242510699001,5,3,"5 - 3","#007EF3",2,2,"2030"
16,101,326,2030-05-26,1905,9,2,6,"ANC","Anchorage Wheelers","home",1,0,"West Division","MiLPBE",5,4,1,"5 - 4",1,37,49,95,2401,1369,9,0.636870026525199,6,3,"6 - 3","#007EF3",2,2,"2030"
16,101,329,2030-05-27,1905,9,1,6,"ANC","Anchorage Wheelers","home",0,1,"West Division","MiLPBE",5,5,0,"5 - 5",12,49,50,101,2500,2401,10,0.510099979596001,5,5,"5 - 5","#007EF3",2,2,"2030"
16,101,332,2030-05-28,1905,9,0,3,"ANC","Anchorage Wheelers","home",0,1,"West Division","MiLPBE",5,6,-1,"5 - 6",5,54,50,104,2500,2916,11,0.461595273264402,5,6,"5 - 6","#007EF3",2,2,"2030"
16,101,335,2030-05-29,1905,9,10,13,"ANC","Anchorage Wheelers","home",1,0,"West Division","MiLPBE",6,6,0,"6 - 6",9,63,60,117,3600,3969,12,0.475624256837099,6,6,"6 - 6","#007EF3",2,2,"2030"
16,101,338,2030-06-01,1905,9,3,11,"ANC","Anchorage Wheelers","home",0,1,"West Division","MiLPBE",6,7,-1,"6 - 7",6,69,63,128,3969,4761,13,0.454639175257732,6,7,"6 - 7","#007EF3",2,2,"2030"
16,101,341,2030-06-02,1905,9,3,4,"ANC","Anchorage Wheelers","home",0,1,"West Division","MiLPBE",6,8,-2,"6 - 8",7,76,66,132,4356,5776,14,0.42992499013028,6,8,"6 - 8","#007EF3",2,2,"2030"
16,101,344,2030-06-03,1905,9,11,12,"ANC","Anchorage Wheelers","home",1,0,"West Division","MiLPBE",7,8,-1,"7 - 8",0,76,77,144,5929,5776,15,0.506535668517727,8,7,"8 - 7","#007EF3",2,2,"2030"
16,101,347,2030-06-04,1905,9,7,5,"ANC","Anchorage Wheelers","home",1,0,"West Division","MiLPBE",8,8,0,"8 - 8",4,80,84,149,7056,6400,16,0.524375743162901,8,8,"8 - 8","#007EF3",2,2,"2030"
16,101,350,2030-06-07,1905,9,4,10,"ANC","Anchorage Wheelers","home",1,0,"West Division","MiLPBE",9,8,1,"9 - 8",2,82,88,159,7744,6724,17,0.535250207354161,9,8,"9 - 8","#007EF3",2,2,"2030"
16,101,353,2030-06-08,1905,9,2,8,"ANC","Anchorage Wheelers","home",0,1,"West Division","MiLPBE",9,9,0,"9 - 9",6,88,90,167,8100,7744,18,0.511234536733148,9,9,"9 - 9","#007EF3",2,2,"2030"
16,101,356,2030-06-09,1905,9,1,4,"ANC","Anchorage Wheelers","home",1,0,"West Division","MiLPBE",10,9,1,"10 - 9",0,88,91,171,8281,7744,19,0.516755070202808,10,9,"10 - 9","#007EF3",2,2,"2030"
16,101,359,2030-06-10,1905,9,4,9,"ANC","Anchorage Wheelers","home",1,0,"West Division","MiLPBE",11,9,2,"11 - 9",3,91,95,180,9025,8281,20,0.521495435109211,10,10,"10 - 10","#007EF3",2,2,"2030"
16,101,362,2030-06-13,1905,9,0,4,"ANC","Anchorage Wheelers","home",0,1,"West Division","MiLPBE",11,10,1,"11 - 10",1,92,95,184,9025,8464,21,0.516038652867517,11,10,"11 - 10","#007EF3",2,2,"2030"
16,101,365,2030-06-14,1905,9,5,9,"ANC","Anchorage Wheelers","home",0,1,"West Division","MiLPBE",11,11,0,"11 - 11",7,99,100,193,10000,9801,22,0.505024998737438,11,11,"11 - 11","#007EF3",2,2,"2030"
16,101,368,2030-06-15,1905,9,11,20,"ANC","Anchorage Wheelers","home",0,1,"West Division","MiLPBE",11,12,-1,"11 - 12",13,112,111,213,12321,12544,23,0.495515785240298,11,12,"11 - 12","#007EF3",2,2,"2030"
16,101,371,2030-06-16,1905,9,9,13,"ANC","Anchorage Wheelers","home",1,0,"West Division","MiLPBE",12,12,0,"12 - 12",4,116,120,226,14400,13456,24,0.516944284893739,12,12,"12 - 12","#007EF3",2,2,"2030"
16,101,374,2030-06-19,1905,9,5,8,"ANC","Anchorage Wheelers","home",1,0,"West Division","MiLPBE",13,12,1,"13 - 12",2,118,125,234,15625,13924,25,0.528782699922163,13,12,"13 - 12","#007EF3",2,2,"2030"
16,101,377,2030-06-20,1905,9,12,15,"ANC","Anchorage Wheelers","home",1,0,"West Division","MiLPBE",14,12,2,"14 - 12",9,127,137,249,18769,16129,26,0.537824517164307,14,12,"14 - 12","#007EF3",2,2,"2030"
16,101,380,2030-06-21,1905,9,5,12,"ANC","Anchorage Wheelers","home",1,0,"West Division","MiLPBE",15,12,3,"15 - 12",1,128,142,261,20164,16384,27,0.551712816022765,15,12,"15 - 12","#007EF3",2,2,"2030"
16,101,509,2030-06-22,1905,9,4,9,"ANC","Anchorage Wheelers","home",0,1,"West Division","MiLPBE",15,13,2,"15 - 13",5,133,146,270,21316,17689,28,0.54649403922574,15,13,"15 - 13","#007EF3",2,2,"2030"
16,101,512,2030-07-14,1405,9,9,14,"ANC","Anchorage Wheelers","away",1,0,"West Division","MiLPBE",16,13,3,"16 - 13",2,135,155,284,24025,18225,29,0.568639053254438,16,13,"16 - 13","#007EF3",2,2,"2030"
16,101,515,2030-06-24,1905,9,1,11,"ANC","Anchorage Wheelers","away",0,1,"West Division","MiLPBE",16,14,2,"16 - 14",3,138,156,295,24336,19044,30,0.560995850622407,17,13,"17 - 13","#007EF3",2,2,"2030"
16,101,518,2030-06-25,1905,9,1,7,"ANC","Anchorage Wheelers","away",0,1,"West Division","MiLPBE",16,15,1,"16 - 15",2,140,157,302,24649,19600,31,0.557052136771452,17,14,"17 - 14","#007EF3",2,2,"2030"
16,101,521,2030-06-26,1905,9,17,17,"ANC","Anchorage Wheelers","away",1,0,"West Division","MiLPBE",17,15,2,"17 - 15",11,151,174,319,30276,22801,32,0.570416564613675,18,14,"18 - 14","#007EF3",2,2,"2030"
16,101,524,2030-06-27,1905,9,4,10,"ANC","Anchorage Wheelers","away",0,1,"West Division","MiLPBE",17,16,1,"17 - 16",13,164,178,329,31684,26896,33,0.540867190167293,18,15,"18 - 15","#007EF3",2,2,"2030"
16,101,527,2030-06-30,1905,9,4,9,"ANC","Anchorage Wheelers","away",1,0,"West Division","MiLPBE",18,16,2,"18 - 16",3,167,182,338,33124,27889,34,0.542900693294872,18,16,"18 - 16","#007EF3",2,2,"2030"
16,101,530,2030-07-01,1905,9,3,12,"ANC","Anchorage Wheelers","away",0,1,"West Division","MiLPBE",18,17,1,"18 - 17",8,175,185,350,34225,30625,35,0.527756360832691,18,17,"18 - 17","#007EF3",2,2,"2030"
16,101,533,2030-07-02,1905,9,0,7,"ANC","Anchorage Wheelers","away",0,1,"West Division","MiLPBE",18,18,0,"18 - 18",6,181,185,357,34225,32761,36,0.510927656525244,18,18,"18 - 18","#007EF3",2,2,"2030"
16,101,536,2030-07-03,1905,9,1,7,"ANC","Anchorage Wheelers","away",0,1,"West Division","MiLPBE",18,19,-1,"18 - 19",6,187,186,364,34596,34969,37,0.497319054122044,18,19,"18 - 19","#007EF3",2,2,"2030"
16,101,539,2030-07-06,1905,9,2,6,"ANC","Anchorage Wheelers","away",1,0,"West Division","MiLPBE",19,19,0,"19 - 19",0,187,188,370,35344,34969,38,0.502666647703839,19,19,"19 - 19","#007EF3",2,2,"2030"
16,101,542,2030-07-07,1905,9,3,7,"ANC","Anchorage Wheelers","away",1,0,"West Division","MiLPBE",20,19,1,"20 - 19",0,187,191,377,36481,34969,39,0.510580825752274,20,19,"20 - 19","#007EF3",2,2,"2030"
16,101,545,2030-07-08,1905,9,3,9,"ANC","Anchorage Wheelers","away",0,1,"West Division","MiLPBE",20,20,0,"20 - 20",5,192,194,386,37636,36864,40,0.505181208053691,20,20,"20 - 20","#007EF3",2,2,"2030"
16,101,548,2030-07-09,1905,9,11,16,"ANC","Anchorage Wheelers","away",1,0,"West Division","MiLPBE",21,20,1,"21 - 20",4,196,205,402,42025,38416,41,0.522432590345719,21,20,"21 - 20","#007EF3",2,2,"2030"
16,101,551,2030-07-11,1905,9,5,8,"ANC","Anchorage Wheelers","away",0,1,"West Division","MiLPBE",21,21,0,"21 - 21",9,205,210,410,44100,42025,42,0.512046444121916,22,20,"22 - 20","#007EF3",2,2,"2030"
16,101,554,2030-07-12,1905,9,1,4,"ANC","Anchorage Wheelers","away",0,1,"West Division","MiLPBE",21,22,-1,"21 - 22",10,215,211,414,44521,46225,43,0.490611156414608,21,22,"21 - 22","#007EF3",2,2,"2030"
16,101,557,2030-07-13,1905,12,5,13,"ANC","Anchorage Wheelers","away",0,1,"West Division","MiLPBE",21,23,-2,"21 - 23",6,221,216,427,46656,48841,44,0.488559850047645,21,23,"21 - 23","#007EF3",2,2,"2030"
16,101,560,2030-07-17,1905,9,1,6,"ANC","Anchorage Wheelers","away",0,1,"West Division","MiLPBE",21,24,-3,"21 - 24",6,227,217,433,47089,51529,45,0.477488896550326,21,24,"21 - 24","#007EF3",2,2,"2030"
16,101,563,2030-07-18,1905,9,8,9,"ANC","Anchorage Wheelers","away",1,0,"West Division","MiLPBE",22,24,-2,"22 - 24",3,230,225,442,50625,52900,46,0.489012315865733,22,24,"22 - 24","#007EF3",2,2,"2030"
16,101,566,2030-07-19,1905,9,1,5,"ANC","Anchorage Wheelers","away",0,1,"West Division","MiLPBE",22,25,-3,"22 - 25",6,236,226,447,51076,55696,47,0.478365114449481,22,25,"22 - 25","#007EF3",2,2,"2030"
16,101,569,2030-07-20,1905,9,5,7,"ANC","Anchorage Wheelers","away",1,0,"West Division","MiLPBE",23,25,-2,"23 - 25",3,239,231,454,53361,57121,48,0.48298365344581,23,25,"23 - 25","#007EF3",2,2,"2030"
16,101,572,2030-07-23,1905,9,2,9,"ANC","Anchorage Wheelers","away",0,1,"West Division","MiLPBE",23,26,-3,"23 - 26",10,249,233,463,54289,62001,49,0.466841516897412,23,26,"23 - 26","#007EF3",2,2,"2030"
16,101,575,2030-07-24,1905,9,0,9,"ANC","Anchorage Wheelers","away",0,1,"West Division","MiLPBE",23,27,-4,"23 - 27",6,255,233,472,54289,65025,50,0.45500947080812,23,27,"23 - 27","#007EF3",2,2,"2030"
16,101,578,2030-07-25,1905,9,10,17,"ANC","Anchorage Wheelers","away",1,0,"West Division","MiLPBE",24,27,-3,"24 - 27",3,258,243,489,59049,66564,51,0.470086694848463,24,27,"24 - 27","#007EF3",2,2,"2030"
16,101,581,2030-07-26,1905,9,8,12,"ANC","Anchorage Wheelers","away",1,0,"West Division","MiLPBE",25,27,-2,"25 - 27",5,263,251,501,63001,69169,52,0.476666414466218,25,27,"25 - 27","#007EF3",2,2,"2030"
16,101,584,2030-08-12,1905,9,7,11,"ANC","Anchorage Wheelers","home",1,0,"West Division","MiLPBE",26,27,-1,"26 - 27",5,268,258,512,66564,71824,53,0.48099546203428,25,28,"25 - 28","#007EF3",2,2,"2030"
16,101,587,2030-08-13,1905,9,10,14,"ANC","Anchorage Wheelers","home",1,0,"West Division","MiLPBE",27,27,0,"27 - 27",2,270,268,526,71824,72900,54,0.496282579254305,27,27,"27 - 27","#007EF3",2,2,"2030"
16,101,590,2030-08-14,1905,9,8,12,"ANC","Anchorage Wheelers","home",1,0,"West Division","MiLPBE",28,27,1,"28 - 27",7,277,276,538,76176,76729,55,0.498191687649194,27,28,"27 - 28","#007EF3",2,2,"2030"
16,101,593,2030-08-15,1905,14,3,13,"ANC","Anchorage Wheelers","home",0,1,"West Division","MiLPBE",28,28,0,"28 - 28",4,281,279,551,77841,78961,56,0.496428616981926,28,28,"28 - 28","#007EF3",2,2,"2030"
16,101,596,2030-08-18,1905,9,4,8,"ANC","Anchorage Wheelers","home",1,0,"West Division","MiLPBE",29,28,1,"29 - 28",0,281,283,559,80089,78961,57,0.50354605469978,29,28,"29 - 28","#007EF3",2,2,"2030"
16,101,599,2030-08-19,1905,9,1,7,"ANC","Anchorage Wheelers","home",0,1,"West Division","MiLPBE",29,29,0,"29 - 29",4,285,284,566,80656,81225,58,0.498242536183987,29,29,"29 - 29","#007EF3",2,2,"2030"
16,101,602,2030-08-20,1905,9,2,8,"ANC","Anchorage Wheelers","home",1,0,"West Division","MiLPBE",30,29,1,"30 - 29",0,285,286,574,81796,81225,59,0.501751308113679,30,29,"30 - 29","#007EF3",2,2,"2030"
16,101,605,2030-08-21,1905,9,2,7,"ANC","Anchorage Wheelers","home",1,0,"West Division","MiLPBE",31,29,2,"31 - 29",1,286,288,581,82944,81796,60,0.503484278256647,30,30,"30 - 30","#007EF3",2,2,"2030"
16,101,608,2030-08-24,1905,9,4,11,"ANC","Anchorage Wheelers","home",1,0,"West Division","MiLPBE",32,29,3,"32 - 29",3,289,292,592,85264,83521,61,0.505163373522529,31,30,"31 - 30","#007EF3",2,2,"2030"
16,101,611,2030-08-25,1905,9,1,9,"ANC","Anchorage Wheelers","home",0,1,"West Division","MiLPBE",32,30,2,"32 - 30",2,291,293,601,85849,84681,62,0.503424617369378,31,31,"31 - 31","#007EF3",2,2,"2030"
16,101,614,2030-08-26,1905,9,0,4,"ANC","Anchorage Wheelers","home",0,1,"West Division","MiLPBE",32,31,1,"32 - 31",2,293,293,605,85849,85849,63,0.5,32,31,"32 - 31","#007EF3",2,2,"2030"
16,101,617,2030-08-27,1905,9,4,8,"ANC","Anchorage Wheelers","home",1,0,"West Division","MiLPBE",33,31,2,"33 - 31",3,296,297,613,88209,87616,64,0.501686335845301,32,32,"32 - 32","#007EF3",2,2,"2030"
16,101,620,2030-08-30,1905,9,7,12,"ANC","Anchorage Wheelers","home",1,0,"West Division","MiLPBE",34,31,3,"34 - 31",2,298,304,625,92416,88804,65,0.50996578744068,33,32,"33 - 32","#007EF3",2,2,"2030"
16,101,623,2030-08-31,1905,9,3,11,"ANC","Anchorage Wheelers","home",1,0,"West Division","MiLPBE",35,31,4,"35 - 31",0,298,307,636,94249,88804,66,0.51487274177424,34,32,"34 - 32","#007EF3",2,2,"2030"
16,101,626,2030-09-01,1905,9,2,7,"ANC","Anchorage Wheelers","home",0,1,"West Division","MiLPBE",35,32,3,"35 - 32",3,301,309,643,95481,90601,67,0.513112498790856,34,33,"34 - 33","#007EF3",2,2,"2030"
16,101,829,2030-09-02,1905,9,2,9,"ANC","Anchorage Wheelers","home",0,1,"West Division","MiLPBE",35,33,2,"35 - 33",5,306,311,652,96721,93636,68,0.508103195574631,35,33,"35 - 33","#007EF3",2,2,"2030"
16,101,832,2030-09-05,1905,9,7,9,"ANC","Anchorage Wheelers","home",0,1,"West Division","MiLPBE",35,34,1,"35 - 34",8,314,318,661,101124,98596,69,0.506328860404566,35,34,"35 - 34","#007EF3",2,2,"2030"
16,101,835,2030-09-06,1905,9,0,5,"ANC","Anchorage Wheelers","home",0,1,"West Division","MiLPBE",35,35,0,"35 - 35",2,316,318,666,101124,99856,70,0.503154542740571,35,35,"35 - 35","#007EF3",2,2,"2030"
16,101,838,2030-09-07,1905,9,6,10,"ANC","Anchorage Wheelers","home",1,0,"West Division","MiLPBE",36,35,1,"36 - 35",5,321,324,676,104976,103041,71,0.504651062172803,36,35,"36 - 35","#007EF3",2,2,"2030"
16,101,841,2030-09-08,1905,9,2,8,"ANC","Anchorage Wheelers","home",1,0,"West Division","MiLPBE",37,35,2,"37 - 35",1,322,326,684,106276,103684,72,0.506172604305582,36,36,"36 - 36","#007EF3",2,2,"2030"
16,101,844,2030-09-11,1905,9,9,16,"ANC","Anchorage Wheelers","away",1,0,"West Division","MiLPBE",38,35,3,"38 - 35",6,328,335,700,112225,107584,73,0.510556892574917,37,36,"37 - 36","#007EF3",2,2,"2030"
16,101,847,2030-09-12,1905,9,7,11,"ANC","Anchorage Wheelers","away",1,0,"West Division","MiLPBE",39,35,4,"39 - 35",0,328,342,711,116964,107584,74,0.520886402907173,39,35,"39 - 35","#007EF3",2,2,"2030"
16,101,850,2030-09-13,1905,9,7,12,"ANC","Anchorage Wheelers","away",1,0,"West Division","MiLPBE",40,35,5,"40 - 35",3,331,349,723,121801,109561,75,0.52645205349193,39,36,"39 - 36","#007EF3",2,2,"2030"
16,101,853,2030-09-14,1905,9,10,18,"ANC","Anchorage Wheelers","away",1,0,"West Division","MiLPBE",41,35,6,"41 - 35",6,337,359,741,128881,113569,76,0.531577644875232,40,36,"40 - 36","#007EF3",2,2,"2030"
16,101,856,2030-09-17,1905,9,0,4,"ANC","Anchorage Wheelers","away",0,1,"West Division","MiLPBE",41,36,5,"41 - 36",2,339,359,745,128881,114921,77,0.528629789747418,41,36,"41 - 36","#007EF3",2,2,"2030"
16,101,859,2030-09-18,1905,9,2,5,"ANC","Anchorage Wheelers","away",0,1,"West Division","MiLPBE",41,37,4,"41 - 37",8,347,361,750,130321,120409,78,0.519766282455231,41,37,"41 - 37","#007EF3",2,2,"2030"
16,101,862,2030-09-19,1905,9,1,7,"ANC","Anchorage Wheelers","home",0,1,"West Division","MiLPBE",41,38,3,"41 - 38",11,358,362,757,131044,128164,79,0.505555384093084,40,39,"40 - 39","#007EF3",2,2,"2030"
16,101,865,2030-09-20,1905,9,2,6,"ANC","Anchorage Wheelers","home",1,0,"West Division","MiLPBE",42,38,4,"42 - 38",0,358,364,763,132496,128164,80,0.50830967543927,41,39,"41 - 39","#007EF3",2,2,"2030"
16,101,868,2030-09-22,1905,9,1,11,"ANC","Anchorage Wheelers","away",0,1,"West Division","MiLPBE",42,39,3,"42 - 39",11,369,365,774,133225,136161,81,0.494550570556748,40,41,"40 - 41","#007EF3",2,2,"2030"
16,101,871,2030-09-23,1905,9,7,15,"ANC","Anchorage Wheelers","away",1,0,"West Division","MiLPBE",43,39,4,"43 - 39",2,371,372,789,138384,137641,82,0.501345892582194,41,41,"41 - 41","#007EF3",2,2,"2030"
16,101,874,2030-09-24,1905,9,2,11,"ANC","Anchorage Wheelers","home",1,0,"West Division","MiLPBE",44,39,5,"44 - 39",1,372,374,800,139876,138384,83,0.502680945877956,42,41,"42 - 41","#007EF3",2,2,"2030"
16,101,877,2030-09-25,1905,9,9,14,"ANC","Anchorage Wheelers","home",1,0,"West Division","MiLPBE",45,39,6,"45 - 39",4,376,383,814,146689,141376,84,0.509221877006926,43,41,"43 - 41","#007EF3",2,2,"2030"
16,101,880,2030-09-28,1905,9,6,12,"ANC","Anchorage Wheelers","away",1,0,"West Division","MiLPBE",46,39,7,"46 - 39",2,378,389,826,151321,142884,85,0.514338641423497,44,41,"44 - 41","#007EF3",2,2,"2030"
16,101,883,2030-09-29,1905,9,7,9,"ANC","Anchorage Wheelers","away",1,0,"West Division","MiLPBE",47,39,8,"47 - 39",3,381,396,835,156816,145161,86,0.519297827317975,45,41,"45 - 41","#007EF3",2,2,"2030"
16,101,886,2030-09-30,1905,9,14,17,"ANC","Anchorage Wheelers","home",1,0,"West Division","MiLPBE",48,39,9,"48 - 39",3,384,410,852,168100,147456,87,0.532710517309131,46,41,"46 - 41","#007EF3",2,2,"2030"
16,101,889,2030-10-01,1905,9,0,7,"ANC","Anchorage Wheelers","home",0,1,"West Division","MiLPBE",48,40,8,"48 - 40",3,387,410,859,168100,149769,88,0.528834205285825,47,41,"47 - 41","#007EF3",2,2,"2030"
16,101,892,2030-10-04,1905,9,6,13,"ANC","Anchorage Wheelers","away",0,1,"West Division","MiLPBE",48,41,7,"48 - 41",8,395,416,872,173056,156025,89,0.525876607886812,47,42,"47 - 42","#007EF3",2,2,"2030"
16,101,895,2030-10-05,1905,9,2,8,"ANC","Anchorage Wheelers","away",0,1,"West Division","MiLPBE",48,42,6,"48 - 42",4,399,418,880,174724,159201,90,0.523243243243243,47,43,"47 - 43","#007EF3",2,2,"2030"
16,101,898,2030-10-06,1905,9,1,5,"ANC","Anchorage Wheelers","home",0,1,"West Division","MiLPBE",48,43,5,"48 - 43",2,401,419,885,175561,160801,91,0.521940647278825,47,44,"47 - 44","#007EF3",2,2,"2030"
17,101,302,2030-05-15,1905,11,5,13,"KGN","Kingston Mounties","home",1,0,"East Division","MiLPBE",1,0,1,"1 - 0",3,3,5,13,25,9,1,0.735294117647059,1,0,"1 - 0","#6C0000",1,2,"2030"
17,101,305,2030-05-16,1905,9,3,10,"KGN","Kingston Mounties","home",0,1,"East Division","MiLPBE",1,1,0,"1 - 1",10,13,8,23,64,169,2,0.274678111587983,1,1,"1 - 1","#6C0000",1,2,"2030"
17,101,308,2030-05-17,1905,9,4,9,"KGN","Kingston Mounties","home",1,0,"East Division","MiLPBE",2,1,1,"2 - 1",3,16,12,32,144,256,3,0.36,1,2,"1 - 2","#6C0000",1,2,"2030"
17,101,311,2030-05-18,1905,9,1,7,"KGN","Kingston Mounties","home",0,1,"East Division","MiLPBE",2,2,0,"2 - 2",7,23,13,39,169,529,4,0.242120343839542,1,3,"1 - 3","#6C0000",1,2,"2030"
17,101,315,2030-05-20,1905,11,5,10,"KGN","Kingston Mounties","home",1,0,"East Division","MiLPBE",3,2,1,"3 - 2",3,26,18,49,324,676,5,0.324,2,3,"2 - 3","#6C0000",1,2,"2030"
17,101,318,2030-05-21,1905,9,8,11,"KGN","Kingston Mounties","home",1,0,"East Division","MiLPBE",4,2,2,"4 - 2",3,29,26,60,676,841,6,0.445616348055372,3,3,"3 - 3","#6C0000",1,2,"2030"
17,101,321,2030-05-22,1905,9,12,13,"KGN","Kingston Mounties","home",1,0,"East Division","MiLPBE",5,2,3,"5 - 2",2,31,38,73,1444,961,7,0.6004158004158,4,3,"4 - 3","#6C0000",1,2,"2030"
17,101,324,2030-05-23,1905,9,11,13,"KGN","Kingston Mounties","home",1,0,"East Division","MiLPBE",6,2,4,"6 - 2",6,37,49,86,2401,1369,8,0.636870026525199,5,3,"5 - 3","#6C0000",1,2,"2030"
17,101,328,2030-05-26,1905,9,4,6,"KGN","Kingston Mounties","away",0,1,"East Division","MiLPBE",6,3,3,"6 - 3",10,47,53,92,2809,2209,9,0.559784774810682,5,4,"5 - 4","#6C0000",1,2,"2030"
17,101,331,2030-05-27,1905,9,3,10,"KGN","Kingston Mounties","away",0,1,"East Division","MiLPBE",6,4,2,"6 - 4",9,56,56,102,3136,3136,10,0.5,5,5,"5 - 5","#6C0000",1,2,"2030"
17,101,334,2030-05-28,1905,9,2,7,"KGN","Kingston Mounties","away",0,1,"East Division","MiLPBE",6,5,1,"6 - 5",7,63,58,109,3364,3969,11,0.458748124914769,5,6,"5 - 6","#6C0000",1,2,"2030"
17,101,337,2030-05-29,1905,9,7,8,"KGN","Kingston Mounties","away",1,0,"East Division","MiLPBE",7,5,2,"7 - 5",3,66,65,117,4225,4356,12,0.492366857009673,6,6,"6 - 6","#6C0000",1,2,"2030"
17,101,340,2030-06-01,1905,9,3,9,"KGN","Kingston Mounties","home",0,1,"East Division","MiLPBE",7,6,1,"7 - 6",10,76,68,126,4624,5776,13,0.444615384615385,6,7,"6 - 7","#6C0000",1,2,"2030"
17,101,343,2030-06-02,1905,10,3,6,"KGN","Kingston Mounties","home",0,1,"East Division","MiLPBE",7,7,0,"7 - 7",6,82,71,132,5041,6724,14,0.428474288142796,6,8,"6 - 8","#6C0000",1,2,"2030"
17,101,346,2030-06-03,1905,9,0,3,"KGN","Kingston Mounties","home",0,1,"East Division","MiLPBE",7,8,-1,"7 - 8",6,88,71,135,5041,7744,15,0.394290183809151,6,9,"6 - 9","#6C0000",1,2,"2030"
17,101,349,2030-06-04,1905,9,3,6,"KGN","Kingston Mounties","home",1,0,"East Division","MiLPBE",8,8,0,"8 - 8",1,89,74,141,5476,7921,16,0.408748227215048,7,9,"7 - 9","#6C0000",1,2,"2030"
17,101,351,2030-06-07,1905,9,3,8,"KGN","Kingston Mounties","home",1,0,"East Division","MiLPBE",9,8,1,"9 - 8",2,91,77,149,5929,8281,17,0.417241379310345,7,10,"7 - 10","#6C0000",1,2,"2030"
17,101,354,2030-06-08,1905,9,4,6,"KGN","Kingston Mounties","home",0,1,"East Division","MiLPBE",9,9,0,"9 - 9",7,98,81,155,6561,9604,18,0.405876894525209,7,11,"7 - 11","#6C0000",1,2,"2030"
17,101,357,2030-06-09,1905,9,7,9,"KGN","Kingston Mounties","home",1,0,"East Division","MiLPBE",10,9,1,"10 - 9",1,99,88,164,7744,9801,19,0.441379310344828,8,11,"8 - 11","#6C0000",1,2,"2030"
17,101,360,2030-06-10,1905,9,3,9,"KGN","Kingston Mounties","home",1,0,"East Division","MiLPBE",11,9,2,"11 - 9",0,99,91,173,8281,9801,20,0.457969251189028,9,11,"9 - 11","#6C0000",1,2,"2030"
17,101,362,2030-06-13,1905,9,1,6,"KGN","Kingston Mounties","away",1,0,"East Division","MiLPBE",12,9,3,"12 - 9",0,99,92,179,8464,9801,21,0.463399945250479,10,11,"10 - 11","#6C0000",1,2,"2030"
17,101,365,2030-06-14,1905,9,7,7,"KGN","Kingston Mounties","away",1,0,"East Division","MiLPBE",13,9,4,"13 - 9",5,104,99,186,9801,10816,22,0.47538439152156,10,12,"10 - 12","#6C0000",1,2,"2030"
17,101,368,2030-06-15,1905,9,13,14,"KGN","Kingston Mounties","away",1,0,"East Division","MiLPBE",14,9,5,"14 - 9",11,115,112,200,12544,13225,23,0.48678644883387,11,12,"11 - 12","#6C0000",1,2,"2030"
17,101,371,2030-06-16,1905,9,4,10,"KGN","Kingston Mounties","away",0,1,"East Division","MiLPBE",14,10,4,"14 - 10",9,124,116,210,13456,15376,24,0.466703662597114,11,13,"11 - 13","#6C0000",1,2,"2030"
17,101,375,2030-06-19,1905,9,6,7,"KGN","Kingston Mounties","away",0,1,"East Division","MiLPBE",14,11,3,"14 - 11",7,131,122,217,14884,17161,25,0.46447183647995,12,13,"12 - 13","#6C0000",1,2,"2030"
17,101,378,2030-06-20,1905,9,3,11,"KGN","Kingston Mounties","away",0,1,"East Division","MiLPBE",14,12,2,"14 - 12",10,141,125,228,15625,19881,26,0.440066467639272,11,15,"11 - 15","#6C0000",1,2,"2030"
17,101,381,2030-06-21,1905,9,6,13,"KGN","Kingston Mounties","away",1,0,"East Division","MiLPBE",15,12,3,"15 - 12",2,143,131,241,17161,20449,27,0.456288221217761,12,15,"12 - 15","#6C0000",1,2,"2030"
17,101,510,2030-06-22,1905,9,5,12,"KGN","Kingston Mounties","away",0,1,"East Division","MiLPBE",15,13,2,"15 - 13",6,149,136,253,18496,22201,28,0.454480674251173,13,15,"13 - 15","#6C0000",1,2,"2030"
17,101,512,2030-07-14,1405,9,2,3,"KGN","Kingston Mounties","home",0,1,"East Division","MiLPBE",15,14,1,"15 - 14",9,158,138,256,19044,24964,29,0.432739501908744,13,16,"13 - 16","#6C0000",1,2,"2030"
17,101,517,2030-06-24,1905,9,8,10,"KGN","Kingston Mounties","home",1,0,"East Division","MiLPBE",16,14,2,"16 - 14",1,159,146,266,21316,25281,30,0.457454342554242,14,16,"14 - 16","#6C0000",1,2,"2030"
17,101,520,2030-06-25,1905,9,0,6,"KGN","Kingston Mounties","home",0,1,"East Division","MiLPBE",16,15,1,"16 - 15",6,165,146,272,21316,27225,31,0.439133928019612,14,17,"14 - 17","#6C0000",1,2,"2030"
17,101,523,2030-06-26,1905,9,1,4,"KGN","Kingston Mounties","home",0,1,"East Division","MiLPBE",16,16,0,"16 - 16",9,174,147,276,21609,30276,32,0.416478751084128,13,19,"13 - 19","#6C0000",1,2,"2030"
17,101,526,2030-06-27,1905,9,7,14,"KGN","Kingston Mounties","home",1,0,"East Division","MiLPBE",17,16,1,"17 - 16",6,180,154,290,23716,32400,33,0.422624563404377,14,19,"14 - 19","#6C0000",1,2,"2030"
17,101,529,2030-06-30,1905,9,7,12,"KGN","Kingston Mounties","away",1,0,"East Division","MiLPBE",18,16,2,"18 - 16",1,181,161,302,25921,32761,34,0.441719777785352,15,19,"15 - 19","#6C0000",1,2,"2030"
17,101,532,2030-07-01,1905,9,5,8,"KGN","Kingston Mounties","away",1,0,"East Division","MiLPBE",19,16,3,"19 - 16",2,183,166,310,27556,33489,35,0.45140470144975,16,19,"16 - 19","#6C0000",1,2,"2030"
17,101,535,2030-07-02,1905,9,2,9,"KGN","Kingston Mounties","away",0,1,"East Division","MiLPBE",19,17,2,"19 - 17",7,190,168,319,28224,36100,36,0.438778682917729,16,20,"16 - 20","#6C0000",1,2,"2030"
17,101,538,2030-07-03,1905,9,8,13,"KGN","Kingston Mounties","away",1,0,"East Division","MiLPBE",20,17,3,"20 - 17",5,195,176,332,30976,38025,37,0.448921030129998,17,20,"17 - 20","#6C0000",1,2,"2030"
17,101,540,2030-07-06,1905,9,1,7,"KGN","Kingston Mounties","away",0,1,"East Division","MiLPBE",20,18,2,"20 - 18",3,198,177,339,31329,39204,38,0.44417506698992,17,21,"17 - 21","#6C0000",1,2,"2030"
17,101,543,2030-07-07,1905,11,2,13,"KGN","Kingston Mounties","away",1,0,"East Division","MiLPBE",21,18,3,"21 - 18",1,199,179,352,32041,39601,39,0.447237653890176,17,22,"17 - 22","#6C0000",1,2,"2030"
17,101,546,2030-07-08,1905,9,1,3,"KGN","Kingston Mounties","away",0,1,"East Division","MiLPBE",21,19,2,"21 - 19",3,202,180,355,32400,40804,40,0.442598765094804,18,22,"18 - 22","#6C0000",1,2,"2030"
17,101,549,2030-07-09,1905,9,4,11,"KGN","Kingston Mounties","away",0,1,"East Division","MiLPBE",21,20,1,"21 - 20",6,208,184,366,33856,43264,41,0.439004149377593,18,23,"18 - 23","#6C0000",1,2,"2030"
17,101,551,2030-07-11,1905,9,9,14,"KGN","Kingston Mounties","home",1,0,"East Division","MiLPBE",22,20,2,"22 - 20",5,213,193,380,37249,45369,42,0.450858166501247,19,23,"19 - 23","#6C0000",1,2,"2030"
17,101,554,2030-07-12,1905,9,10,17,"KGN","Kingston Mounties","home",1,0,"East Division","MiLPBE",23,20,3,"23 - 20",1,214,203,397,41209,45796,43,0.47363944600885,20,23,"20 - 23","#6C0000",1,2,"2030"
17,101,557,2030-07-13,1905,12,6,10,"KGN","Kingston Mounties","home",1,0,"East Division","MiLPBE",24,20,4,"24 - 20",5,219,209,407,43681,47961,44,0.476648261714061,21,23,"21 - 23","#6C0000",1,2,"2030"
17,101,561,2030-07-17,1905,9,5,6,"KGN","Kingston Mounties","home",1,0,"East Division","MiLPBE",25,20,5,"25 - 20",2,221,214,413,45796,48841,45,0.483912211925568,22,23,"22 - 23","#6C0000",1,2,"2030"
17,101,564,2030-07-18,1905,9,8,7,"KGN","Kingston Mounties","home",1,0,"East Division","MiLPBE",26,20,6,"26 - 20",5,226,222,420,49284,51076,46,0.491072140294938,23,23,"23 - 23","#6C0000",1,2,"2030"
17,101,567,2030-07-19,1905,9,6,12,"KGN","Kingston Mounties","home",0,1,"East Division","MiLPBE",26,21,5,"26 - 21",7,233,228,432,51984,54289,47,0.489155288737497,23,24,"23 - 24","#6C0000",1,2,"2030"
17,101,570,2030-07-20,1905,9,5,9,"KGN","Kingston Mounties","home",1,0,"East Division","MiLPBE",27,21,6,"27 - 21",4,237,233,441,54289,56169,48,0.49148997809122,24,24,"24 - 24","#6C0000",1,2,"2030"
17,101,573,2030-07-23,1905,9,0,6,"KGN","Kingston Mounties","away",0,1,"East Division","MiLPBE",27,22,5,"27 - 22",3,240,233,447,54289,57600,49,0.485204086192566,24,25,"24 - 25","#6C0000",1,2,"2030"
17,101,576,2030-07-24,1905,10,5,10,"KGN","Kingston Mounties","away",0,1,"East Division","MiLPBE",27,23,4,"27 - 23",6,246,238,457,56644,60516,50,0.483475588938204,24,26,"24 - 26","#6C0000",1,2,"2030"
17,101,579,2030-07-25,1905,9,4,9,"KGN","Kingston Mounties","away",1,0,"East Division","MiLPBE",28,23,5,"28 - 23",3,249,242,466,58564,62001,51,0.485746277941359,25,26,"25 - 26","#6C0000",1,2,"2030"
17,101,582,2030-07-26,1905,9,2,9,"KGN","Kingston Mounties","away",0,1,"East Division","MiLPBE",28,24,4,"28 - 24",7,256,244,475,59536,65536,52,0.47601381604196,25,27,"25 - 27","#6C0000",1,2,"2030"
17,101,586,2030-08-12,1905,9,0,9,"KGN","Kingston Mounties","away",0,1,"East Division","MiLPBE",28,25,3,"28 - 25",6,262,244,484,59536,68644,53,0.46447183647995,25,28,"25 - 28","#6C0000",1,2,"2030"
17,101,589,2030-08-13,1905,10,4,9,"KGN","Kingston Mounties","away",0,1,"East Division","MiLPBE",28,26,2,"28 - 26",5,267,248,493,61504,71289,54,0.463156943513589,25,29,"25 - 29","#6C0000",1,2,"2030"
17,101,592,2030-08-14,1905,9,3,6,"KGN","Kingston Mounties","away",1,0,"East Division","MiLPBE",29,26,3,"29 - 26",2,269,251,499,63001,72361,55,0.465426042759416,26,29,"26 - 29","#6C0000",1,2,"2030"
17,101,595,2030-08-15,1905,9,2,8,"KGN","Kingston Mounties","away",1,0,"East Division","MiLPBE",30,26,4,"30 - 26",1,270,253,507,64009,72900,56,0.467529526912036,26,30,"26 - 30","#6C0000",1,2,"2030"
17,101,598,2030-08-18,1905,9,4,11,"KGN","Kingston Mounties","home",1,0,"East Division","MiLPBE",31,26,5,"31 - 26",3,273,257,518,66049,74529,57,0.46983880834839,27,30,"27 - 30","#6C0000",1,2,"2030"
17,101,601,2030-08-19,1905,9,6,12,"KGN","Kingston Mounties","home",0,1,"East Division","MiLPBE",31,27,4,"31 - 27",8,281,263,530,69169,78961,58,0.466947951124013,27,31,"27 - 31","#6C0000",1,2,"2030"
17,101,604,2030-08-20,1905,9,2,8,"KGN","Kingston Mounties","home",1,0,"East Division","MiLPBE",32,27,5,"32 - 27",1,282,265,538,70225,79524,59,0.468951378640258,28,31,"28 - 31","#6C0000",1,2,"2030"
17,101,607,2030-08-21,1905,9,9,10,"KGN","Kingston Mounties","home",1,0,"East Division","MiLPBE",33,27,6,"33 - 27",4,286,274,548,75076,81796,60,0.478581263705441,29,31,"29 - 31","#6C0000",1,2,"2030"
17,101,609,2030-08-24,1905,9,3,4,"KGN","Kingston Mounties","home",0,1,"East Division","MiLPBE",33,28,5,"33 - 28",4,290,277,552,76729,84100,61,0.477084356676967,29,32,"29 - 32","#6C0000",1,2,"2030"
17,101,612,2030-08-25,1905,9,6,10,"KGN","Kingston Mounties","home",1,0,"East Division","MiLPBE",34,28,6,"34 - 28",2,292,283,562,80089,85264,62,0.484351659782405,30,32,"30 - 32","#6C0000",1,2,"2030"
17,101,615,2030-08-26,1905,9,4,9,"KGN","Kingston Mounties","home",0,1,"East Division","MiLPBE",34,29,5,"34 - 29",8,300,287,571,82369,90000,63,0.477864349157911,30,33,"30 - 33","#6C0000",1,2,"2030"
17,101,618,2030-08-27,1905,9,4,9,"KGN","Kingston Mounties","home",1,0,"East Division","MiLPBE",35,29,6,"35 - 29",2,302,291,580,84681,91204,64,0.481456633595815,31,33,"31 - 33","#6C0000",1,2,"2030"
17,101,620,2030-08-30,1905,9,2,3,"KGN","Kingston Mounties","away",0,1,"East Division","MiLPBE",35,30,5,"35 - 30",7,309,293,583,85849,95481,65,0.473440688247946,31,34,"31 - 34","#6C0000",1,2,"2030"
17,101,623,2030-08-31,1905,9,0,6,"KGN","Kingston Mounties","away",0,1,"East Division","MiLPBE",35,31,4,"35 - 31",3,312,293,589,85849,97344,66,0.468625984617316,31,35,"31 - 35","#6C0000",1,2,"2030"
17,101,626,2030-09-01,1905,9,3,8,"KGN","Kingston Mounties","away",1,0,"East Division","MiLPBE",36,31,5,"36 - 31",2,314,296,597,87616,98596,67,0.470517474706249,32,35,"32 - 35","#6C0000",1,2,"2030"
17,101,829,2030-09-02,1905,9,5,8,"KGN","Kingston Mounties","away",1,0,"East Division","MiLPBE",37,31,6,"37 - 31",2,316,301,605,90601,99856,68,0.475703177095092,32,36,"32 - 36","#6C0000",1,2,"2030"
17,101,833,2030-09-05,1905,9,0,6,"KGN","Kingston Mounties","away",0,1,"East Division","MiLPBE",37,32,5,"37 - 32",15,331,301,611,90601,109561,69,0.45263836292603,31,38,"31 - 38","#6C0000",1,2,"2030"
17,101,836,2030-09-06,1905,9,10,18,"KGN","Kingston Mounties","away",1,0,"East Division","MiLPBE",38,32,6,"38 - 32",5,336,311,629,96721,112896,70,0.461417728523927,32,38,"32 - 38","#6C0000",1,2,"2030"
17,101,839,2030-09-07,1905,9,5,8,"KGN","Kingston Mounties","away",0,1,"East Division","MiLPBE",38,33,5,"38 - 33",11,347,316,637,99856,120409,71,0.453344834631013,32,39,"32 - 39","#6C0000",1,2,"2030"
17,101,842,2030-09-08,1905,9,10,13,"KGN","Kingston Mounties","away",1,0,"East Division","MiLPBE",39,33,6,"39 - 33",3,350,326,650,106276,122500,72,0.464541735147043,33,39,"33 - 39","#6C0000",1,2,"2030"
17,101,846,2030-09-11,1905,9,4,10,"KGN","Kingston Mounties","home",0,1,"East Division","MiLPBE",39,34,5,"39 - 34",8,358,330,660,108900,128164,73,0.459369621705531,34,39,"34 - 39","#6C0000",1,2,"2030"
17,101,849,2030-09-12,1905,9,3,11,"KGN","Kingston Mounties","home",0,1,"East Division","MiLPBE",39,35,4,"39 - 35",5,363,333,671,110889,131769,74,0.45697648542393,34,40,"34 - 40","#6C0000",1,2,"2030"
17,101,852,2030-09-13,1905,9,9,13,"KGN","Kingston Mounties","home",0,1,"East Division","MiLPBE",39,36,3,"39 - 36",13,376,342,684,116964,141376,75,0.452752187040334,34,41,"34 - 41","#6C0000",1,2,"2030"
17,101,855,2030-09-14,1905,9,10,14,"KGN","Kingston Mounties","home",1,0,"East Division","MiLPBE",40,36,4,"40 - 36",2,378,352,698,123904,142884,76,0.464428684948348,35,41,"35 - 41","#6C0000",1,2,"2030"
17,101,858,2030-09-17,1905,9,0,2,"KGN","Kingston Mounties","away",0,1,"East Division","MiLPBE",40,37,3,"40 - 37",3,381,352,700,123904,145161,77,0.460498392581718,35,42,"35 - 42","#6C0000",1,2,"2030"
17,101,861,2030-09-18,1905,9,3,9,"KGN","Kingston Mounties","away",0,1,"East Division","MiLPBE",40,38,2,"40 - 38",5,386,355,709,126025,148996,78,0.458237734572996,36,42,"36 - 42","#6C0000",1,2,"2030"
17,101,864,2030-09-19,1905,9,4,12,"KGN","Kingston Mounties","home",1,0,"East Division","MiLPBE",41,38,3,"41 - 38",1,387,359,721,128881,149769,79,0.462519289431186,37,42,"37 - 42","#6C0000",1,2,"2030"
17,101,867,2030-09-20,1905,9,6,18,"KGN","Kingston Mounties","home",1,0,"East Division","MiLPBE",42,38,4,"42 - 38",3,390,365,739,133225,152100,80,0.466923683518794,37,43,"37 - 43","#6C0000",1,2,"2030"
17,101,869,2030-09-22,1905,9,6,10,"KGN","Kingston Mounties","away",1,0,"East Division","MiLPBE",43,38,5,"43 - 38",2,392,371,749,137641,153664,81,0.472497897392767,38,43,"38 - 43","#6C0000",1,2,"2030"
17,101,872,2030-09-23,1905,9,6,11,"KGN","Kingston Mounties","away",0,1,"East Division","MiLPBE",43,39,4,"43 - 39",12,404,377,760,142129,163216,82,0.465470205832747,38,44,"38 - 44","#6C0000",1,2,"2030"
17,101,875,2030-09-24,1905,9,5,10,"KGN","Kingston Mounties","home",1,0,"East Division","MiLPBE",44,39,5,"44 - 39",3,407,382,770,145924,165649,83,0.468346101876607,39,44,"39 - 44","#6C0000",1,2,"2030"
17,101,878,2030-09-25,1905,9,1,8,"KGN","Kingston Mounties","home",0,1,"East Division","MiLPBE",44,40,4,"44 - 40",2,409,383,778,146689,167281,84,0.467207057999172,39,45,"39 - 45","#6C0000",1,2,"2030"
17,101,880,2030-09-28,1905,9,2,10,"KGN","Kingston Mounties","home",0,1,"East Division","MiLPBE",44,41,3,"44 - 41",6,415,385,788,148225,172225,85,0.462552660321423,39,46,"39 - 46","#6C0000",1,2,"2030"
17,101,883,2030-09-29,1905,9,3,10,"KGN","Kingston Mounties","home",0,1,"East Division","MiLPBE",44,42,2,"44 - 42",7,422,388,798,150544,178084,86,0.458098518689826,39,47,"39 - 47","#6C0000",1,2,"2030"
17,101,886,2030-09-30,1905,9,3,8,"KGN","Kingston Mounties","away",0,1,"East Division","MiLPBE",44,43,1,"44 - 43",14,436,391,806,152881,190096,87,0.445747090912802,39,48,"39 - 48","#6C0000",1,2,"2030"
17,101,889,2030-10-01,1905,9,3,7,"KGN","Kingston Mounties","away",1,0,"East Division","MiLPBE",45,43,2,"45 - 43",0,436,394,813,155236,190096,88,0.449526832149931,40,48,"40 - 48","#6C0000",1,2,"2030"
17,101,893,2030-10-04,1905,10,6,11,"KGN","Kingston Mounties","home",1,0,"East Division","MiLPBE",46,43,3,"46 - 43",5,441,400,824,160000,194481,89,0.451364106962009,40,49,"40 - 49","#6C0000",1,2,"2030"
17,101,896,2030-10-05,1905,9,14,11,"KGN","Kingston Mounties","home",1,0,"East Division","MiLPBE",47,43,4,"47 - 43",1,442,414,835,171396,195364,90,0.467324680990293,42,48,"42 - 48","#6C0000",1,2,"2030"
17,101,899,2030-10-06,1905,9,6,6,"KGN","Kingston Mounties","away",1,0,"East Division","MiLPBE",48,43,5,"48 - 43",2,444,420,841,176400,197136,91,0.472243639167309,43,48,"43 - 48","#6C0000",1,2,"2030"
18,101,303,2030-05-15,1905,9,4,9,"SCSS","State College Swift Steeds ","away",0,1,"East Division","MiLPBE",0,1,-1,"0 - 1",5,5,4,9,16,25,1,0.390243902439024,0,1,"0 - 1","#115376",2,5,"2030"
18,101,306,2030-05-16,1905,9,13,18,"SCSS","State College Swift Steeds ","away",1,0,"East Division","MiLPBE",1,1,0,"1 - 1",0,5,17,27,289,25,2,0.920382165605096,2,0,"2 - 0","#115376",2,5,"2030"
18,101,309,2030-05-17,1905,9,4,8,"SCSS","State College Swift Steeds ","away",1,0,"East Division","MiLPBE",2,1,1,"2 - 1",3,8,21,35,441,64,3,0.873267326732673,3,0,"3 - 0","#115376",2,5,"2030"
18,101,312,2030-05-18,1905,12,8,21,"SCSS","State College Swift Steeds ","away",1,0,"East Division","MiLPBE",3,1,2,"3 - 1",5,13,29,56,841,169,4,0.832673267326733,3,1,"3 - 1","#115376",2,5,"2030"
18,101,316,2030-05-20,1905,11,0,5,"SCSS","State College Swift Steeds ","home",0,1,"East Division","MiLPBE",3,2,1,"3 - 2",2,15,29,61,841,225,5,0.788930581613508,4,1,"4 - 1","#115376",2,5,"2030"
18,101,319,2030-05-21,1905,9,3,7,"SCSS","State College Swift Steeds ","home",0,1,"East Division","MiLPBE",3,3,0,"3 - 3",8,23,32,68,1024,529,6,0.659368963296845,4,2,"4 - 2","#115376",2,5,"2030"
18,101,322,2030-05-22,1905,9,3,6,"SCSS","State College Swift Steeds ","home",0,1,"East Division","MiLPBE",3,4,-1,"3 - 4",8,31,35,74,1225,961,7,0.560384263494968,4,3,"4 - 3","#115376",2,5,"2030"
18,101,325,2030-05-23,1905,9,3,11,"SCSS","State College Swift Steeds ","home",0,1,"East Division","MiLPBE",3,5,-2,"3 - 5",8,39,38,85,1444,1521,8,0.487015177065767,4,4,"4 - 4","#115376",2,5,"2030"
18,101,328,2030-05-26,1905,9,10,12,"SCSS","State College Swift Steeds ","home",1,0,"East Division","MiLPBE",4,5,-1,"4 - 5",4,43,48,97,2304,1849,9,0.554779677341681,5,4,"5 - 4","#115376",2,5,"2030"
18,101,331,2030-05-27,1905,9,9,16,"SCSS","State College Swift Steeds ","home",1,0,"East Division","MiLPBE",5,5,0,"5 - 5",3,46,57,113,3249,2116,10,0.605591798695247,6,4,"6 - 4","#115376",2,5,"2030"
18,101,334,2030-05-28,1905,9,7,7,"SCSS","State College Swift Steeds ","home",1,0,"East Division","MiLPBE",6,5,1,"6 - 5",2,48,64,120,4096,2304,11,0.64,7,4,"7 - 4","#115376",2,5,"2030"
18,101,337,2030-05-29,1905,9,3,6,"SCSS","State College Swift Steeds ","home",0,1,"East Division","MiLPBE",6,6,0,"6 - 6",7,55,67,126,4489,3025,12,0.597418152781475,7,5,"7 - 5","#115376",2,5,"2030"
18,101,339,2030-06-01,1905,9,1,7,"SCSS","State College Swift Steeds ","away",0,1,"East Division","MiLPBE",6,7,-1,"6 - 7",3,58,68,133,4624,3364,13,0.57886830245368,8,5,"8 - 5","#115376",2,5,"2030"
18,101,342,2030-06-02,1905,9,5,12,"SCSS","State College Swift Steeds ","away",0,1,"East Division","MiLPBE",6,8,-2,"6 - 8",7,65,73,145,5329,4225,14,0.557776847393762,8,6,"8 - 6","#115376",2,5,"2030"
18,101,345,2030-06-03,1905,9,1,10,"SCSS","State College Swift Steeds ","away",0,1,"East Division","MiLPBE",6,9,-3,"6 - 9",3,68,74,155,5476,4624,15,0.542178217821782,8,7,"8 - 7","#115376",2,5,"2030"
18,101,348,2030-06-04,1905,9,9,17,"SCSS","State College Swift Steeds ","away",1,0,"East Division","MiLPBE",7,9,-2,"7 - 9",6,74,83,172,6889,5476,16,0.557137080469066,9,7,"9 - 7","#115376",2,5,"2030"
18,101,350,2030-06-07,1905,9,2,5,"SCSS","State College Swift Steeds ","away",0,1,"East Division","MiLPBE",7,10,-3,"7 - 10",4,78,85,177,7225,6084,17,0.542865729957172,9,8,"9 - 8","#115376",2,5,"2030"
18,101,353,2030-06-08,1905,9,6,13,"SCSS","State College Swift Steeds ","away",1,0,"East Division","MiLPBE",8,10,-2,"8 - 10",2,80,91,190,8281,6400,18,0.56406239356992,10,8,"10 - 8","#115376",2,5,"2030"
18,101,356,2030-06-09,1905,9,0,5,"SCSS","State College Swift Steeds ","away",0,1,"East Division","MiLPBE",8,11,-3,"8 - 11",1,81,91,195,8281,6561,19,0.557943673359386,11,8,"11 - 8","#115376",2,5,"2030"
18,101,359,2030-06-10,1905,9,3,11,"SCSS","State College Swift Steeds ","away",0,1,"East Division","MiLPBE",8,12,-4,"8 - 12",4,85,94,206,8836,7225,20,0.55015254342818,11,9,"11 - 9","#115376",2,5,"2030"
18,101,363,2030-06-13,1905,9,4,8,"SCSS","State College Swift Steeds ","home",0,1,"East Division","MiLPBE",8,13,-5,"8 - 13",13,98,98,214,9604,9604,21,0.5,10,11,"10 - 11","#115376",2,5,"2030"
18,101,366,2030-06-14,1905,9,8,14,"SCSS","State College Swift Steeds ","home",0,1,"East Division","MiLPBE",8,14,-6,"8 - 14",9,107,106,228,11236,11449,22,0.495305267798104,11,11,"11 - 11","#115376",2,5,"2030"
18,101,369,2030-06-15,1905,9,8,12,"SCSS","State College Swift Steeds ","home",0,1,"East Division","MiLPBE",8,15,-7,"8 - 15",9,116,114,240,12996,13456,23,0.491305005292605,11,12,"11 - 12","#115376",2,5,"2030"
18,101,372,2030-06-16,1905,9,2,12,"SCSS","State College Swift Steeds ","home",0,1,"East Division","MiLPBE",8,16,-8,"8 - 16",6,122,116,252,13456,14884,24,0.474805928016937,11,13,"11 - 13","#115376",2,5,"2030"
18,101,376,2030-06-19,1905,9,5,13,"SCSS","State College Swift Steeds ","away",1,0,"East Division","MiLPBE",9,16,-7,"9 - 16",3,125,121,265,14641,15625,25,0.483744135333377,12,13,"12 - 13","#115376",2,5,"2030"
18,101,379,2030-06-20,1905,9,4,7,"SCSS","State College Swift Steeds ","away",0,1,"East Division","MiLPBE",9,17,-8,"9 - 17",7,132,125,272,15625,17424,26,0.472782837604769,12,14,"12 - 14","#115376",2,5,"2030"
18,101,508,2030-06-21,1905,9,6,9,"SCSS","State College Swift Steeds ","away",1,0,"East Division","MiLPBE",10,17,-7,"10 - 17",2,134,131,281,17161,17956,27,0.488680695959222,13,14,"13 - 14","#115376",2,5,"2030"
18,101,511,2030-06-22,1905,9,9,10,"SCSS","State College Swift Steeds ","away",1,0,"East Division","MiLPBE",11,17,-6,"11 - 17",7,141,140,291,19600,19881,28,0.496441326207543,14,14,"14 - 14","#115376",2,5,"2030"
18,101,513,2030-07-14,1905,9,5,9,"SCSS","State College Swift Steeds ","away",0,1,"East Division","MiLPBE",11,18,-7,"11 - 18",11,152,145,300,21025,23104,29,0.476444061728115,14,15,"14 - 15","#115376",2,5,"2030"
18,101,517,2030-06-24,1905,9,1,9,"SCSS","State College Swift Steeds ","away",0,1,"East Division","MiLPBE",11,19,-8,"11 - 19",8,160,146,309,21316,25600,30,0.454343933839202,14,16,"14 - 16","#115376",2,5,"2030"
18,101,520,2030-06-25,1905,9,6,9,"SCSS","State College Swift Steeds ","away",1,0,"East Division","MiLPBE",12,19,-7,"12 - 19",0,160,152,318,23104,25600,31,0.474375821287779,15,16,"15 - 16","#115376",2,5,"2030"
18,101,523,2030-06-26,1905,9,9,15,"SCSS","State College Swift Steeds ","away",1,0,"East Division","MiLPBE",13,19,-6,"13 - 19",1,161,161,333,25921,25921,32,0.5,16,16,"16 - 16","#115376",2,5,"2030"
18,101,526,2030-06-27,1905,9,6,8,"SCSS","State College Swift Steeds ","away",0,1,"East Division","MiLPBE",13,20,-7,"13 - 20",7,168,167,341,27889,28224,33,0.497014951971914,16,17,"16 - 17","#115376",2,5,"2030"
18,101,528,2030-06-30,1905,9,14,10,"SCSS","State College Swift Steeds ","home",1,0,"East Division","MiLPBE",14,20,-6,"14 - 20",2,170,181,351,32761,28900,34,0.531308282382705,18,16,"18 - 16","#115376",2,5,"2030"
18,101,531,2030-07-01,1905,9,2,10,"SCSS","State College Swift Steeds ","home",0,1,"East Division","MiLPBE",14,21,-7,"14 - 21",7,177,183,361,33489,31329,35,0.516662038322688,18,17,"18 - 17","#115376",2,5,"2030"
18,101,534,2030-07-02,1905,9,2,5,"SCSS","State College Swift Steeds ","home",0,1,"East Division","MiLPBE",14,22,-8,"14 - 22",7,184,185,366,34225,33856,36,0.502710007197309,18,18,"18 - 18","#115376",2,5,"2030"
18,101,537,2030-07-03,1905,9,3,14,"SCSS","State College Swift Steeds ","home",0,1,"East Division","MiLPBE",14,23,-9,"14 - 23",11,195,188,380,35344,38025,37,0.481729340729736,18,19,"18 - 19","#115376",2,5,"2030"
18,101,539,2030-07-06,1905,9,0,5,"SCSS","State College Swift Steeds ","home",0,1,"East Division","MiLPBE",14,24,-10,"14 - 24",2,197,188,385,35344,38809,38,0.476636144188367,18,20,"18 - 20","#115376",2,5,"2030"
18,101,542,2030-07-07,1905,9,0,2,"SCSS","State College Swift Steeds ","home",0,1,"East Division","MiLPBE",14,25,-11,"14 - 25",3,200,188,387,35344,40000,39,0.469101720110427,18,21,"18 - 21","#115376",2,5,"2030"
18,101,545,2030-07-08,1905,9,5,7,"SCSS","State College Swift Steeds ","home",1,0,"East Division","MiLPBE",15,25,-10,"15 - 25",3,203,193,394,37249,41209,40,0.474763567768743,19,21,"19 - 21","#115376",2,5,"2030"
18,101,548,2030-07-09,1905,9,4,12,"SCSS","State College Swift Steeds ","home",0,1,"East Division","MiLPBE",15,26,-11,"15 - 26",11,214,197,406,38809,45796,41,0.458708114177649,19,22,"19 - 22","#115376",2,5,"2030"
18,101,552,2030-07-11,1905,10,5,10,"SCSS","State College Swift Steeds ","away",1,0,"East Division","MiLPBE",16,26,-10,"16 - 26",3,217,202,416,40804,47089,42,0.464246299477774,19,23,"19 - 23","#115376",2,5,"2030"
18,101,555,2030-07-12,1905,9,14,16,"SCSS","State College Swift Steeds ","away",1,0,"East Division","MiLPBE",17,26,-9,"17 - 26",2,219,216,432,46656,47961,43,0.49310377627699,21,22,"21 - 22","#115376",2,5,"2030"
18,101,558,2030-07-13,1905,9,4,8,"SCSS","State College Swift Steeds ","away",0,1,"East Division","MiLPBE",17,27,-10,"17 - 27",6,225,220,440,48400,50625,44,0.488765463266852,22,22,"22 - 22","#115376",2,5,"2030"
18,101,562,2030-07-17,1905,9,6,7,"SCSS","State College Swift Steeds ","home",1,0,"East Division","MiLPBE",18,27,-9,"18 - 27",0,225,226,447,51076,50625,45,0.502217283999174,23,22,"23 - 22","#115376",2,5,"2030"
18,101,565,2030-07-18,1905,9,7,10,"SCSS","State College Swift Steeds ","home",0,1,"East Division","MiLPBE",18,28,-10,"18 - 28",8,233,233,457,54289,54289,46,0.5,23,23,"23 - 23","#115376",2,5,"2030"
18,101,568,2030-07-19,1905,9,2,4,"SCSS","State College Swift Steeds ","home",0,1,"East Division","MiLPBE",18,29,-11,"18 - 29",4,237,235,461,55225,56169,47,0.4957627879419,23,24,"23 - 24","#115376",2,5,"2030"
18,101,571,2030-07-20,1905,9,3,11,"SCSS","State College Swift Steeds ","home",0,1,"East Division","MiLPBE",18,30,-12,"18 - 30",6,243,238,472,56644,59049,48,0.489606112729379,24,24,"24 - 24","#115376",2,5,"2030"
18,101,572,2030-07-23,1905,9,10,13,"SCSS","State College Swift Steeds ","home",1,0,"East Division","MiLPBE",19,30,-11,"19 - 30",2,245,248,485,61504,60025,49,0.506084967374042,25,24,"25 - 24","#115376",2,5,"2030"
18,101,575,2030-07-24,1905,9,6,13,"SCSS","State College Swift Steeds ","home",1,0,"East Division","MiLPBE",20,30,-10,"20 - 30",0,245,254,498,64516,60025,50,0.518030206919809,26,24,"26 - 24","#115376",2,5,"2030"
18,101,578,2030-07-25,1905,9,3,8,"SCSS","State College Swift Steeds ","home",0,1,"East Division","MiLPBE",20,31,-11,"20 - 31",10,255,257,506,66049,65025,51,0.503906190396265,26,25,"26 - 25","#115376",2,5,"2030"
18,101,581,2030-07-26,1905,9,5,8,"SCSS","State College Swift Steeds ","home",0,1,"East Division","MiLPBE",20,32,-12,"20 - 32",8,263,262,514,68644,69169,52,0.498095245005914,26,26,"26 - 26","#115376",2,5,"2030"
18,101,586,2030-08-12,1905,9,6,8,"SCSS","State College Swift Steeds ","home",1,0,"East Division","MiLPBE",21,32,-11,"21 - 32",0,263,268,522,71824,69169,53,0.509415361046293,27,26,"27 - 26","#115376",2,5,"2030"
18,101,589,2030-08-13,1905,10,5,12,"SCSS","State College Swift Steeds ","home",1,0,"East Division","MiLPBE",22,32,-10,"22 - 32",4,267,273,534,74529,71289,54,0.511109739538329,28,26,"28 - 26","#115376",2,5,"2030"
18,101,592,2030-08-14,1905,9,2,7,"SCSS","State College Swift Steeds ","home",0,1,"East Division","MiLPBE",22,33,-11,"22 - 33",3,270,275,541,75625,72900,55,0.509173539808113,28,27,"28 - 27","#115376",2,5,"2030"
18,101,595,2030-08-15,1905,9,1,6,"SCSS","State College Swift Steeds ","home",0,1,"East Division","MiLPBE",22,34,-12,"22 - 34",2,272,276,547,76176,73984,56,0.507298881193394,28,28,"28 - 28","#115376",2,5,"2030"
18,101,597,2030-08-18,1905,9,8,16,"SCSS","State College Swift Steeds ","away",1,0,"East Division","MiLPBE",23,34,-11,"23 - 34",5,277,284,563,80656,76729,57,0.512475775963402,29,28,"29 - 28","#115376",2,5,"2030"
18,101,600,2030-08-19,1905,9,10,15,"SCSS","State College Swift Steeds ","away",1,0,"East Division","MiLPBE",24,34,-10,"24 - 34",1,278,294,578,86436,77284,58,0.52795015880772,31,27,"31 - 27","#115376",2,5,"2030"
18,101,603,2030-08-20,1905,9,4,6,"SCSS","State College Swift Steeds ","away",0,1,"East Division","MiLPBE",24,35,-11,"24 - 35",5,283,298,584,88804,80089,59,0.525800358807055,31,28,"31 - 28","#115376",2,5,"2030"
18,101,606,2030-08-21,1905,9,6,16,"SCSS","State College Swift Steeds ","away",1,0,"East Division","MiLPBE",25,35,-10,"25 - 35",5,288,304,600,92416,82944,60,0.527007299270073,32,28,"32 - 28","#115376",2,5,"2030"
18,101,608,2030-08-24,1905,9,3,11,"SCSS","State College Swift Steeds ","away",0,1,"East Division","MiLPBE",25,36,-11,"25 - 36",4,292,307,611,94249,85264,61,0.525026042682146,32,29,"32 - 29","#115376",2,5,"2030"
18,101,611,2030-08-25,1905,9,2,7,"SCSS","State College Swift Steeds ","away",1,0,"East Division","MiLPBE",26,36,-10,"26 - 36",1,293,309,618,95481,85849,62,0.526559311752054,33,29,"33 - 29","#115376",2,5,"2030"
18,101,614,2030-08-26,1905,9,2,8,"SCSS","State College Swift Steeds ","away",1,0,"East Division","MiLPBE",27,36,-9,"27 - 36",0,293,311,626,96721,85849,63,0.529774880867612,33,30,"33 - 30","#115376",2,5,"2030"
18,101,617,2030-08-27,1905,9,3,10,"SCSS","State College Swift Steeds ","away",0,1,"East Division","MiLPBE",27,37,-10,"27 - 37",4,297,314,636,98596,88209,64,0.527801718369423,34,30,"34 - 30","#115376",2,5,"2030"
18,101,621,2030-08-30,1905,9,1,7,"SCSS","State College Swift Steeds ","home",0,1,"East Division","MiLPBE",27,38,-11,"27 - 38",7,304,315,643,99225,92416,65,0.517764987659217,34,31,"34 - 31","#115376",2,5,"2030"
18,101,624,2030-08-31,1905,9,6,11,"SCSS","State College Swift Steeds ","home",1,0,"East Division","MiLPBE",28,38,-10,"28 - 38",1,305,321,654,103041,93025,66,0.525542419389389,35,31,"35 - 31","#115376",2,5,"2030"
18,101,627,2030-09-01,1905,9,9,9,"SCSS","State College Swift Steeds ","home",1,0,"East Division","MiLPBE",29,38,-9,"29 - 38",2,307,330,663,108900,94249,67,0.536059739403098,36,31,"36 - 31","#115376",2,5,"2030"
18,101,830,2030-09-02,1905,11,1,6,"SCSS","State College Swift Steeds ","home",0,1,"East Division","MiLPBE",29,39,-10,"29 - 39",2,309,331,669,109561,95481,68,0.534334429043806,36,32,"36 - 32","#115376",2,5,"2030"
18,101,834,2030-09-05,1905,9,6,10,"SCSS","State College Swift Steeds ","away",1,0,"East Division","MiLPBE",30,39,-9,"30 - 39",2,311,337,679,113569,96721,69,0.540058966189548,37,32,"37 - 32","#115376",2,5,"2030"
18,101,837,2030-09-06,1905,9,9,12,"SCSS","State College Swift Steeds ","away",1,0,"East Division","MiLPBE",31,39,-8,"31 - 39",4,315,346,691,119716,99225,70,0.546795712086818,38,32,"38 - 32","#115376",2,5,"2030"
18,101,840,2030-09-07,1905,9,3,14,"SCSS","State College Swift Steeds ","away",0,1,"East Division","MiLPBE",31,40,-9,"31 - 40",6,321,349,705,121801,103041,71,0.541718184324993,38,33,"38 - 33","#115376",2,5,"2030"
18,101,843,2030-09-08,1905,9,1,7,"SCSS","State College Swift Steeds ","away",0,1,"East Division","MiLPBE",31,41,-10,"31 - 41",3,324,350,712,122500,104976,72,0.538518349188486,39,33,"39 - 33","#115376",2,5,"2030"
18,101,846,2030-09-11,1905,9,8,8,"SCSS","State College Swift Steeds ","away",1,0,"East Division","MiLPBE",32,41,-9,"32 - 41",4,328,358,720,128164,107584,73,0.543648302424623,40,33,"40 - 33","#115376",2,5,"2030"
18,101,849,2030-09-12,1905,9,5,7,"SCSS","State College Swift Steeds ","away",1,0,"East Division","MiLPBE",33,41,-8,"33 - 41",3,331,363,727,131769,109561,74,0.546011685244271,40,34,"40 - 34","#115376",2,5,"2030"
18,101,852,2030-09-13,1905,9,13,15,"SCSS","State College Swift Steeds ","away",1,0,"East Division","MiLPBE",34,41,-7,"34 - 41",9,340,376,742,141376,115600,75,0.55015254342818,41,34,"41 - 34","#115376",2,5,"2030"
18,101,855,2030-09-14,1905,9,2,7,"SCSS","State College Swift Steeds ","away",0,1,"East Division","MiLPBE",34,42,-8,"34 - 42",10,350,378,749,142884,122500,76,0.538404726735598,41,35,"41 - 35","#115376",2,5,"2030"
18,101,857,2030-09-17,1905,9,3,9,"SCSS","State College Swift Steeds ","home",1,0,"East Division","MiLPBE",35,42,-7,"35 - 42",1,351,381,758,145161,123201,77,0.540914883627339,42,35,"42 - 35","#115376",2,5,"2030"
18,101,860,2030-09-18,1905,9,10,6,"SCSS","State College Swift Steeds ","home",1,0,"East Division","MiLPBE",36,42,-6,"36 - 42",4,355,391,764,152881,126025,78,0.548145253239443,43,35,"43 - 35","#115376",2,5,"2030"
18,101,863,2030-09-19,1905,9,8,16,"SCSS","State College Swift Steeds ","away",1,0,"East Division","MiLPBE",37,42,-5,"37 - 42",3,358,399,780,159201,128164,79,0.554002749116977,44,35,"44 - 35","#115376",2,5,"2030"
18,101,866,2030-09-20,1905,9,5,11,"SCSS","State College Swift Steeds ","away",0,1,"East Division","MiLPBE",37,43,-6,"37 - 43",10,368,404,791,163216,135424,80,0.546530940262523,44,36,"44 - 36","#115376",2,5,"2030"
18,101,868,2030-09-22,1905,9,11,15,"SCSS","State College Swift Steeds ","home",1,0,"East Division","MiLPBE",38,43,-5,"38 - 43",1,369,415,806,172225,136161,81,0.558472174482629,45,36,"45 - 36","#115376",2,5,"2030"
18,101,871,2030-09-23,1905,9,2,6,"SCSS","State College Swift Steeds ","home",0,1,"East Division","MiLPBE",38,44,-6,"38 - 44",7,376,417,812,173889,141376,82,0.551564556801421,45,37,"45 - 37","#115376",2,5,"2030"
18,101,874,2030-09-24,1905,9,1,7,"SCSS","State College Swift Steeds ","away",0,1,"East Division","MiLPBE",38,45,-7,"38 - 45",2,378,418,819,174724,142884,83,0.550124681997935,46,37,"46 - 37","#115376",2,5,"2030"
18,101,877,2030-09-25,1905,9,4,7,"SCSS","State College Swift Steeds ","away",0,1,"East Division","MiLPBE",38,46,-8,"38 - 46",9,387,422,826,178084,149769,84,0.54318246287208,46,38,"46 - 38","#115376",2,5,"2030"
18,101,881,2030-09-28,1905,9,4,8,"SCSS","State College Swift Steeds ","away",1,0,"East Division","MiLPBE",39,46,-7,"39 - 46",1,388,426,834,181476,150544,85,0.546581531233058,46,39,"46 - 39","#115376",2,5,"2030"
18,101,884,2030-09-29,1905,10,3,7,"SCSS","State College Swift Steeds ","away",0,1,"East Division","MiLPBE",39,47,-8,"39 - 47",4,392,429,841,184041,153664,86,0.544975644423387,47,39,"47 - 39","#115376",2,5,"2030"
18,101,887,2030-09-30,1905,9,5,11,"SCSS","State College Swift Steeds ","home",0,1,"East Division","MiLPBE",39,48,-9,"39 - 48",10,402,434,852,188356,161604,87,0.538221511029832,47,40,"47 - 40","#115376",2,5,"2030"
18,101,890,2030-10-01,1905,9,8,12,"SCSS","State College Swift Steeds ","home",1,0,"East Division","MiLPBE",40,48,-8,"40 - 48",7,409,442,864,195364,167281,88,0.538719684539977,47,41,"47 - 41","#115376",2,5,"2030"
18,101,894,2030-10-04,1905,9,1,8,"SCSS","State College Swift Steeds ","home",0,1,"East Division","MiLPBE",40,49,-9,"40 - 49",3,412,443,872,196249,169744,89,0.536209708928859,48,41,"48 - 41","#115376",2,5,"2030"
18,101,897,2030-10-05,1905,9,4,6,"SCSS","State College Swift Steeds ","home",1,0,"East Division","MiLPBE",41,49,-8,"41 - 49",3,415,447,878,199809,172225,90,0.537071880527049,48,42,"48 - 42","#115376",2,5,"2030"
18,101,900,2030-10-06,1905,9,3,8,"SCSS","State College Swift Steeds ","away",0,1,"East Division","MiLPBE",41,50,-9,"41 - 50",6,421,450,886,202500,177241,91,0.533258194400921,49,42,"49 - 42","#115376",2,5,"2030"
19,101,304,2030-05-15,1905,9,7,14,"ARM","Amarillo Armadillos","away",1,0,"West Division","MiLPBE",1,0,1,"1 - 0",2,2,7,14,49,4,1,0.924528301886792,1,0,"1 - 0","#86572C",1,1,"2030"
19,101,307,2030-05-16,1905,9,0,11,"ARM","Amarillo Armadillos","away",0,1,"West Division","MiLPBE",1,1,0,"1 - 1",5,7,7,25,49,49,2,0.5,1,1,"1 - 1","#86572C",1,1,"2030"
19,101,310,2030-05-17,1905,9,4,10,"ARM","Amarillo Armadillos","away",0,1,"West Division","MiLPBE",1,2,-1,"1 - 2",6,13,11,35,121,169,3,0.417241379310345,1,2,"1 - 2","#86572C",1,1,"2030"
19,101,313,2030-05-18,1905,9,6,9,"ARM","Amarillo Armadillos","away",1,0,"West Division","MiLPBE",2,2,0,"2 - 2",5,18,17,44,289,324,4,0.471451876019576,2,2,"2 - 2","#86572C",1,1,"2030"
19,101,316,2030-05-20,1905,11,2,7,"ARM","Amarillo Armadillos","away",1,0,"West Division","MiLPBE",3,2,1,"3 - 2",0,18,19,51,361,324,5,0.527007299270073,3,2,"3 - 2","#86572C",1,1,"2030"
19,101,319,2030-05-21,1905,9,8,13,"ARM","Amarillo Armadillos","away",1,0,"West Division","MiLPBE",4,2,2,"4 - 2",3,21,27,64,729,441,6,0.623076923076923,4,2,"4 - 2","#86572C",1,1,"2030"
19,101,322,2030-05-22,1905,9,8,13,"ARM","Amarillo Armadillos","away",1,0,"West Division","MiLPBE",5,2,3,"5 - 2",3,24,35,77,1225,576,7,0.680177679067185,5,2,"5 - 2","#86572C",1,1,"2030"
19,101,325,2030-05-23,1905,9,8,11,"ARM","Amarillo Armadillos","away",1,0,"West Division","MiLPBE",6,2,4,"6 - 2",3,27,43,88,1849,729,8,0.71722265321955,6,2,"6 - 2","#86572C",1,1,"2030"
19,101,327,2030-05-26,1905,9,6,13,"ARM","Amarillo Armadillos","away",1,0,"West Division","MiLPBE",7,2,5,"7 - 2",2,29,49,101,2401,841,9,0.740592227020358,7,2,"7 - 2","#86572C",1,1,"2030"
19,101,330,2030-05-27,1905,9,1,7,"ARM","Amarillo Armadillos","away",0,1,"West Division","MiLPBE",7,3,4,"7 - 3",3,32,50,108,2500,1024,10,0.709421112372304,7,3,"7 - 3","#86572C",1,1,"2030"
19,101,333,2030-05-28,1905,9,2,9,"ARM","Amarillo Armadillos","away",0,1,"West Division","MiLPBE",7,4,3,"7 - 4",6,38,52,117,2704,1444,11,0.651880424300868,7,4,"7 - 4","#86572C",1,1,"2030"
19,101,336,2030-05-29,1905,9,8,14,"ARM","Amarillo Armadillos","away",1,0,"West Division","MiLPBE",8,4,4,"8 - 4",7,45,60,131,3600,2025,12,0.64,8,4,"8 - 4","#86572C",1,1,"2030"
19,101,338,2030-06-01,1905,9,6,10,"ARM","Amarillo Armadillos","away",1,0,"West Division","MiLPBE",9,4,5,"9 - 4",3,48,66,141,4356,2304,13,0.654054054054054,9,4,"9 - 4","#86572C",1,1,"2030"
19,101,341,2030-06-02,1905,9,7,11,"ARM","Amarillo Armadillos","away",1,0,"West Division","MiLPBE",10,4,6,"10 - 4",3,51,73,152,5329,2601,14,0.672005044136192,9,5,"9 - 5","#86572C",1,1,"2030"
19,101,344,2030-06-03,1905,9,0,9,"ARM","Amarillo Armadillos","away",0,1,"West Division","MiLPBE",10,5,5,"10 - 5",11,62,73,161,5329,3844,15,0.580944075002725,9,6,"9 - 6","#86572C",1,1,"2030"
19,101,347,2030-06-04,1905,9,4,12,"ARM","Amarillo Armadillos","away",0,1,"West Division","MiLPBE",10,6,4,"10 - 6",7,69,77,173,5929,4761,16,0.554630495790458,9,7,"9 - 7","#86572C",1,1,"2030"
19,101,351,2030-06-07,1905,9,2,6,"ARM","Amarillo Armadillos","away",0,1,"West Division","MiLPBE",10,7,3,"10 - 7",3,72,79,179,6241,5184,17,0.546258205689278,9,8,"9 - 8","#86572C",1,1,"2030"
19,101,354,2030-06-08,1905,9,7,13,"ARM","Amarillo Armadillos","away",1,0,"West Division","MiLPBE",11,7,4,"11 - 7",4,76,86,192,7396,5776,18,0.561494078348011,10,8,"10 - 8","#86572C",1,1,"2030"
19,101,357,2030-06-09,1905,9,1,8,"ARM","Amarillo Armadillos","away",0,1,"West Division","MiLPBE",11,8,3,"11 - 8",7,83,87,200,7569,6889,19,0.523516392308756,10,9,"10 - 9","#86572C",1,1,"2030"
19,101,360,2030-06-10,1905,9,0,4,"ARM","Amarillo Armadillos","away",0,1,"West Division","MiLPBE",11,9,2,"11 - 9",3,86,87,204,7569,7396,20,0.505780153691948,10,10,"10 - 10","#86572C",1,1,"2030"
19,101,364,2030-06-13,1905,9,2,6,"ARM","Amarillo Armadillos","home",0,1,"West Division","MiLPBE",11,10,1,"11 - 10",5,91,89,210,7921,8281,21,0.488890260461671,10,11,"10 - 11","#86572C",1,1,"2030"
19,101,367,2030-06-14,1905,9,6,14,"ARM","Amarillo Armadillos","home",0,1,"West Division","MiLPBE",11,11,0,"11 - 11",7,98,95,224,9025,9604,22,0.484459713350153,11,11,"11 - 11","#86572C",1,1,"2030"
19,101,370,2030-06-15,1905,10,5,10,"ARM","Amarillo Armadillos","home",0,1,"West Division","MiLPBE",11,12,-1,"11 - 12",6,104,100,234,10000,10816,23,0.480399692544197,11,12,"11 - 12","#86572C",1,1,"2030"
19,101,373,2030-06-16,1905,9,5,10,"ARM","Amarillo Armadillos","home",0,1,"West Division","MiLPBE",11,13,-2,"11 - 13",6,110,105,244,11025,12100,24,0.476756756756757,11,13,"11 - 13","#86572C",1,1,"2030"
19,101,376,2030-06-19,1905,9,3,10,"ARM","Amarillo Armadillos","home",0,1,"West Division","MiLPBE",11,14,-3,"11 - 14",5,115,108,254,11664,13225,25,0.468640764996585,12,13,"12 - 13","#86572C",1,1,"2030"
19,101,379,2030-06-20,1905,9,7,11,"ARM","Amarillo Armadillos","home",1,0,"West Division","MiLPBE",12,14,-2,"12 - 14",4,119,115,265,13225,14161,26,0.482910976411305,13,13,"13 - 13","#86572C",1,1,"2030"
19,101,508,2030-06-21,1905,9,2,9,"ARM","Amarillo Armadillos","home",0,1,"West Division","MiLPBE",12,15,-3,"12 - 15",6,125,117,274,13689,15625,27,0.466978235655318,13,14,"13 - 14","#86572C",1,1,"2030"
19,101,511,2030-06-22,1905,9,7,13,"ARM","Amarillo Armadillos","home",0,1,"West Division","MiLPBE",12,16,-4,"12 - 16",9,134,124,287,15376,17956,28,0.461298451938078,13,15,"13 - 15","#86572C",1,1,"2030"
19,101,514,2030-07-14,1405,9,5,14,"ARM","Amarillo Armadillos","away",1,0,"West Division","MiLPBE",13,16,-3,"13 - 16",3,137,129,301,16641,18769,29,0.469951990963005,14,15,"14 - 15","#86572C",1,1,"2030"
19,101,516,2030-06-24,1905,9,6,10,"ARM","Amarillo Armadillos","home",1,0,"West Division","MiLPBE",14,16,-2,"14 - 16",1,138,135,311,18225,19044,30,0.489012315865733,15,15,"15 - 15","#86572C",1,1,"2030"
19,101,519,2030-06-25,1905,9,11,18,"ARM","Amarillo Armadillos","home",1,0,"West Division","MiLPBE",15,16,-1,"15 - 16",0,138,146,329,21316,19044,31,0.52814667988107,16,15,"16 - 15","#86572C",1,1,"2030"
19,101,522,2030-06-26,1905,9,1,8,"ARM","Amarillo Armadillos","home",0,1,"West Division","MiLPBE",15,17,-2,"15 - 17",8,146,147,337,21609,21316,32,0.503412929528247,16,16,"16 - 16","#86572C",1,1,"2030"
19,101,525,2030-06-27,1905,9,6,8,"ARM","Amarillo Armadillos","home",1,0,"West Division","MiLPBE",16,17,-1,"16 - 17",2,148,153,345,23409,21904,33,0.516606713305232,17,16,"17 - 16","#86572C",1,1,"2030"
19,101,527,2030-06-30,1905,9,3,7,"ARM","Amarillo Armadillos","home",0,1,"West Division","MiLPBE",16,18,-2,"16 - 18",4,152,156,352,24336,23104,34,0.512984822934233,17,17,"17 - 17","#86572C",1,1,"2030"
19,101,530,2030-07-01,1905,9,8,15,"ARM","Amarillo Armadillos","home",1,0,"West Division","MiLPBE",17,18,-1,"17 - 18",3,155,164,367,26896,24025,35,0.528190726812121,18,17,"18 - 17","#86572C",1,1,"2030"
19,101,533,2030-07-02,1905,9,6,10,"ARM","Amarillo Armadillos","home",1,0,"West Division","MiLPBE",18,18,0,"18 - 18",0,155,170,377,28900,24025,36,0.546055739253661,20,16,"20 - 16","#86572C",1,1,"2030"
19,101,536,2030-07-03,1905,9,6,7,"ARM","Amarillo Armadillos","home",1,0,"West Division","MiLPBE",19,18,1,"19 - 18",1,156,176,384,30976,24336,37,0.560023141452126,21,16,"21 - 16","#86572C",1,1,"2030"
19,101,540,2030-07-06,1905,9,3,10,"ARM","Amarillo Armadillos","home",1,0,"West Division","MiLPBE",20,18,2,"20 - 18",1,157,179,394,32041,24649,38,0.565196683718469,21,17,"21 - 17","#86572C",1,1,"2030"
19,101,543,2030-07-07,1905,11,1,7,"ARM","Amarillo Armadillos","home",0,1,"West Division","MiLPBE",20,19,1,"20 - 19",2,159,180,401,32400,25281,39,0.561710095178655,22,17,"22 - 17","#86572C",1,1,"2030"
19,101,546,2030-07-08,1905,9,3,9,"ARM","Amarillo Armadillos","home",1,0,"West Division","MiLPBE",21,19,2,"21 - 19",1,160,183,410,33489,25600,40,0.566755233630625,23,17,"23 - 17","#86572C",1,1,"2030"
19,101,549,2030-07-09,1905,9,6,10,"ARM","Amarillo Armadillos","home",1,0,"West Division","MiLPBE",22,19,3,"22 - 19",4,164,189,420,35721,26896,41,0.570468083747225,23,18,"23 - 18","#86572C",1,1,"2030"
19,101,553,2030-07-11,1905,9,4,5,"ARM","Amarillo Armadillos","away",0,1,"West Division","MiLPBE",22,20,2,"22 - 20",5,169,193,425,37249,28561,42,0.566008205439903,24,18,"24 - 18","#86572C",1,1,"2030"
19,101,556,2030-07-12,1905,9,6,12,"ARM","Amarillo Armadillos","away",1,0,"West Division","MiLPBE",23,20,3,"23 - 20",1,170,199,437,39601,28900,43,0.578108348783229,25,18,"25 - 18","#86572C",1,1,"2030"
19,101,559,2030-07-13,1905,9,6,12,"ARM","Amarillo Armadillos","away",1,0,"West Division","MiLPBE",24,20,4,"24 - 20",3,173,205,449,42025,29929,44,0.584053700975623,26,18,"26 - 18","#86572C",1,1,"2030"
19,101,562,2030-07-17,1905,9,0,3,"ARM","Amarillo Armadillos","away",0,1,"West Division","MiLPBE",24,21,3,"24 - 21",6,179,205,452,42025,32041,45,0.567399346528772,26,19,"26 - 19","#86572C",1,1,"2030"
19,101,565,2030-07-18,1905,9,8,15,"ARM","Amarillo Armadillos","away",1,0,"West Division","MiLPBE",25,21,4,"25 - 21",7,186,213,467,45369,34596,46,0.567360720315138,26,20,"26 - 20","#86572C",1,1,"2030"
19,101,568,2030-07-19,1905,9,4,7,"ARM","Amarillo Armadillos","away",1,0,"West Division","MiLPBE",26,21,5,"26 - 21",2,188,217,474,47089,35344,47,0.571239673431757,27,20,"27 - 20","#86572C",1,1,"2030"
19,101,571,2030-07-20,1905,9,6,12,"ARM","Amarillo Armadillos","away",1,0,"West Division","MiLPBE",27,21,6,"27 - 21",3,191,223,486,49729,36481,48,0.576835633917179,28,20,"28 - 20","#86572C",1,1,"2030"
19,101,573,2030-07-23,1905,9,3,14,"ARM","Amarillo Armadillos","home",1,0,"West Division","MiLPBE",28,21,7,"28 - 21",0,191,226,500,51076,36481,49,0.583345706225659,29,20,"29 - 20","#86572C",1,1,"2030"
19,101,576,2030-07-24,1905,10,6,11,"ARM","Amarillo Armadillos","home",1,0,"West Division","MiLPBE",29,21,8,"29 - 21",5,196,232,511,53824,38416,50,0.583521248915872,29,21,"29 - 21","#86572C",1,1,"2030"
19,101,579,2030-07-25,1905,9,3,10,"ARM","Amarillo Armadillos","home",0,1,"West Division","MiLPBE",29,22,7,"29 - 22",4,200,235,521,55225,40000,51,0.579942242058283,30,21,"30 - 21","#86572C",1,1,"2030"
19,101,582,2030-07-26,1905,9,7,14,"ARM","Amarillo Armadillos","home",1,0,"West Division","MiLPBE",30,22,8,"30 - 22",2,202,242,535,58564,40804,52,0.589364785444006,31,21,"31 - 21","#86572C",1,1,"2030"
19,101,585,2030-08-12,1905,9,6,12,"ARM","Amarillo Armadillos","away",1,0,"West Division","MiLPBE",31,22,9,"31 - 22",3,205,248,547,61504,42025,53,0.594075090071381,31,22,"31 - 22","#86572C",1,1,"2030"
19,101,588,2030-08-13,1905,9,2,10,"ARM","Amarillo Armadillos","away",0,1,"West Division","MiLPBE",31,23,8,"31 - 23",9,214,250,557,62500,45796,54,0.577121962029992,31,23,"31 - 23","#86572C",1,1,"2030"
19,101,591,2030-08-14,1905,9,6,12,"ARM","Amarillo Armadillos","away",1,0,"West Division","MiLPBE",32,23,9,"32 - 23",4,218,256,569,65536,47524,55,0.579656819387936,32,23,"32 - 23","#86572C",1,1,"2030"
19,101,594,2030-08-15,1905,10,7,14,"ARM","Amarillo Armadillos","away",0,1,"West Division","MiLPBE",32,24,8,"32 - 24",8,226,263,583,69169,51076,56,0.575233897459354,32,24,"32 - 24","#86572C",1,1,"2030"
19,101,596,2030-08-18,1905,9,0,7,"ARM","Amarillo Armadillos","away",0,1,"West Division","MiLPBE",32,25,7,"32 - 25",4,230,263,590,69169,52900,57,0.566638540497587,32,25,"32 - 25","#86572C",1,1,"2030"
19,101,599,2030-08-19,1905,9,4,12,"ARM","Amarillo Armadillos","away",1,0,"West Division","MiLPBE",33,25,8,"33 - 25",1,231,267,602,71289,53361,58,0.571913357400722,33,25,"33 - 25","#86572C",1,1,"2030"
19,101,602,2030-08-20,1905,9,0,4,"ARM","Amarillo Armadillos","away",0,1,"West Division","MiLPBE",33,26,7,"33 - 26",2,233,267,606,71289,54289,59,0.567687015241523,33,26,"33 - 26","#86572C",1,1,"2030"
19,101,605,2030-08-21,1905,9,1,10,"ARM","Amarillo Armadillos","away",0,1,"West Division","MiLPBE",33,27,6,"33 - 27",2,235,268,616,71824,55225,60,0.565325189493817,34,26,"34 - 26","#86572C",1,1,"2030"
19,101,609,2030-08-24,1905,9,4,12,"ARM","Amarillo Armadillos","away",1,0,"West Division","MiLPBE",34,27,7,"34 - 27",3,238,272,628,73984,56644,61,0.566371681415929,35,26,"35 - 26","#86572C",1,1,"2030"
19,101,612,2030-08-25,1905,9,2,7,"ARM","Amarillo Armadillos","away",0,1,"West Division","MiLPBE",34,28,6,"34 - 28",6,244,274,635,75076,59536,62,0.557721451282204,35,27,"35 - 27","#86572C",1,1,"2030"
19,101,615,2030-08-26,1905,9,8,9,"ARM","Amarillo Armadillos","away",1,0,"West Division","MiLPBE",35,28,7,"35 - 28",4,248,282,644,79524,61504,63,0.563888022236719,36,27,"36 - 27","#86572C",1,1,"2030"
19,101,618,2030-08-27,1905,9,2,8,"ARM","Amarillo Armadillos","away",0,1,"West Division","MiLPBE",35,29,6,"35 - 29",4,252,284,652,80656,63504,64,0.559489456159822,36,28,"36 - 28","#86572C",1,1,"2030"
19,101,622,2030-08-30,1905,9,7,9,"ARM","Amarillo Armadillos","home",1,0,"West Division","MiLPBE",36,29,7,"36 - 29",3,255,291,661,84681,65025,65,0.565648671395936,37,28,"37 - 28","#86572C",1,1,"2030"
19,101,625,2030-08-31,1905,9,6,11,"ARM","Amarillo Armadillos","home",0,1,"West Division","MiLPBE",36,30,6,"36 - 30",8,263,297,672,88209,69169,66,0.560491301198389,37,29,"37 - 29","#86572C",1,1,"2030"
19,101,828,2030-09-01,1905,9,1,6,"ARM","Amarillo Armadillos","home",0,1,"West Division","MiLPBE",36,31,5,"36 - 31",2,265,298,678,88804,70225,67,0.558413874199045,37,30,"37 - 30","#86572C",1,1,"2030"
19,101,831,2030-09-02,1905,9,7,10,"ARM","Amarillo Armadillos","home",1,0,"West Division","MiLPBE",37,31,6,"37 - 31",0,265,305,688,93025,70225,68,0.569831546707504,39,29,"39 - 29","#86572C",1,1,"2030"
19,101,834,2030-09-05,1905,9,2,11,"ARM","Amarillo Armadillos","home",0,1,"West Division","MiLPBE",37,32,5,"37 - 32",6,271,307,699,94249,73441,69,0.56204305563838,39,30,"39 - 30","#86572C",1,1,"2030"
19,101,837,2030-09-06,1905,9,4,10,"ARM","Amarillo Armadillos","home",0,1,"West Division","MiLPBE",37,33,4,"37 - 33",9,280,311,709,96721,78400,70,0.552309545971071,39,31,"39 - 31","#86572C",1,1,"2030"
19,101,840,2030-09-07,1905,9,6,8,"ARM","Amarillo Armadillos","home",1,0,"West Division","MiLPBE",38,33,5,"38 - 33",3,283,317,717,100489,80089,71,0.556485286136739,40,31,"40 - 31","#86572C",1,1,"2030"
19,101,843,2030-09-08,1905,9,3,8,"ARM","Amarillo Armadillos","home",1,0,"West Division","MiLPBE",39,33,6,"39 - 33",1,284,320,725,102400,80656,72,0.559391661568045,40,32,"40 - 32","#86572C",1,1,"2030"
19,101,845,2030-09-11,1905,11,3,7,"ARM","Amarillo Armadillos","home",0,1,"West Division","MiLPBE",39,34,5,"39 - 34",5,289,323,732,104329,83521,73,0.555384615384615,41,32,"41 - 32","#86572C",1,1,"2030"
19,101,848,2030-09-12,1905,9,1,8,"ARM","Amarillo Armadillos","home",0,1,"West Division","MiLPBE",39,35,4,"39 - 35",6,295,324,740,104976,87025,74,0.546747152358582,40,34,"40 - 34","#86572C",1,1,"2030"
19,101,851,2030-09-13,1905,9,5,10,"ARM","Amarillo Armadillos","home",1,0,"West Division","MiLPBE",40,35,5,"40 - 35",4,299,329,750,108241,89401,75,0.547661934204268,41,34,"41 - 34","#86572C",1,1,"2030"
19,101,854,2030-09-14,1905,10,4,13,"ARM","Amarillo Armadillos","home",1,0,"West Division","MiLPBE",41,35,6,"41 - 35",3,302,333,763,110889,91204,76,0.548702824937034,42,34,"42 - 34","#86572C",1,1,"2030"
19,101,856,2030-09-17,1905,9,2,8,"ARM","Amarillo Armadillos","home",1,0,"West Division","MiLPBE",42,35,7,"42 - 35",0,302,335,771,112225,91204,77,0.551666674859533,42,35,"42 - 35","#86572C",1,1,"2030"
19,101,859,2030-09-18,1905,9,8,11,"ARM","Amarillo Armadillos","home",1,0,"West Division","MiLPBE",43,35,8,"43 - 35",2,304,343,782,117649,92416,78,0.560059981434318,44,34,"44 - 34","#86572C",1,1,"2030"
19,101,862,2030-09-19,1905,9,11,16,"ARM","Amarillo Armadillos","away",1,0,"West Division","MiLPBE",44,35,9,"44 - 35",1,305,354,798,125316,93025,79,0.57394625837566,45,34,"45 - 34","#86572C",1,1,"2030"
19,101,865,2030-09-20,1905,9,0,5,"ARM","Amarillo Armadillos","away",0,1,"West Division","MiLPBE",44,36,8,"44 - 36",2,307,354,803,125316,94249,80,0.570746703709608,46,34,"46 - 34","#86572C",1,1,"2030"
19,101,869,2030-09-22,1905,9,2,5,"ARM","Amarillo Armadillos","home",0,1,"West Division","MiLPBE",44,37,7,"44 - 37",6,313,356,808,126736,97969,81,0.564010591664627,46,35,"46 - 35","#86572C",1,1,"2030"
19,101,872,2030-09-23,1905,9,12,16,"ARM","Amarillo Armadillos","home",1,0,"West Division","MiLPBE",45,37,8,"45 - 37",6,319,368,824,135424,101761,82,0.570963593819171,47,35,"47 - 35","#86572C",1,1,"2030"
19,101,875,2030-09-24,1905,9,3,5,"ARM","Amarillo Armadillos","away",0,1,"West Division","MiLPBE",45,38,7,"45 - 38",5,324,371,829,137641,104976,83,0.56731803624643,47,36,"47 - 36","#86572C",1,1,"2030"
19,101,878,2030-09-25,1905,9,2,11,"ARM","Amarillo Armadillos","away",1,0,"West Division","MiLPBE",46,38,8,"46 - 38",1,325,373,840,139129,105625,84,0.568444233802103,48,36,"48 - 36","#86572C",1,1,"2030"
19,101,882,2030-09-28,1905,9,4,9,"ARM","Amarillo Armadillos","away",0,1,"West Division","MiLPBE",46,39,7,"46 - 39",5,330,377,849,142129,108900,85,0.566185580152094,48,37,"48 - 37","#86572C",1,1,"2030"
19,101,885,2030-09-29,1905,9,14,16,"ARM","Amarillo Armadillos","away",1,0,"West Division","MiLPBE",47,39,8,"47 - 39",8,338,391,865,152881,114244,86,0.572320074871315,49,37,"49 - 37","#86572C",1,1,"2030"
19,101,888,2030-09-30,1905,9,5,9,"ARM","Amarillo Armadillos","home",0,1,"West Division","MiLPBE",47,40,7,"47 - 40",10,348,396,874,156816,121104,87,0.564248704663212,49,38,"49 - 38","#86572C",1,1,"2030"
19,101,891,2030-10-01,1905,9,4,7,"ARM","Amarillo Armadillos","home",1,0,"West Division","MiLPBE",48,40,8,"48 - 40",3,351,400,881,160000,123201,88,0.564969756462724,50,38,"50 - 38","#86572C",1,1,"2030"
19,101,894,2030-10-04,1905,9,3,9,"ARM","Amarillo Armadillos","away",1,0,"West Division","MiLPBE",49,40,9,"49 - 40",1,352,403,890,162409,123904,89,0.567242842623283,50,39,"50 - 39","#86572C",1,1,"2030"
19,101,897,2030-10-05,1905,9,3,4,"ARM","Amarillo Armadillos","away",0,1,"West Division","MiLPBE",49,41,8,"49 - 41",4,356,406,894,164836,126736,90,0.565335491748179,51,39,"51 - 39","#86572C",1,1,"2030"
19,101,900,2030-10-06,1905,9,6,12,"ARM","Amarillo Armadillos","home",1,0,"West Division","MiLPBE",50,41,9,"50 - 41",3,359,412,906,169744,128881,91,0.568418585182085,52,39,"52 - 39","#86572C",1,1,"2030"
24,100,1,2030-05-15,1905,9,1,8,"FL","Florida Space Rangers","home",1,0,"Eastern Division","PBE",1,0,1,"1 - 0",0,0,1,8,1,0,1,1,1,0,"1 - 0","#D0D02B",1,3,"2030"
24,100,6,2030-05-16,1905,9,6,13,"FL","Florida Space Rangers","home",0,1,"Eastern Division","PBE",1,1,0,"1 - 1",7,7,7,21,49,49,2,0.5,1,1,"1 - 1","#D0D02B",1,3,"2030"
24,100,11,2030-05-17,1905,9,3,11,"FL","Florida Space Rangers","home",0,1,"Eastern Division","PBE",1,2,-1,"1 - 2",4,11,10,32,100,121,3,0.452488687782805,1,2,"1 - 2","#D0D02B",1,3,"2030"
24,100,16,2030-05-18,1905,9,8,12,"FL","Florida Space Rangers","home",1,0,"Eastern Division","PBE",2,2,0,"2 - 2",4,15,18,44,324,225,4,0.590163934426229,2,2,"2 - 2","#D0D02B",1,3,"2030"
24,100,21,2030-05-21,1905,9,7,10,"FL","Florida Space Rangers","home",1,0,"Eastern Division","PBE",3,2,1,"3 - 2",3,18,25,54,625,324,5,0.658587987355111,3,2,"3 - 2","#D0D02B",1,3,"2030"
24,100,26,2030-05-22,1905,9,7,10,"FL","Florida Space Rangers","home",1,0,"Eastern Division","PBE",4,2,2,"4 - 2",4,22,32,64,1024,484,6,0.679045092838196,4,2,"4 - 2","#D0D02B",1,3,"2030"
24,100,31,2030-05-23,1905,9,2,5,"FL","Florida Space Rangers","home",0,1,"Eastern Division","PBE",4,3,1,"4 - 3",3,25,34,69,1156,625,7,0.649073554183043,5,2,"5 - 2","#D0D02B",1,3,"2030"
24,100,42,2030-05-26,1905,9,0,6,"FL","Florida Space Rangers","away",0,1,"Eastern Division","PBE",4,4,0,"4 - 4",6,31,34,75,1156,961,8,0.546055739253661,4,4,"4 - 4","#D0D02B",1,3,"2030"
24,100,46,2030-05-27,1905,9,2,5,"FL","Florida Space Rangers","away",0,1,"Eastern Division","PBE",4,5,-1,"4 - 5",13,44,36,80,1296,1936,9,0.400990099009901,4,5,"4 - 5","#D0D02B",1,3,"2030"
24,100,51,2030-05-28,1905,9,8,6,"FL","Florida Space Rangers","away",1,0,"Eastern Division","PBE",5,5,0,"5 - 5",7,51,44,86,1936,2601,10,0.426713687458673,4,6,"4 - 6","#D0D02B",1,3,"2030"
24,100,56,2030-05-29,1905,9,5,9,"FL","Florida Space Rangers","away",0,1,"Eastern Division","PBE",5,6,-1,"5 - 6",6,57,49,95,2401,3249,11,0.424955752212389,5,6,"5 - 6","#D0D02B",1,3,"2030"
24,100,60,2030-06-01,1905,9,5,10,"FL","Florida Space Rangers","home",1,0,"Eastern Division","PBE",6,6,0,"6 - 6",2,59,54,105,2916,3481,12,0.455838674378615,5,7,"5 - 7","#D0D02B",1,3,"2030"
24,100,65,2030-06-02,1905,9,4,7,"FL","Florida Space Rangers","home",1,0,"Eastern Division","PBE",7,6,1,"7 - 6",1,60,58,112,3364,3600,13,0.483055715106261,6,7,"6 - 7","#D0D02B",1,3,"2030"
24,100,70,2030-06-03,1905,9,4,7,"FL","Florida Space Rangers","home",1,0,"Eastern Division","PBE",8,6,2,"8 - 6",1,61,62,119,3844,3721,14,0.508129543952412,7,7,"7 - 7","#D0D02B",1,3,"2030"
24,100,75,2030-06-04,1905,9,6,11,"FL","Florida Space Rangers","home",1,0,"Eastern Division","PBE",9,6,3,"9 - 6",5,66,68,130,4624,4356,15,0.514922048997773,8,7,"8 - 7","#D0D02B",1,3,"2030"
24,100,80,2030-06-06,1905,9,10,15,"FL","Florida Space Rangers","away",1,0,"Eastern Division","PBE",10,6,4,"10 - 6",1,67,78,145,6084,4489,16,0.575427976922349,9,7,"9 - 7","#D0D02B",1,3,"2030"
24,100,84,2030-06-07,1905,9,7,13,"FL","Florida Space Rangers","away",1,0,"Eastern Division","PBE",11,6,5,"11 - 6",3,70,85,158,7225,4900,17,0.595876288659794,10,7,"10 - 7","#D0D02B",1,3,"2030"
24,100,89,2030-06-08,1905,9,6,16,"FL","Florida Space Rangers","away",1,0,"Eastern Division","PBE",12,6,6,"12 - 6",4,74,91,174,8281,5476,18,0.601948099149524,11,7,"11 - 7","#D0D02B",1,3,"2030"
24,100,98,2030-06-11,1905,9,6,7,"FL","Florida Space Rangers","away",1,0,"Eastern Division","PBE",13,6,7,"13 - 6",0,74,97,181,9409,5476,19,0.632112865300638,12,7,"12 - 7","#D0D02B",1,3,"2030"
24,100,103,2030-06-12,1905,9,9,9,"FL","Florida Space Rangers","away",1,0,"Eastern Division","PBE",14,6,8,"14 - 6",1,75,106,190,11236,5625,20,0.666389893837851,13,7,"13 - 7","#D0D02B",1,3,"2030"
24,100,108,2030-06-13,1905,9,8,11,"FL","Florida Space Rangers","away",1,0,"Eastern Division","PBE",15,6,9,"15 - 6",2,77,114,201,12996,5929,21,0.6867107001321,14,7,"14 - 7","#D0D02B",1,3,"2030"
24,100,112,2030-06-14,1905,9,4,8,"FL","Florida Space Rangers","away",1,0,"Eastern Division","PBE",16,6,10,"16 - 6",3,80,118,209,13924,6400,22,0.685101358000394,15,7,"15 - 7","#D0D02B",1,3,"2030"
24,100,116,2030-06-16,1905,9,7,11,"FL","Florida Space Rangers","away",1,0,"Eastern Division","PBE",17,6,11,"17 - 6",6,86,125,220,15625,7396,23,0.678728117805482,16,7,"16 - 7","#D0D02B",1,3,"2030"
24,100,120,2030-06-17,1905,9,7,9,"FL","Florida Space Rangers","away",1,0,"Eastern Division","PBE",18,6,12,"18 - 6",2,88,132,229,17424,7744,24,0.692307692307692,17,7,"17 - 7","#D0D02B",1,3,"2030"
24,100,125,2030-06-18,1905,9,5,9,"FL","Florida Space Rangers","away",0,1,"Eastern Division","PBE",18,7,11,"18 - 7",7,95,137,238,18769,9025,25,0.67528963085558,17,8,"17 - 8","#D0D02B",1,3,"2030"
24,100,130,2030-06-19,1905,9,0,5,"FL","Florida Space Rangers","away",0,1,"Eastern Division","PBE",18,8,10,"18 - 8",2,97,137,243,18769,9409,26,0.666087018241181,17,9,"17 - 9","#D0D02B",1,3,"2030"
24,100,135,2030-06-22,1905,9,8,16,"FL","Florida Space Rangers","away",1,0,"Eastern Division","PBE",19,8,11,"19 - 8",7,104,145,259,21025,10816,27,0.660312176125122,18,9,"18 - 9","#D0D02B",1,3,"2030"
24,100,140,2030-06-23,1905,9,6,9,"FL","Florida Space Rangers","away",1,0,"Eastern Division","PBE",20,8,12,"20 - 8",2,106,151,268,22801,11236,28,0.669888650586127,19,9,"19 - 9","#D0D02B",1,3,"2030"
24,100,145,2030-06-24,1905,9,5,8,"FL","Florida Space Rangers","away",0,1,"Eastern Division","PBE",20,9,11,"20 - 9",11,117,156,276,24336,13689,29,0.64,19,10,"19 - 10","#D0D02B",1,3,"2030"
24,100,150,2030-06-25,1905,9,3,10,"FL","Florida Space Rangers","away",0,1,"Eastern Division","PBE",20,10,10,"20 - 10",4,121,159,286,25281,14641,30,0.633259856720605,19,11,"19 - 11","#D0D02B",1,3,"2030"
24,100,155,2030-06-27,1905,9,7,8,"FL","Florida Space Rangers","home",1,0,"Eastern Division","PBE",21,10,11,"21 - 10",6,127,166,294,27556,16129,31,0.63078860020602,20,11,"20 - 11","#D0D02B",1,3,"2030"
24,100,159,2030-06-28,1905,9,2,8,"FL","Florida Space Rangers","home",1,0,"Eastern Division","PBE",22,10,12,"22 - 10",1,128,168,302,28224,16384,32,0.632711621233859,20,12,"20 - 12","#D0D02B",1,3,"2030"
24,100,164,2030-06-29,1905,10,6,10,"FL","Florida Space Rangers","home",0,1,"Eastern Division","PBE",22,11,11,"22 - 11",7,135,174,312,30276,18225,33,0.62423455186491,21,12,"21 - 12","#D0D02B",1,3,"2030"
24,100,169,2030-06-30,1905,9,2,5,"FL","Florida Space Rangers","home",0,1,"Eastern Division","PBE",22,12,10,"22 - 12",5,140,176,317,30976,19600,34,0.612464409996836,21,13,"21 - 13","#D0D02B",1,3,"2030"
24,100,175,2030-07-03,1905,9,5,9,"FL","Florida Space Rangers","home",0,1,"Eastern Division","PBE",22,13,9,"22 - 13",10,150,181,326,32761,22500,35,0.592841244277157,21,14,"21 - 14","#D0D02B",1,3,"2030"
24,100,180,2030-07-04,1905,10,6,15,"FL","Florida Space Rangers","home",1,0,"Eastern Division","PBE",23,13,10,"23 - 13",5,155,187,341,34969,24025,36,0.592755195443604,21,15,"21 - 15","#D0D02B",1,3,"2030"
24,100,185,2030-07-05,1905,9,3,7,"FL","Florida Space Rangers","home",1,0,"Eastern Division","PBE",24,13,11,"24 - 13",2,157,190,348,36100,24649,37,0.594248464995309,22,15,"22 - 15","#D0D02B",1,3,"2030"
24,100,190,2030-07-06,1905,9,0,5,"FL","Florida Space Rangers","home",0,1,"Eastern Division","PBE",24,14,10,"24 - 14",6,163,190,353,36100,26569,38,0.576042381400693,22,16,"22 - 16","#D0D02B",1,3,"2030"
24,100,194,2030-07-09,1905,10,2,5,"FL","Florida Space Rangers","away",1,0,"Eastern Division","PBE",25,14,11,"25 - 14",1,164,192,358,36864,26896,39,0.578168130489335,23,16,"23 - 16","#D0D02B",1,3,"2030"
24,100,199,2030-07-10,1905,9,6,11,"FL","Florida Space Rangers","away",0,1,"Eastern Division","PBE",25,15,10,"25 - 15",10,174,198,369,39204,30276,40,0.564248704663212,23,17,"23 - 17","#D0D02B",1,3,"2030"
24,100,204,2030-07-11,1905,9,0,5,"FL","Florida Space Rangers","away",0,1,"Eastern Division","PBE",25,16,9,"25 - 16",1,175,198,374,39204,30625,41,0.56142863280299,23,18,"23 - 18","#D0D02B",1,3,"2030"
24,100,209,2030-07-12,1905,9,5,9,"FL","Florida Space Rangers","away",1,0,"Eastern Division","PBE",26,16,10,"26 - 16",3,178,203,383,41209,31684,42,0.565335491748179,24,18,"24 - 18","#D0D02B",1,3,"2030"
24,100,214,2030-07-15,1905,9,6,10,"FL","Florida Space Rangers","home",1,0,"Eastern Division","PBE",27,16,11,"27 - 16",0,178,209,393,43681,31684,43,0.579592649107676,25,18,"25 - 18","#D0D02B",1,3,"2030"
24,100,219,2030-07-16,1905,10,1,5,"FL","Florida Space Rangers","home",0,1,"Eastern Division","PBE",27,17,10,"27 - 17",3,181,210,398,44100,32761,44,0.573763026762597,25,19,"25 - 19","#D0D02B",1,3,"2030"
24,100,224,2030-07-17,1905,11,5,10,"FL","Florida Space Rangers","home",1,0,"Eastern Division","PBE",28,17,11,"28 - 17",3,184,215,408,46225,33856,45,0.5772280565927,26,19,"26 - 19","#D0D02B",1,3,"2030"
24,100,229,2030-07-18,1905,9,4,9,"FL","Florida Space Rangers","home",0,1,"Eastern Division","PBE",28,18,10,"28 - 18",5,189,219,417,47961,35721,46,0.573134007313401,26,20,"26 - 20","#D0D02B",1,3,"2030"
24,100,236,2030-07-21,1905,9,5,8,"FL","Florida Space Rangers","home",1,0,"Eastern Division","PBE",29,18,11,"29 - 18",4,193,224,425,50176,37249,47,0.573931941664284,27,20,"27 - 20","#D0D02B",1,3,"2030"
24,100,241,2030-07-22,1905,9,2,6,"FL","Florida Space Rangers","home",0,1,"Eastern Division","PBE",29,19,10,"29 - 19",6,199,226,431,51076,39601,48,0.563274038620598,27,21,"27 - 21","#D0D02B",1,3,"2030"
24,100,246,2030-07-23,1905,9,1,4,"FL","Florida Space Rangers","home",0,1,"Eastern Division","PBE",29,20,9,"29 - 20",4,203,227,435,51529,41209,49,0.555640621967263,27,22,"27 - 22","#D0D02B",1,3,"2030"
24,100,251,2030-07-24,1905,9,4,5,"FL","Florida Space Rangers","home",1,0,"Eastern Division","PBE",30,20,10,"30 - 20",1,204,231,440,53361,41616,50,0.561830759025869,28,22,"28 - 22","#D0D02B",1,3,"2030"
24,100,256,2030-08-12,1905,9,1,4,"FL","Florida Space Rangers","away",0,1,"Eastern Division","PBE",30,21,9,"30 - 21",9,213,232,444,53824,45369,51,0.542618934803867,28,23,"28 - 23","#D0D02B",1,3,"2030"
24,100,261,2030-08-13,1905,9,3,6,"FL","Florida Space Rangers","away",0,1,"Eastern Division","PBE",30,22,8,"30 - 22",10,223,235,450,55225,49729,52,0.526182899174877,27,25,"27 - 25","#D0D02B",1,3,"2030"
24,100,266,2030-08-14,1905,11,6,10,"FL","Florida Space Rangers","away",1,0,"Eastern Division","PBE",31,22,9,"31 - 22",4,227,241,460,58081,51529,53,0.529887783961317,28,25,"28 - 25","#D0D02B",1,3,"2030"
24,100,271,2030-08-15,1905,9,0,6,"FL","Florida Space Rangers","away",0,1,"Eastern Division","PBE",31,23,8,"31 - 23",4,231,241,466,58081,53361,54,0.52117693508731,28,26,"28 - 26","#D0D02B",1,3,"2030"
24,100,273,2030-08-17,1905,9,2,5,"FL","Florida Space Rangers","away",1,0,"Eastern Division","PBE",32,23,9,"32 - 23",0,231,243,471,59049,53361,55,0.525300240192154,29,26,"29 - 26","#D0D02B",1,3,"2030"
24,100,277,2030-08-18,1905,9,5,10,"FL","Florida Space Rangers","away",0,1,"Eastern Division","PBE",32,24,8,"32 - 24",7,238,248,481,61504,56644,56,0.520567423908995,29,27,"29 - 27","#D0D02B",1,3,"2030"
24,100,282,2030-08-19,1905,9,6,7,"FL","Florida Space Rangers","away",1,0,"Eastern Division","PBE",33,24,9,"33 - 24",2,240,254,488,64516,57600,57,0.528317337613417,30,27,"30 - 27","#D0D02B",1,3,"2030"
24,100,287,2030-08-20,1905,9,11,16,"FL","Florida Space Rangers","away",1,0,"Eastern Division","PBE",34,24,10,"34 - 24",5,245,265,504,70225,60025,58,0.53915547024952,31,27,"31 - 27","#D0D02B",1,3,"2030"
24,100,295,2030-08-23,1905,9,9,12,"FL","Florida Space Rangers","home",1,0,"Eastern Division","PBE",35,24,11,"35 - 24",1,246,274,516,75076,60516,59,0.553690483214349,33,26,"33 - 26","#D0D02B",1,3,"2030"
24,100,300,2030-08-24,1905,9,6,10,"FL","Florida Space Rangers","home",1,0,"Eastern Division","PBE",36,24,12,"36 - 24",3,249,280,526,78400,62001,60,0.558400581192442,34,26,"34 - 26","#D0D02B",1,3,"2030"
24,100,631,2030-08-25,1905,9,9,9,"FL","Florida Space Rangers","home",1,0,"Eastern Division","PBE",37,24,13,"37 - 24",2,251,289,535,83521,63001,61,0.57002361420128,35,26,"35 - 26","#D0D02B",1,3,"2030"
24,100,634,2030-08-27,1905,9,15,17,"FL","Florida Space Rangers","home",1,0,"Eastern Division","PBE",38,24,14,"38 - 24",6,257,304,552,92416,66049,62,0.583195027293093,36,26,"36 - 26","#D0D02B",1,3,"2030"
24,100,639,2030-08-28,1905,9,2,4,"FL","Florida Space Rangers","home",1,0,"Eastern Division","PBE",39,24,15,"39 - 24",1,258,306,556,93636,66564,63,0.584494382022472,37,26,"37 - 26","#D0D02B",1,3,"2030"
24,100,644,2030-08-29,1905,9,6,13,"FL","Florida Space Rangers","home",1,0,"Eastern Division","PBE",40,24,16,"40 - 24",4,262,312,569,97344,68644,64,0.586452032677061,38,26,"38 - 26","#D0D02B",1,3,"2030"
24,100,649,2030-08-30,1905,9,7,8,"FL","Florida Space Rangers","home",1,0,"Eastern Division","PBE",41,24,17,"41 - 24",1,263,319,577,101761,69169,65,0.595337272567718,39,26,"39 - 26","#D0D02B",1,3,"2030"
24,100,654,2030-09-02,1905,9,3,10,"FL","Florida Space Rangers","away",1,0,"Eastern Division","PBE",42,24,18,"42 - 24",0,263,322,587,103684,69169,66,0.599839169699108,40,26,"40 - 26","#D0D02B",1,3,"2030"
24,100,659,2030-09-03,1905,9,5,9,"FL","Florida Space Rangers","away",0,1,"Eastern Division","PBE",42,25,17,"42 - 25",7,270,327,596,106929,72900,67,0.594614884139933,40,27,"40 - 27","#D0D02B",1,3,"2030"
24,100,664,2030-09-04,1905,9,4,9,"FL","Florida Space Rangers","away",0,1,"Eastern Division","PBE",42,26,16,"42 - 26",5,275,331,605,109561,75625,68,0.591626796842094,40,28,"40 - 28","#D0D02B",1,3,"2030"
24,100,669,2030-09-05,1905,9,2,6,"FL","Florida Space Rangers","away",0,1,"Eastern Division","PBE",42,27,15,"42 - 27",5,280,333,611,110889,78400,69,0.585818510320198,40,29,"40 - 29","#D0D02B",1,3,"2030"
24,100,674,2030-09-08,1905,9,7,9,"FL","Florida Space Rangers","home",1,0,"Eastern Division","PBE",43,27,16,"43 - 27",1,281,340,620,115600,78961,70,0.594158130355004,42,28,"42 - 28","#D0D02B",1,3,"2030"
24,100,679,2030-09-09,1905,10,2,5,"FL","Florida Space Rangers","home",0,1,"Eastern Division","PBE",43,28,15,"43 - 28",5,286,342,625,116964,81796,71,0.588468504729322,42,29,"42 - 29","#D0D02B",1,3,"2030"
24,100,684,2030-09-10,1905,9,0,6,"FL","Florida Space Rangers","home",0,1,"Eastern Division","PBE",43,29,14,"43 - 29",5,291,342,631,116964,84681,72,0.580049096183888,42,30,"42 - 30","#D0D02B",1,3,"2030"
24,100,689,2030-09-11,1905,9,6,9,"FL","Florida Space Rangers","home",1,0,"Eastern Division","PBE",44,29,15,"44 - 29",3,294,348,640,121104,86436,73,0.583521248915872,43,30,"43 - 30","#D0D02B",1,3,"2030"
24,100,694,2030-09-14,1905,9,3,10,"FL","Florida Space Rangers","away",0,1,"Eastern Division","PBE",44,30,14,"44 - 30",4,298,351,650,123201,88804,74,0.581123086719653,43,31,"43 - 31","#D0D02B",1,3,"2030"
24,100,699,2030-09-15,1905,9,3,8,"FL","Florida Space Rangers","away",1,0,"Eastern Division","PBE",45,30,15,"45 - 30",2,300,354,658,125316,90000,75,0.582009697375021,44,31,"44 - 31","#D0D02B",1,3,"2030"
24,100,704,2030-09-16,1905,9,1,3,"FL","Florida Space Rangers","away",0,1,"Eastern Division","PBE",45,31,14,"45 - 31",5,305,355,661,126025,93025,76,0.575325268203607,44,32,"44 - 32","#D0D02B",1,3,"2030"
24,100,709,2030-09-17,1905,9,3,7,"FL","Florida Space Rangers","away",0,1,"Eastern Division","PBE",45,32,13,"45 - 32",4,309,358,668,128164,95481,77,0.573068926200004,44,33,"44 - 33","#D0D02B",1,3,"2030"
24,100,718,2030-09-20,1905,9,5,9,"FL","Florida Space Rangers","home",1,0,"Eastern Division","PBE",46,32,14,"46 - 32",2,311,363,677,131769,96721,78,0.576694822530527,45,33,"45 - 33","#D0D02B",1,3,"2030"
24,100,723,2030-09-21,1905,9,3,11,"FL","Florida Space Rangers","home",0,1,"Eastern Division","PBE",46,33,13,"46 - 33",6,317,366,688,133956,100489,79,0.571374949348461,45,34,"45 - 34","#D0D02B",1,3,"2030"
24,100,728,2030-09-22,1905,9,2,9,"FL","Florida Space Rangers","home",0,1,"Eastern Division","PBE",46,34,12,"46 - 34",8,325,368,697,135424,105625,80,0.56181108405345,45,35,"45 - 35","#D0D02B",1,3,"2030"
24,100,732,2030-09-23,1905,9,7,10,"FL","Florida Space Rangers","home",1,0,"Eastern Division","PBE",47,34,13,"47 - 34",3,328,375,707,140625,107584,81,0.566558827439779,46,35,"46 - 35","#D0D02B",1,3,"2030"
24,100,734,2030-09-25,1905,9,8,15,"FL","Florida Space Rangers","away",1,0,"Eastern Division","PBE",48,34,14,"48 - 34",1,329,383,722,146689,108241,82,0.575408935786294,47,35,"47 - 35","#D0D02B",1,3,"2030"
24,100,739,2030-09-26,1905,9,2,6,"FL","Florida Space Rangers","away",0,1,"Eastern Division","PBE",48,35,13,"48 - 35",4,333,385,728,148225,110889,83,0.572045508926573,47,36,"47 - 36","#D0D02B",1,3,"2030"
24,100,744,2030-09-27,1905,9,8,9,"FL","Florida Space Rangers","away",1,0,"Eastern Division","PBE",49,35,14,"49 - 35",4,337,393,737,154449,113569,84,0.576263534538725,48,36,"48 - 36","#D0D02B",1,3,"2030"
24,100,752,2030-09-30,1905,10,6,10,"FL","Florida Space Rangers","away",1,0,"Eastern Division","PBE",50,35,15,"50 - 35",3,340,399,747,159201,115600,85,0.579331952940491,49,36,"49 - 36","#D0D02B",1,3,"2030"
24,100,757,2030-10-01,1905,9,8,13,"FL","Florida Space Rangers","away",1,0,"Eastern Division","PBE",51,35,16,"51 - 35",4,344,407,760,165649,118336,86,0.583301934961354,50,36,"50 - 36","#D0D02B",1,3,"2030"
24,100,762,2030-10-02,1905,9,4,11,"FL","Florida Space Rangers","away",1,0,"Eastern Division","PBE",52,35,17,"52 - 35",1,345,411,771,168921,119025,87,0.586641245233481,51,36,"51 - 36","#D0D02B",1,3,"2030"
24,100,767,2030-10-03,1905,9,7,13,"FL","Florida Space Rangers","away",1,0,"Eastern Division","PBE",53,35,18,"53 - 35",2,347,418,784,174724,120409,88,0.592017836026469,52,36,"52 - 36","#D0D02B",1,3,"2030"
24,100,772,2030-10-05,1905,9,4,8,"FL","Florida Space Rangers","home",1,0,"Eastern Division","PBE",54,35,19,"54 - 35",1,348,422,792,178084,121104,89,0.595224407396019,53,36,"53 - 36","#D0D02B",1,3,"2030"
24,100,776,2030-10-06,1905,9,10,14,"FL","Florida Space Rangers","home",1,0,"Eastern Division","PBE",55,35,20,"55 - 35",7,355,432,806,186624,126025,90,0.596912192266727,54,36,"54 - 36","#D0D02B",1,3,"2030"
25,100,4,2030-05-15,1905,9,11,14,"UTA","Utah Railroaders","away",1,0,"Western Division","PBE",1,0,1,"1 - 0",2,2,11,14,121,4,1,0.968,1,0,"1 - 0","#2C0060",3,6,"2030"
25,100,9,2030-05-16,1905,9,3,6,"UTA","Utah Railroaders","away",0,1,"Western Division","PBE",1,1,0,"1 - 1",11,13,14,20,196,169,2,0.536986301369863,1,1,"1 - 1","#2C0060",3,6,"2030"
25,100,14,2030-05-17,1905,9,18,18,"UTA","Utah Railroaders","away",1,0,"Western Division","PBE",2,1,1,"2 - 1",2,15,32,38,1024,225,3,0.819855884707766,2,1,"2 - 1","#2C0060",3,6,"2030"
25,100,19,2030-05-18,1905,9,6,9,"UTA","Utah Railroaders","away",0,1,"Western Division","PBE",2,2,0,"2 - 2",8,23,38,47,1444,529,4,0.731880385200203,3,1,"3 - 1","#2C0060",3,6,"2030"
25,100,25,2030-05-21,1905,11,7,10,"UTA","Utah Railroaders","home",0,1,"Western Division","PBE",2,3,-1,"2 - 3",8,31,45,57,2025,961,5,0.678164768921634,3,2,"3 - 2","#2C0060",3,6,"2030"
25,100,30,2030-05-22,1905,10,4,12,"UTA","Utah Railroaders","home",0,1,"Western Division","PBE",2,4,-2,"2 - 4",6,37,49,69,2401,1369,6,0.636870026525199,4,2,"4 - 2","#2C0060",3,6,"2030"
25,100,35,2030-05-23,1905,9,1,5,"UTA","Utah Railroaders","home",0,1,"Western Division","PBE",2,5,-3,"2 - 5",6,43,50,74,2500,1849,7,0.574844791906185,4,3,"4 - 3","#2C0060",3,6,"2030"
25,100,39,2030-05-24,1905,9,3,9,"UTA","Utah Railroaders","home",0,1,"Western Division","PBE",2,6,-4,"2 - 6",7,50,53,83,2809,2500,8,0.529101525711057,4,4,"4 - 4","#2C0060",3,6,"2030"
25,100,47,2030-05-27,1905,9,0,4,"UTA","Utah Railroaders","away",0,1,"Western Division","PBE",2,7,-5,"2 - 7",2,52,53,87,2809,2704,9,0.509522945764556,5,4,"5 - 4","#2C0060",3,6,"2030"
25,100,52,2030-05-28,1905,9,11,11,"UTA","Utah Railroaders","away",1,0,"Western Division","PBE",3,7,-4,"3 - 7",3,55,64,98,4096,3025,10,0.575200112343772,6,4,"6 - 4","#2C0060",3,6,"2030"
25,100,57,2030-05-29,1905,9,8,10,"UTA","Utah Railroaders","away",1,0,"Western Division","PBE",4,7,-3,"4 - 7",4,59,72,108,5184,3481,11,0.598268897864974,7,4,"7 - 4","#2C0060",3,6,"2030"
25,100,63,2030-06-01,1905,9,4,3,"UTA","Utah Railroaders","home",0,1,"Western Division","PBE",4,8,-4,"4 - 8",10,69,76,111,5776,4761,12,0.548163613931859,7,5,"7 - 5","#2C0060",3,6,"2030"
25,100,68,2030-06-02,1905,9,2,4,"UTA","Utah Railroaders","home",0,1,"Western Division","PBE",4,9,-5,"4 - 9",3,72,78,115,6084,5184,13,0.539936102236422,7,6,"7 - 6","#2C0060",3,6,"2030"
25,100,73,2030-06-03,1905,9,6,9,"UTA","Utah Railroaders","home",0,1,"Western Division","PBE",4,10,-6,"4 - 10",7,79,84,124,7056,6241,14,0.530646010378281,7,7,"7 - 7","#2C0060",3,6,"2030"
25,100,78,2030-06-04,1905,9,2,10,"UTA","Utah Railroaders","home",0,1,"Western Division","PBE",4,11,-7,"4 - 11",14,93,86,134,7396,8649,15,0.460953568089748,7,8,"7 - 8","#2C0060",3,6,"2030"
25,100,81,2030-06-06,1905,9,0,2,"UTA","Utah Railroaders","away",0,1,"Western Division","PBE",4,12,-8,"4 - 12",7,100,86,136,7396,10000,16,0.425155208093815,7,9,"7 - 9","#2C0060",3,6,"2030"
25,100,85,2030-06-07,1905,9,6,9,"UTA","Utah Railroaders","away",1,0,"Western Division","PBE",5,12,-7,"5 - 12",2,102,92,145,8464,10404,17,0.448590205639177,8,9,"8 - 9","#2C0060",3,6,"2030"
25,100,90,2030-06-08,1905,9,8,12,"UTA","Utah Railroaders","away",1,0,"Western Division","PBE",6,12,-6,"6 - 12",1,103,100,157,10000,10609,18,0.485224901741957,9,9,"9 - 9","#2C0060",3,6,"2030"
25,100,94,2030-06-09,1905,9,5,8,"UTA","Utah Railroaders","away",1,0,"Western Division","PBE",7,12,-5,"7 - 12",4,107,105,165,11025,11449,19,0.490566877280413,9,10,"9 - 10","#2C0060",3,6,"2030"
25,100,100,2030-06-11,1905,9,4,11,"UTA","Utah Railroaders","home",1,0,"Western Division","PBE",8,12,-4,"8 - 12",2,109,109,176,11881,11881,20,0.5,10,10,"10 - 10","#2C0060",3,6,"2030"
25,100,105,2030-06-12,1905,9,2,8,"UTA","Utah Railroaders","home",0,1,"Western Division","PBE",8,13,-5,"8 - 13",4,113,111,184,12321,12769,21,0.491072140294938,10,11,"10 - 11","#2C0060",3,6,"2030"
25,100,110,2030-06-13,1905,9,5,10,"UTA","Utah Railroaders","home",1,0,"Western Division","PBE",9,13,-4,"9 - 13",3,116,116,194,13456,13456,22,0.5,11,11,"11 - 11","#2C0060",3,6,"2030"
25,100,114,2030-06-14,1905,9,9,11,"UTA","Utah Railroaders","home",1,0,"Western Division","PBE",10,13,-3,"10 - 13",7,123,125,205,15625,15129,23,0.50806399167588,12,11,"12 - 11","#2C0060",3,6,"2030"
25,100,119,2030-06-16,1905,9,4,10,"UTA","Utah Railroaders","away",0,1,"Western Division","PBE",10,14,-4,"10 - 14",7,130,129,215,16641,16900,24,0.496139053695477,12,12,"12 - 12","#2C0060",3,6,"2030"
25,100,124,2030-06-17,1905,9,7,8,"UTA","Utah Railroaders","away",1,0,"Western Division","PBE",11,14,-3,"11 - 14",2,132,136,223,18496,17424,25,0.514922048997773,13,12,"13 - 12","#2C0060",3,6,"2030"
25,100,129,2030-06-18,1905,9,2,7,"UTA","Utah Railroaders","away",0,1,"Western Division","PBE",11,15,-4,"11 - 15",13,145,138,230,19044,21025,26,0.475280141755472,12,14,"12 - 14","#2C0060",3,6,"2030"
25,100,134,2030-06-19,1905,9,7,11,"UTA","Utah Railroaders","away",0,1,"Western Division","PBE",11,16,-5,"11 - 16",9,154,145,241,21025,23716,27,0.469926912675175,13,14,"13 - 14","#2C0060",3,6,"2030"
25,100,138,2030-06-22,1905,9,3,9,"UTA","Utah Railroaders","home",0,1,"Western Division","PBE",11,17,-6,"11 - 17",9,163,148,250,21904,26569,28,0.451880428279661,13,15,"13 - 15","#2C0060",3,6,"2030"
25,100,143,2030-06-23,1905,9,2,7,"UTA","Utah Railroaders","home",1,0,"Western Division","PBE",12,17,-5,"12 - 17",0,163,150,257,22500,26569,29,0.45853797713424,13,16,"13 - 16","#2C0060",3,6,"2030"
25,100,148,2030-06-24,1905,9,10,15,"UTA","Utah Railroaders","home",1,0,"Western Division","PBE",13,17,-4,"13 - 17",0,163,160,272,25600,26569,30,0.490712875462439,15,15,"15 - 15","#2C0060",3,6,"2030"
25,100,153,2030-06-25,1905,9,1,4,"UTA","Utah Railroaders","home",1,0,"Western Division","PBE",14,17,-3,"14 - 17",0,163,161,276,25921,26569,31,0.493827395694418,15,16,"15 - 16","#2C0060",3,6,"2030"
25,100,158,2030-06-27,1905,9,0,2,"UTA","Utah Railroaders","home",0,1,"Western Division","PBE",14,18,-4,"14 - 18",1,164,161,278,25921,26896,32,0.490770017229301,16,16,"16 - 16","#2C0060",3,6,"2030"
25,100,163,2030-06-28,1905,9,1,8,"UTA","Utah Railroaders","home",0,1,"Western Division","PBE",14,19,-5,"14 - 19",4,168,162,286,26244,28224,33,0.481824190350297,16,17,"16 - 17","#2C0060",3,6,"2030"
25,100,168,2030-06-29,1905,9,11,13,"UTA","Utah Railroaders","home",1,0,"Western Division","PBE",15,19,-4,"15 - 19",7,175,173,299,29929,30625,34,0.494253063381445,17,17,"17 - 17","#2C0060",3,6,"2030"
25,100,173,2030-06-30,1905,14,9,17,"UTA","Utah Railroaders","home",1,0,"Western Division","PBE",16,19,-3,"16 - 19",6,181,182,316,33124,32761,35,0.502754800030356,18,17,"18 - 17","#2C0060",3,6,"2030"
25,100,175,2030-07-03,1905,9,10,11,"UTA","Utah Railroaders","away",1,0,"Western Division","PBE",17,19,-2,"17 - 19",5,186,192,327,36864,34596,36,0.515869017632242,19,17,"19 - 17","#2C0060",3,6,"2030"
25,100,180,2030-07-04,1905,10,5,5,"UTA","Utah Railroaders","away",0,1,"Western Division","PBE",17,20,-3,"17 - 20",6,192,197,332,38809,36864,37,0.512851347244063,19,18,"19 - 18","#2C0060",3,6,"2030"
25,100,185,2030-07-05,1905,9,2,6,"UTA","Utah Railroaders","away",0,1,"Western Division","PBE",17,21,-4,"17 - 21",3,195,199,338,39601,38025,38,0.510151237987272,19,19,"19 - 19","#2C0060",3,6,"2030"
25,100,190,2030-07-06,1905,9,6,9,"UTA","Utah Railroaders","away",1,0,"Western Division","PBE",18,21,-3,"18 - 21",0,195,205,347,42025,38025,39,0.524984384759525,20,19,"20 - 19","#2C0060",3,6,"2030"
25,100,198,2030-07-09,1905,9,4,10,"UTA","Utah Railroaders","away",0,1,"Western Division","PBE",18,22,-4,"18 - 22",13,208,209,357,43681,43264,40,0.502398067743976,20,20,"20 - 20","#2C0060",3,6,"2030"
25,100,203,2030-07-10,1905,9,1,4,"UTA","Utah Railroaders","away",0,1,"Western Division","PBE",18,23,-5,"18 - 23",3,211,210,361,44100,44521,41,0.49762471648932,20,21,"20 - 21","#2C0060",3,6,"2030"
25,100,208,2030-07-11,1905,9,3,8,"UTA","Utah Railroaders","away",1,0,"Western Division","PBE",19,23,-4,"19 - 23",0,211,213,369,45369,44521,42,0.504716876182,21,21,"21 - 21","#2C0060",3,6,"2030"
25,100,213,2030-07-12,1905,9,7,13,"UTA","Utah Railroaders","away",1,0,"Western Division","PBE",20,23,-3,"20 - 23",4,215,220,382,48400,46225,43,0.511492734478203,22,21,"22 - 21","#2C0060",3,6,"2030"
25,100,217,2030-07-15,1905,9,5,8,"UTA","Utah Railroaders","home",1,0,"Western Division","PBE",21,23,-2,"21 - 23",4,219,225,390,50625,47961,44,0.513511046193171,23,21,"23 - 21","#2C0060",3,6,"2030"
25,100,222,2030-07-16,1905,9,8,11,"UTA","Utah Railroaders","home",0,1,"Western Division","PBE",21,24,-3,"21 - 24",9,228,233,401,54289,51984,45,0.510844711262503,23,22,"23 - 22","#2C0060",3,6,"2030"
25,100,227,2030-07-17,1905,9,5,13,"UTA","Utah Railroaders","home",1,0,"Western Division","PBE",22,24,-2,"22 - 24",1,229,238,414,56644,52441,46,0.519264793509648,24,22,"24 - 22","#2C0060",3,6,"2030"
25,100,232,2030-07-18,1905,9,4,9,"UTA","Utah Railroaders","home",0,1,"Western Division","PBE",22,25,-3,"22 - 25",5,234,242,423,58564,54756,47,0.516801976703142,24,23,"24 - 23","#2C0060",3,6,"2030"
25,100,237,2030-07-21,1905,9,3,7,"UTA","Utah Railroaders","home",0,1,"Western Division","PBE",22,26,-4,"22 - 26",4,238,245,430,60025,56644,48,0.514489710205796,25,23,"25 - 23","#2C0060",3,6,"2030"
25,100,242,2030-07-22,1905,9,2,8,"UTA","Utah Railroaders","home",0,1,"Western Division","PBE",22,27,-5,"22 - 27",4,242,247,438,61009,58564,49,0.510223879972904,25,24,"25 - 24","#2C0060",3,6,"2030"
25,100,247,2030-07-23,1905,9,1,7,"UTA","Utah Railroaders","home",0,1,"Western Division","PBE",22,28,-6,"22 - 28",3,245,248,445,61504,60025,50,0.506084967374042,25,25,"25 - 25","#2C0060",3,6,"2030"
25,100,252,2030-07-24,1905,9,8,16,"UTA","Utah Railroaders","home",1,0,"Western Division","PBE",23,28,-5,"23 - 28",5,250,256,461,65536,62500,51,0.511856040488613,26,25,"26 - 25","#2C0060",3,6,"2030"
25,100,256,2030-08-12,1905,9,9,10,"UTA","Utah Railroaders","home",1,0,"Western Division","PBE",24,28,-4,"24 - 28",1,251,265,471,70225,63001,52,0.52711182501914,27,25,"27 - 25","#2C0060",3,6,"2030"
25,100,261,2030-08-13,1905,9,10,15,"UTA","Utah Railroaders","home",1,0,"Western Division","PBE",25,28,-3,"25 - 28",3,254,275,486,75625,64516,53,0.539635081810462,29,24,"29 - 24","#2C0060",3,6,"2030"
25,100,266,2030-08-14,1905,11,4,11,"UTA","Utah Railroaders","home",0,1,"Western Division","PBE",25,29,-4,"25 - 29",6,260,279,497,77841,67600,54,0.535206716125439,29,25,"29 - 25","#2C0060",3,6,"2030"
25,100,271,2030-08-15,1905,9,4,9,"UTA","Utah Railroaders","home",1,0,"Western Division","PBE",26,29,-3,"26 - 29",0,260,283,506,80089,67600,55,0.542281415677539,30,25,"30 - 25","#2C0060",3,6,"2030"
25,100,281,2030-08-18,1905,9,5,11,"UTA","Utah Railroaders","home",0,1,"Western Division","PBE",26,30,-4,"26 - 30",9,269,288,517,82944,72361,56,0.534071665432536,30,26,"30 - 26","#2C0060",3,6,"2030"
25,100,286,2030-08-19,1905,9,4,11,"UTA","Utah Railroaders","home",0,1,"Western Division","PBE",26,31,-5,"26 - 31",9,278,292,528,85264,77284,57,0.524546595467185,30,27,"30 - 27","#2C0060",3,6,"2030"
25,100,291,2030-08-20,1905,9,7,9,"UTA","Utah Railroaders","home",1,0,"Western Division","PBE",27,31,-4,"27 - 31",2,280,299,537,89401,78400,58,0.532779900000596,31,27,"31 - 27","#2C0060",3,6,"2030"
25,100,298,2030-08-23,1905,9,2,6,"UTA","Utah Railroaders","away",0,1,"Western Division","PBE",27,32,-5,"27 - 32",3,283,301,543,90601,80089,59,0.530792665065323,31,28,"31 - 28","#2C0060",3,6,"2030"
25,100,629,2030-08-24,1905,9,7,11,"UTA","Utah Railroaders","away",1,0,"Western Division","PBE",28,32,-4,"28 - 32",3,286,308,554,94864,81796,60,0.536986301369863,32,28,"32 - 28","#2C0060",3,6,"2030"
25,100,633,2030-08-25,1905,9,1,6,"UTA","Utah Railroaders","away",0,1,"Western Division","PBE",28,33,-5,"28 - 33",10,296,309,560,95481,87616,61,0.521477686690661,32,29,"32 - 29","#2C0060",3,6,"2030"
25,100,637,2030-08-27,1905,9,13,14,"UTA","Utah Railroaders","home",1,0,"Western Division","PBE",29,33,-4,"29 - 33",0,296,322,574,103684,87616,62,0.541996863565081,34,28,"34 - 28","#2C0060",3,6,"2030"
25,100,642,2030-08-28,1905,9,1,2,"UTA","Utah Railroaders","home",1,0,"Western Division","PBE",30,33,-3,"30 - 33",0,296,323,576,104329,87616,63,0.543535908723853,34,29,"34 - 29","#2C0060",3,6,"2030"
25,100,647,2030-08-29,1905,9,4,6,"UTA","Utah Railroaders","home",1,0,"Western Division","PBE",31,33,-2,"31 - 33",1,297,327,582,106929,88209,64,0.547966054791993,35,29,"35 - 29","#2C0060",3,6,"2030"
25,100,652,2030-08-30,1905,9,3,7,"UTA","Utah Railroaders","home",1,0,"Western Division","PBE",32,33,-1,"32 - 33",0,297,330,589,108900,88209,65,0.552486187845304,36,29,"36 - 29","#2C0060",3,6,"2030"
25,100,656,2030-09-02,1905,9,8,12,"UTA","Utah Railroaders","away",1,0,"Western Division","PBE",33,33,0,"33 - 33",4,301,338,601,114244,90601,66,0.557709487661402,37,29,"37 - 29","#2C0060",3,6,"2030"
25,100,661,2030-09-03,1905,9,3,8,"UTA","Utah Railroaders","away",0,1,"Western Division","PBE",33,34,-1,"33 - 34",4,305,341,609,116281,93025,67,0.555555024700678,37,30,"37 - 30","#2C0060",3,6,"2030"
25,100,666,2030-09-04,1905,11,7,10,"UTA","Utah Railroaders","away",0,1,"Western Division","PBE",33,35,-2,"33 - 35",8,313,348,619,121104,97969,68,0.552802034025188,38,30,"38 - 30","#2C0060",3,6,"2030"
25,100,671,2030-09-05,1905,9,12,17,"UTA","Utah Railroaders","away",1,0,"Western Division","PBE",34,35,-1,"34 - 35",5,318,360,636,129600,101124,69,0.561710095178655,39,30,"39 - 30","#2C0060",3,6,"2030"
25,100,678,2030-09-08,1905,9,6,10,"UTA","Utah Railroaders","home",0,1,"Western Division","PBE",34,36,-2,"34 - 36",7,325,366,646,133956,105625,70,0.559126141054591,39,31,"39 - 31","#2C0060",3,6,"2030"
25,100,683,2030-09-09,1905,10,4,10,"UTA","Utah Railroaders","home",1,0,"Western Division","PBE",35,36,-1,"35 - 36",3,328,370,656,136900,107584,71,0.559954843670751,40,31,"40 - 31","#2C0060",3,6,"2030"
25,100,688,2030-09-10,1905,9,3,9,"UTA","Utah Railroaders","home",1,0,"Western Division","PBE",36,36,0,"36 - 36",0,328,373,665,139129,107584,72,0.563930558989595,41,31,"41 - 31","#2C0060",3,6,"2030"
25,100,693,2030-09-11,1905,9,10,15,"UTA","Utah Railroaders","home",1,0,"Western Division","PBE",37,36,1,"37 - 36",7,335,383,680,146689,112225,73,0.56655491784917,41,32,"41 - 32","#2C0060",3,6,"2030"
25,100,697,2030-09-14,1905,9,2,4,"UTA","Utah Railroaders","away",0,1,"Western Division","PBE",37,37,0,"37 - 37",3,338,385,684,148225,114244,74,0.564733358987157,42,32,"42 - 32","#2C0060",3,6,"2030"
25,100,702,2030-09-15,1905,9,2,5,"UTA","Utah Railroaders","away",0,1,"Western Division","PBE",37,38,-1,"37 - 38",3,341,387,689,149769,116281,75,0.562935538432625,42,33,"42 - 33","#2C0060",3,6,"2030"
25,100,707,2030-09-16,1905,9,3,9,"UTA","Utah Railroaders","away",0,1,"Western Division","PBE",37,39,-2,"37 - 39",4,345,390,698,152100,119025,76,0.560995850622407,43,33,"43 - 33","#2C0060",3,6,"2030"
25,100,712,2030-09-17,1905,9,13,15,"UTA","Utah Railroaders","away",1,0,"Western Division","PBE",38,39,-1,"38 - 39",3,348,403,713,162409,121104,77,0.57284498418062,44,33,"44 - 33","#2C0060",3,6,"2030"
25,100,716,2030-09-20,1905,9,6,11,"UTA","Utah Railroaders","away",1,0,"Western Division","PBE",39,39,0,"39 - 39",1,349,409,724,167281,121801,78,0.578662801558035,45,33,"45 - 33","#2C0060",3,6,"2030"
25,100,721,2030-09-21,1905,9,3,7,"UTA","Utah Railroaders","away",1,0,"Western Division","PBE",40,39,1,"40 - 39",2,351,412,731,169744,123201,79,0.579439826588609,46,33,"46 - 33","#2C0060",3,6,"2030"
25,100,726,2030-09-22,1905,9,2,6,"UTA","Utah Railroaders","away",0,1,"Western Division","PBE",40,40,0,"40 - 40",3,354,414,737,171396,125316,80,0.577651055569037,46,34,"46 - 34","#2C0060",3,6,"2030"
25,100,730,2030-09-23,1905,9,7,10,"UTA","Utah Railroaders","away",1,0,"Western Division","PBE",41,40,1,"41 - 40",3,357,421,747,177241,127449,81,0.581709278282845,47,34,"47 - 34","#2C0060",3,6,"2030"
25,100,736,2030-09-25,1905,9,2,2,"UTA","Utah Railroaders","away",0,1,"Western Division","PBE",41,41,0,"41 - 41",3,360,423,749,178929,129600,82,0.579942242058283,48,34,"48 - 34","#2C0060",3,6,"2030"
25,100,741,2030-09-26,1905,9,3,8,"UTA","Utah Railroaders","away",0,1,"Western Division","PBE",41,42,-1,"41 - 42",7,367,426,757,181476,134689,83,0.573991428526244,48,35,"48 - 35","#2C0060",3,6,"2030"
25,100,746,2030-09-27,1905,9,0,4,"UTA","Utah Railroaders","away",0,1,"Western Division","PBE",41,43,-2,"41 - 43",6,373,426,761,181476,139129,84,0.566042326226977,48,36,"48 - 36","#2C0060",3,6,"2030"
25,100,750,2030-09-28,1905,9,6,10,"UTA","Utah Railroaders","away",0,1,"Western Division","PBE",41,44,-3,"41 - 44",7,380,432,771,186624,144400,85,0.563777852965344,48,37,"48 - 37","#2C0060",3,6,"2030"
25,100,756,2030-09-30,1905,9,5,6,"UTA","Utah Railroaders","away",1,0,"Western Division","PBE",42,44,-2,"42 - 44",1,381,437,777,190969,145161,86,0.568140302859013,49,37,"49 - 37","#2C0060",3,6,"2030"
25,100,761,2030-10-01,1905,9,2,4,"UTA","Utah Railroaders","away",0,1,"Western Division","PBE",42,45,-3,"42 - 45",3,384,439,781,192721,147456,87,0.566531540933102,49,38,"49 - 38","#2C0060",3,6,"2030"
25,100,766,2030-10-02,1905,9,8,12,"UTA","Utah Railroaders","away",1,0,"Western Division","PBE",43,45,-2,"43 - 45",3,387,447,793,199809,149769,88,0.571572009680243,50,38,"50 - 38","#2C0060",3,6,"2030"
25,100,771,2030-10-03,1905,9,3,8,"UTA","Utah Railroaders","away",0,1,"Western Division","PBE",43,46,-3,"43 - 46",4,391,450,801,202500,152881,89,0.569810991583681,51,38,"51 - 38","#2C0060",3,6,"2030"
25,100,775,2030-10-05,1905,9,6,7,"UTA","Utah Railroaders","home",1,0,"Western Division","PBE",44,46,-2,"44 - 46",5,396,456,808,207936,156816,90,0.57007500986972,51,39,"51 - 39","#2C0060",3,6,"2030"
25,100,780,2030-10-06,1905,9,15,14,"UTA","Utah Railroaders","home",1,0,"Western Division","PBE",45,46,-1,"45 - 46",2,398,471,822,221841,158404,91,0.583415955502373,53,38,"53 - 38","#2C0060",3,6,"2030"
26,100,3,2030-05-15,1905,9,6,14,"CUN","Cancun Toros","home",1,0,"Eastern Division","PBE",1,0,1,"1 - 0",0,0,6,14,36,0,1,1,1,0,"1 - 0","#0090D4",5,9,"2030"
26,100,8,2030-05-16,1905,9,9,15,"CUN","Cancun Toros","home",1,0,"Eastern Division","PBE",2,0,2,"2 - 0",3,3,15,29,225,9,2,0.961538461538462,2,0,"2 - 0","#0090D4",5,9,"2030"
26,100,13,2030-05-17,1905,9,6,8,"CUN","Cancun Toros","home",1,0,"Eastern Division","PBE",3,0,3,"3 - 0",2,5,21,37,441,25,3,0.946351931330472,3,0,"3 - 0","#0090D4",5,9,"2030"
26,100,18,2030-05-18,1905,9,6,7,"CUN","Cancun Toros","home",1,0,"Eastern Division","PBE",4,0,4,"4 - 0",4,9,27,44,729,81,4,0.9,4,0,"4 - 0","#0090D4",5,9,"2030"
26,100,22,2030-05-21,1905,9,3,10,"CUN","Cancun Toros","away",1,0,"Eastern Division","PBE",5,0,5,"5 - 0",0,9,30,54,900,81,5,0.917431192660551,5,0,"5 - 0","#0090D4",5,9,"2030"
26,100,27,2030-05-22,1905,9,5,9,"CUN","Cancun Toros","away",1,0,"Eastern Division","PBE",6,0,6,"6 - 0",1,10,35,63,1225,100,6,0.924528301886792,6,0,"6 - 0","#0090D4",5,9,"2030"
26,100,32,2030-05-23,1905,9,7,9,"CUN","Cancun Toros","away",1,0,"Eastern Division","PBE",7,0,7,"7 - 0",1,11,42,72,1764,121,7,0.935809018567639,7,0,"7 - 0","#0090D4",5,9,"2030"
26,100,36,2030-05-24,1905,9,9,11,"CUN","Cancun Toros","away",1,0,"Eastern Division","PBE",8,0,8,"8 - 0",3,14,51,83,2601,196,8,0.929924919556668,7,1,"7 - 1","#0090D4",5,9,"2030"
26,100,41,2030-05-26,1905,10,2,11,"CUN","Cancun Toros","home",0,1,"Eastern Division","PBE",8,1,7,"8 - 1",3,17,53,94,2809,289,9,0.906714009038089,8,1,"8 - 1","#0090D4",5,9,"2030"
26,100,45,2030-05-27,1905,9,0,5,"CUN","Cancun Toros","home",0,1,"Eastern Division","PBE",8,2,6,"8 - 2",7,24,53,99,2809,576,10,0.829837518463811,8,2,"8 - 2","#0090D4",5,9,"2030"
26,100,50,2030-05-28,1905,10,4,9,"CUN","Cancun Toros","home",1,0,"Eastern Division","PBE",9,2,7,"9 - 2",3,27,57,108,3249,729,11,0.816742081447964,9,2,"9 - 2","#0090D4",5,9,"2030"
26,100,55,2030-05-29,1905,9,11,15,"CUN","Cancun Toros","home",0,1,"Eastern Division","PBE",9,3,6,"9 - 3",15,42,68,123,4624,1764,12,0.723857232310582,9,3,"9 - 3","#0090D4",5,9,"2030"
26,100,60,2030-06-01,1905,9,2,5,"CUN","Cancun Toros","away",0,1,"Eastern Division","PBE",9,4,5,"9 - 4",5,47,70,128,4900,2209,13,0.689267126178084,9,4,"9 - 4","#0090D4",5,9,"2030"
26,100,65,2030-06-02,1905,9,1,3,"CUN","Cancun Toros","away",0,1,"Eastern Division","PBE",9,5,4,"9 - 5",4,51,71,131,5041,2601,14,0.6596440722324,9,5,"9 - 5","#0090D4",5,9,"2030"
26,100,70,2030-06-03,1905,9,1,3,"CUN","Cancun Toros","away",0,1,"Eastern Division","PBE",9,6,3,"9 - 6",4,55,72,134,5184,3025,15,0.631502009989036,9,6,"9 - 6","#0090D4",5,9,"2030"
26,100,75,2030-06-04,1905,9,5,11,"CUN","Cancun Toros","away",0,1,"Eastern Division","PBE",9,7,2,"9 - 7",6,61,77,145,5929,3721,16,0.61440414507772,10,6,"10 - 6","#0090D4",5,9,"2030"
26,100,79,2030-06-06,1905,9,3,8,"CUN","Cancun Toros","away",0,1,"Eastern Division","PBE",9,8,1,"9 - 8",5,66,80,153,6400,4356,17,0.595016734845668,10,7,"10 - 7","#0090D4",5,9,"2030"
26,100,83,2030-06-07,1905,9,3,6,"CUN","Cancun Toros","away",0,1,"Eastern Division","PBE",9,9,0,"9 - 9",6,72,83,159,6889,5184,18,0.570612109666197,10,8,"10 - 8","#0090D4",5,9,"2030"
26,100,88,2030-06-08,1905,9,3,6,"CUN","Cancun Toros","away",0,1,"Eastern Division","PBE",9,10,-1,"9 - 10",8,80,86,165,7396,6400,19,0.536097419541896,10,9,"10 - 9","#0090D4",5,9,"2030"
26,100,93,2030-06-09,1905,9,5,6,"CUN","Cancun Toros","away",0,1,"Eastern Division","PBE",9,11,-2,"9 - 11",13,93,91,171,8281,8649,20,0.489131718842292,10,10,"10 - 10","#0090D4",5,9,"2030"
26,100,100,2030-06-11,1905,9,2,10,"CUN","Cancun Toros","away",0,1,"Eastern Division","PBE",9,12,-3,"9 - 12",4,97,93,181,8649,9409,21,0.478956695093587,10,11,"10 - 11","#0090D4",5,9,"2030"
26,100,105,2030-06-12,1905,9,4,8,"CUN","Cancun Toros","away",1,0,"Eastern Division","PBE",10,12,-2,"10 - 12",2,99,97,189,9409,9801,22,0.489796980739198,11,11,"11 - 11","#0090D4",5,9,"2030"
26,100,110,2030-06-13,1905,9,3,8,"CUN","Cancun Toros","away",0,1,"Eastern Division","PBE",10,13,-3,"10 - 13",5,104,100,197,10000,10816,23,0.480399692544197,11,12,"11 - 12","#0090D4",5,9,"2030"
26,100,114,2030-06-14,1905,9,7,13,"CUN","Cancun Toros","away",0,1,"Eastern Division","PBE",10,14,-4,"10 - 14",9,113,107,210,11449,12769,24,0.472747543149723,11,13,"11 - 13","#0090D4",5,9,"2030"
26,100,121,2030-06-17,1905,9,2,7,"CUN","Cancun Toros","home",0,1,"Eastern Division","PBE",10,15,-5,"10 - 15",5,118,109,217,11881,13924,25,0.460414648323968,12,13,"12 - 13","#0090D4",5,9,"2030"
26,100,126,2030-06-18,1905,9,1,7,"CUN","Cancun Toros","home",0,1,"Eastern Division","PBE",10,16,-6,"10 - 16",12,130,110,224,12100,16900,26,0.417241379310345,11,15,"11 - 15","#0090D4",5,9,"2030"
26,100,131,2030-06-19,1905,9,6,9,"CUN","Cancun Toros","home",0,1,"Eastern Division","PBE",10,17,-7,"10 - 17",16,146,116,233,13456,21316,27,0.386978028298631,10,17,"10 - 17","#0090D4",5,9,"2030"
26,100,135,2030-06-22,1905,9,7,8,"CUN","Cancun Toros","home",0,1,"Eastern Division","PBE",10,18,-8,"10 - 18",8,154,123,241,15129,23716,28,0.389470974385378,11,17,"11 - 17","#0090D4",5,9,"2030"
26,100,140,2030-06-23,1905,9,2,6,"CUN","Cancun Toros","home",0,1,"Eastern Division","PBE",10,19,-9,"10 - 19",6,160,125,247,15625,25600,29,0.37901758641601,11,18,"11 - 18","#0090D4",5,9,"2030"
26,100,145,2030-06-24,1905,9,11,12,"CUN","Cancun Toros","home",1,0,"Eastern Division","PBE",11,19,-8,"11 - 19",5,165,136,259,18496,27225,30,0.404540583101857,12,18,"12 - 18","#0090D4",5,9,"2030"
26,100,150,2030-06-25,1905,9,4,7,"CUN","Cancun Toros","home",1,0,"Eastern Division","PBE",12,19,-7,"12 - 19",3,168,140,266,19600,28224,31,0.409836065573771,13,18,"13 - 18","#0090D4",5,9,"2030"
26,100,156,2030-06-27,1905,9,0,5,"CUN","Cancun Toros","home",0,1,"Eastern Division","PBE",12,20,-8,"12 - 20",14,182,140,271,19600,33124,32,0.371747211895911,12,20,"12 - 20","#0090D4",5,9,"2030"
26,100,161,2030-06-28,1905,9,2,6,"CUN","Cancun Toros","home",0,1,"Eastern Division","PBE",12,21,-9,"12 - 21",8,190,142,277,20164,36100,33,0.358381913834779,12,21,"12 - 21","#0090D4",5,9,"2030"
26,100,166,2030-06-29,1905,9,6,5,"CUN","Cancun Toros","home",1,0,"Eastern Division","PBE",13,21,-8,"13 - 21",5,195,148,282,21904,38025,34,0.365499174022593,12,22,"12 - 22","#0090D4",5,9,"2030"
26,100,171,2030-06-30,1905,9,2,10,"CUN","Cancun Toros","home",0,1,"Eastern Division","PBE",13,22,-9,"13 - 22",8,203,150,292,22500,41209,35,0.353168312169395,12,23,"12 - 23","#0090D4",5,9,"2030"
26,100,174,2030-07-03,1905,9,5,10,"CUN","Cancun Toros","away",0,1,"Eastern Division","PBE",13,23,-10,"13 - 23",6,209,155,302,24025,43681,36,0.354842997666381,13,23,"13 - 23","#0090D4",5,9,"2030"
26,100,179,2030-07-04,1905,9,3,6,"CUN","Cancun Toros","away",0,1,"Eastern Division","PBE",13,24,-11,"13 - 24",5,214,158,308,24964,45796,37,0.3527981910684,13,24,"13 - 24","#0090D4",5,9,"2030"
26,100,184,2030-07-05,1905,9,5,8,"CUN","Cancun Toros","away",0,1,"Eastern Division","PBE",13,25,-12,"13 - 25",7,221,163,316,26569,48841,38,0.352327277549397,13,25,"13 - 25","#0090D4",5,9,"2030"
26,100,189,2030-07-06,1905,10,3,10,"CUN","Cancun Toros","away",0,1,"Eastern Division","PBE",13,26,-13,"13 - 26",4,225,166,326,27556,50625,39,0.352464153694632,14,25,"14 - 25","#0090D4",5,9,"2030"
26,100,195,2030-07-09,1905,9,5,10,"CUN","Cancun Toros","home",0,1,"Eastern Division","PBE",13,27,-14,"13 - 27",7,232,171,336,29241,53824,40,0.352025522181424,14,26,"14 - 26","#0090D4",5,9,"2030"
26,100,200,2030-07-10,1905,9,5,10,"CUN","Cancun Toros","home",1,0,"Eastern Division","PBE",14,27,-13,"14 - 27",0,232,176,346,30976,53824,41,0.365283018867925,15,26,"15 - 26","#0090D4",5,9,"2030"
26,100,205,2030-07-11,1905,9,5,10,"CUN","Cancun Toros","home",0,1,"Eastern Division","PBE",14,28,-14,"14 - 28",6,238,181,356,32761,56644,42,0.366433644650747,15,27,"15 - 27","#0090D4",5,9,"2030"
26,100,210,2030-07-12,1905,9,2,8,"CUN","Cancun Toros","home",0,1,"Eastern Division","PBE",14,29,-15,"14 - 29",8,246,183,364,33489,60516,43,0.356247008137865,15,28,"15 - 28","#0090D4",5,9,"2030"
26,100,215,2030-07-15,1905,9,7,13,"CUN","Cancun Toros","home",0,1,"Eastern Division","PBE",14,30,-16,"14 - 30",8,254,190,377,36100,64516,44,0.358789854496303,16,28,"16 - 28","#0090D4",5,9,"2030"
26,100,220,2030-07-16,1905,9,2,6,"CUN","Cancun Toros","home",0,1,"Eastern Division","PBE",14,31,-17,"14 - 31",13,267,192,383,36864,71289,45,0.340850461845719,15,30,"15 - 30","#0090D4",5,9,"2030"
26,100,225,2030-07-17,1905,9,2,5,"CUN","Cancun Toros","home",0,1,"Eastern Division","PBE",14,32,-18,"14 - 32",6,273,194,388,37636,74529,46,0.335541389916641,15,31,"15 - 31","#0090D4",5,9,"2030"
26,100,230,2030-07-18,1905,9,1,5,"CUN","Cancun Toros","home",0,1,"Eastern Division","PBE",14,33,-19,"14 - 33",5,278,195,393,38025,77284,47,0.329766106721938,15,32,"15 - 32","#0090D4",5,9,"2030"
26,100,238,2030-07-21,1905,9,10,13,"CUN","Cancun Toros","away",1,0,"Eastern Division","PBE",15,33,-18,"15 - 33",7,285,205,406,42025,81225,48,0.340973630831643,16,32,"16 - 32","#0090D4",5,9,"2030"
26,100,243,2030-07-22,1905,10,4,9,"CUN","Cancun Toros","away",0,1,"Eastern Division","PBE",15,34,-19,"15 - 34",5,290,209,415,43681,84100,49,0.3418426839671,17,32,"17 - 32","#0090D4",5,9,"2030"
26,100,248,2030-07-23,1905,9,0,3,"CUN","Cancun Toros","away",0,1,"Eastern Division","PBE",15,35,-20,"15 - 35",2,292,209,418,43681,85264,50,0.338756834309202,17,33,"17 - 33","#0090D4",5,9,"2030"
26,100,253,2030-07-24,1905,9,3,4,"CUN","Cancun Toros","away",0,1,"Eastern Division","PBE",15,36,-21,"15 - 36",7,299,212,422,44944,89401,51,0.334541665115933,17,34,"17 - 34","#0090D4",5,9,"2030"
26,100,254,2030-08-12,1905,9,2,10,"CUN","Cancun Toros","home",0,1,"Eastern Division","PBE",15,37,-22,"15 - 37",5,304,214,432,45796,92416,52,0.33134604810002,17,35,"17 - 35","#0090D4",5,9,"2030"
26,100,259,2030-08-13,1905,9,4,5,"CUN","Cancun Toros","home",0,1,"Eastern Division","PBE",15,38,-23,"15 - 38",5,309,218,437,47524,95481,53,0.332324044613825,18,35,"18 - 35","#0090D4",5,9,"2030"
26,100,264,2030-08-14,1905,9,0,4,"CUN","Cancun Toros","home",0,1,"Eastern Division","PBE",15,39,-24,"15 - 39",5,314,218,441,47524,98596,54,0.32523952915412,18,36,"18 - 36","#0090D4",5,9,"2030"
26,100,269,2030-08-15,1905,10,4,10,"CUN","Cancun Toros","home",0,1,"Eastern Division","PBE",15,40,-25,"15 - 40",5,319,222,451,49284,101761,55,0.326286868151875,18,37,"18 - 37","#0090D4",5,9,"2030"
26,100,274,2030-08-17,1905,9,7,11,"CUN","Cancun Toros","home",1,0,"Eastern Division","PBE",16,40,-24,"16 - 40",3,322,229,462,52441,103684,56,0.335891112890312,19,37,"19 - 37","#0090D4",5,9,"2030"
26,100,278,2030-08-18,1905,9,7,17,"CUN","Cancun Toros","home",1,0,"Eastern Division","PBE",17,40,-23,"17 - 40",3,325,236,479,55696,105625,57,0.345249533538721,20,37,"20 - 37","#0090D4",5,9,"2030"
26,100,283,2030-08-19,1905,9,2,2,"CUN","Cancun Toros","home",0,1,"Eastern Division","PBE",17,41,-24,"17 - 41",6,331,238,481,56644,109561,58,0.340808038265997,20,38,"20 - 38","#0090D4",5,9,"2030"
26,100,288,2030-08-20,1905,9,0,3,"CUN","Cancun Toros","home",0,1,"Eastern Division","PBE",17,42,-25,"17 - 42",5,336,238,484,56644,112896,59,0.334104046242775,20,39,"20 - 39","#0090D4",5,9,"2030"
26,100,293,2030-08-22,1905,10,10,13,"CUN","Cancun Toros","away",1,0,"Eastern Division","PBE",18,42,-24,"18 - 42",6,342,248,497,61504,116964,60,0.344622005065334,21,39,"21 - 39","#0090D4",5,9,"2030"
26,100,297,2030-08-23,1905,9,8,12,"CUN","Cancun Toros","away",1,0,"Eastern Division","PBE",19,42,-23,"19 - 42",4,346,256,509,65536,119716,61,0.353766760952648,22,39,"22 - 39","#0090D4",5,9,"2030"
26,100,628,2030-08-24,1905,9,5,11,"CUN","Cancun Toros","away",1,0,"Eastern Division","PBE",20,42,-22,"20 - 42",2,348,261,520,68121,121104,62,0.36,22,40,"22 - 40","#0090D4",5,9,"2030"
26,100,632,2030-08-25,1905,9,6,8,"CUN","Cancun Toros","away",1,0,"Eastern Division","PBE",21,42,-21,"21 - 42",0,348,267,528,71289,121104,63,0.370538429152828,23,40,"23 - 40","#0090D4",5,9,"2030"
26,100,634,2030-08-27,1905,9,6,10,"CUN","Cancun Toros","away",0,1,"Eastern Division","PBE",21,43,-22,"21 - 43",15,363,273,538,74529,131769,64,0.361268650205043,23,41,"23 - 41","#0090D4",5,9,"2030"
26,100,639,2030-08-28,1905,9,1,5,"CUN","Cancun Toros","away",0,1,"Eastern Division","PBE",21,44,-23,"21 - 44",2,365,274,543,75076,133225,65,0.360420737298429,23,42,"23 - 42","#0090D4",5,9,"2030"
26,100,644,2030-08-29,1905,9,4,11,"CUN","Cancun Toros","away",0,1,"Eastern Division","PBE",21,45,-24,"21 - 45",6,371,278,554,77284,137641,66,0.359585902058858,24,42,"24 - 42","#0090D4",5,9,"2030"
26,100,649,2030-08-30,1905,9,1,6,"CUN","Cancun Toros","away",0,1,"Eastern Division","PBE",21,46,-25,"21 - 46",7,378,279,560,77841,142884,67,0.352660550458716,24,43,"24 - 43","#0090D4",5,9,"2030"
26,100,657,2030-09-02,1905,9,6,8,"CUN","Cancun Toros","home",1,0,"Eastern Division","PBE",22,46,-24,"22 - 46",5,383,285,568,81225,146689,68,0.356384425704432,24,44,"24 - 44","#0090D4",5,9,"2030"
26,100,662,2030-09-03,1905,9,4,6,"CUN","Cancun Toros","home",1,0,"Eastern Division","PBE",23,46,-23,"23 - 46",2,385,289,574,83521,148225,69,0.360398884986149,25,44,"25 - 44","#0090D4",5,9,"2030"
26,100,667,2030-09-04,1905,9,2,9,"CUN","Cancun Toros","home",0,1,"Eastern Division","PBE",23,47,-24,"23 - 47",6,391,291,583,84681,152881,70,0.356458524511496,25,45,"25 - 45","#0090D4",5,9,"2030"
26,100,672,2030-09-05,1905,9,9,14,"CUN","Cancun Toros","home",0,1,"Eastern Division","PBE",23,48,-25,"23 - 48",10,401,300,597,90000,160801,71,0.358850243818805,25,46,"25 - 46","#0090D4",5,9,"2030"
26,100,676,2030-09-08,1905,11,4,5,"CUN","Cancun Toros","away",0,1,"Eastern Division","PBE",23,49,-26,"23 - 49",5,406,304,602,92416,164836,72,0.359243076827391,26,46,"26 - 46","#0090D4",5,9,"2030"
26,100,681,2030-09-09,1905,9,3,10,"CUN","Cancun Toros","away",0,1,"Eastern Division","PBE",23,50,-27,"23 - 50",7,413,307,612,94249,170569,73,0.355901033917634,26,47,"26 - 47","#0090D4",5,9,"2030"
26,100,686,2030-09-10,1905,9,1,6,"CUN","Cancun Toros","away",0,1,"Eastern Division","PBE",23,51,-28,"23 - 51",4,417,308,618,94864,173889,74,0.352978385357559,26,48,"26 - 48","#0090D4",5,9,"2030"
26,100,691,2030-09-11,1905,9,1,4,"CUN","Cancun Toros","away",0,1,"Eastern Division","PBE",23,52,-29,"23 - 52",3,420,309,622,95481,176400,75,0.351186732430733,26,49,"26 - 49","#0090D4",5,9,"2030"
26,100,695,2030-09-14,1905,9,3,5,"CUN","Cancun Toros","away",0,1,"Eastern Division","PBE",23,53,-30,"23 - 53",6,426,312,627,97344,181476,76,0.349128469980633,27,49,"27 - 49","#0090D4",5,9,"2030"
26,100,700,2030-09-15,1905,9,4,9,"CUN","Cancun Toros","away",0,1,"Eastern Division","PBE",23,54,-31,"23 - 54",9,435,316,636,99856,189225,77,0.345425676540485,27,50,"27 - 50","#0090D4",5,9,"2030"
26,100,705,2030-09-16,1905,9,5,8,"CUN","Cancun Toros","away",1,0,"Eastern Division","PBE",24,54,-30,"24 - 54",3,438,321,644,103041,191844,78,0.349427743018465,27,51,"27 - 51","#0090D4",5,9,"2030"
26,100,710,2030-09-17,1905,9,1,5,"CUN","Cancun Toros","away",0,1,"Eastern Division","PBE",24,55,-31,"24 - 55",3,441,322,649,103684,194481,79,0.347740345110928,27,52,"27 - 52","#0090D4",5,9,"2030"
26,100,715,2030-09-20,1905,12,6,12,"CUN","Cancun Toros","away",1,0,"Eastern Division","PBE",25,55,-30,"25 - 55",4,445,328,661,107584,198025,80,0.352031517396412,28,52,"28 - 52","#0090D4",5,9,"2030"
26,100,720,2030-09-21,1905,9,2,8,"CUN","Cancun Toros","away",0,1,"Eastern Division","PBE",25,56,-31,"25 - 56",8,453,330,669,108900,205209,81,0.346694937107819,28,53,"28 - 53","#0090D4",5,9,"2030"
26,100,725,2030-09-22,1905,9,3,8,"CUN","Cancun Toros","away",1,0,"Eastern Division","PBE",26,56,-30,"26 - 56",2,455,333,677,110889,207025,82,0.34880187723724,29,53,"29 - 53","#0090D4",5,9,"2030"
26,100,734,2030-09-25,1905,9,1,6,"CUN","Cancun Toros","home",0,1,"Eastern Division","PBE",26,57,-31,"26 - 57",8,463,334,683,111556,214369,83,0.34227506328143,28,55,"28 - 55","#0090D4",5,9,"2030"
26,100,739,2030-09-26,1905,9,4,7,"CUN","Cancun Toros","home",1,0,"Eastern Division","PBE",27,57,-30,"27 - 57",2,465,338,690,114244,216225,84,0.345702622636314,29,55,"29 - 55","#0090D4",5,9,"2030"
26,100,744,2030-09-27,1905,9,4,10,"CUN","Cancun Toros","home",0,1,"Eastern Division","PBE",27,58,-31,"27 - 58",8,473,342,700,116964,223729,85,0.343312014041967,29,56,"29 - 56","#0090D4",5,9,"2030"
26,100,754,2030-09-30,1905,9,4,12,"CUN","Cancun Toros","home",0,1,"Eastern Division","PBE",27,59,-32,"27 - 59",5,478,346,712,119716,228484,86,0.343813900057438,30,56,"30 - 56","#0090D4",5,9,"2030"
26,100,759,2030-10-01,1905,9,0,6,"CUN","Cancun Toros","home",0,1,"Eastern Division","PBE",27,60,-33,"27 - 60",4,482,346,718,119716,232324,87,0.340063629133053,30,57,"30 - 57","#0090D4",5,9,"2030"
26,100,764,2030-10-02,1905,9,1,3,"CUN","Cancun Toros","home",0,1,"Eastern Division","PBE",27,61,-34,"27 - 61",3,485,347,721,120409,235225,88,0.338575614255105,30,58,"30 - 58","#0090D4",5,9,"2030"
26,100,769,2030-10-03,1905,9,4,8,"CUN","Cancun Toros","home",1,0,"Eastern Division","PBE",28,61,-33,"28 - 61",3,488,351,729,123201,238144,89,0.340951168550831,30,59,"30 - 59","#0090D4",5,9,"2030"
26,100,773,2030-10-05,1905,9,12,13,"CUN","Cancun Toros","away",1,0,"Eastern Division","PBE",29,61,-32,"29 - 61",5,493,363,742,131769,243049,90,0.351554621176144,32,58,"32 - 58","#0090D4",5,9,"2030"
26,100,777,2030-10-06,1905,11,7,16,"CUN","Cancun Toros","away",1,0,"Eastern Division","PBE",30,61,-31,"30 - 61",4,497,370,758,136900,247009,91,0.356594922234175,32,59,"32 - 59","#0090D4",5,9,"2030"
27,100,3,2030-05-15,1905,9,0,4,"NSH","Nashville Stars","away",0,1,"Western Division","PBE",0,1,-1,"0 - 1",6,6,0,4,0,36,1,0,0,1,"0 - 1","#AC0000",5,10,"2030"
27,100,8,2030-05-16,1905,9,3,9,"NSH","Nashville Stars","away",0,1,"Western Division","PBE",0,2,-2,"0 - 2",9,15,3,13,9,225,2,0.0384615384615385,0,2,"0 - 2","#AC0000",5,10,"2030"
27,100,13,2030-05-17,1905,9,2,6,"NSH","Nashville Stars","away",0,1,"Western Division","PBE",0,3,-3,"0 - 3",6,21,5,19,25,441,3,0.0536480686695279,0,3,"0 - 3","#AC0000",5,10,"2030"
27,100,18,2030-05-18,1905,9,4,7,"NSH","Nashville Stars","away",0,1,"Western Division","PBE",0,4,-4,"0 - 4",6,27,9,26,81,729,4,0.1,0,4,"0 - 4","#AC0000",5,10,"2030"
27,100,24,2030-05-21,1905,9,5,6,"NSH","Nashville Stars","home",0,1,"Western Division","PBE",0,5,-5,"0 - 5",7,34,14,32,196,1156,5,0.144970414201183,1,4,"1 - 4","#AC0000",5,10,"2030"
27,100,29,2030-05-22,1905,9,0,4,"NSH","Nashville Stars","home",0,1,"Western Division","PBE",0,6,-6,"0 - 6",6,40,14,36,196,1600,6,0.10913140311804,1,5,"1 - 5","#AC0000",5,10,"2030"
27,100,34,2030-05-23,1905,9,7,9,"NSH","Nashville Stars","home",0,1,"Western Division","PBE",0,7,-7,"0 - 7",16,56,21,45,441,3136,7,0.123287671232877,1,6,"1 - 6","#AC0000",5,10,"2030"
27,100,38,2030-05-24,1905,9,2,8,"NSH","Nashville Stars","home",0,1,"Western Division","PBE",0,8,-8,"0 - 8",23,79,23,53,529,6241,8,0.0781388478581979,1,7,"1 - 7","#AC0000",5,10,"2030"
27,100,47,2030-05-27,1905,9,2,3,"NSH","Nashville Stars","home",1,0,"Western Division","PBE",1,8,-7,"1 - 8",0,79,25,56,625,6241,9,0.0910282551704049,1,8,"1 - 8","#AC0000",5,10,"2030"
27,100,52,2030-05-28,1905,9,3,4,"NSH","Nashville Stars","home",0,1,"Western Division","PBE",1,9,-8,"1 - 9",11,90,28,60,784,8100,10,0.0882485366951823,1,9,"1 - 9","#AC0000",5,10,"2030"
27,100,57,2030-05-29,1905,9,4,10,"NSH","Nashville Stars","home",0,1,"Western Division","PBE",1,10,-9,"1 - 10",8,98,32,70,1024,9604,11,0.0963492660895747,1,10,"1 - 10","#AC0000",5,10,"2030"
27,100,62,2030-06-01,1905,9,0,6,"NSH","Nashville Stars","away",0,1,"Western Division","PBE",1,11,-10,"1 - 11",6,104,32,76,1024,10816,12,0.0864864864864865,1,11,"1 - 11","#AC0000",5,10,"2030"
27,100,67,2030-06-02,1905,9,4,9,"NSH","Nashville Stars","away",1,0,"Western Division","PBE",2,11,-9,"2 - 11",3,107,36,85,1296,11449,13,0.101686936053354,1,12,"1 - 12","#AC0000",5,10,"2030"
27,100,72,2030-06-03,1905,9,0,5,"NSH","Nashville Stars","away",0,1,"Western Division","PBE",2,12,-10,"2 - 12",4,111,36,90,1296,12321,14,0.0951751487111699,1,13,"1 - 13","#AC0000",5,10,"2030"
27,100,77,2030-06-04,1905,9,9,13,"NSH","Nashville Stars","away",0,1,"Western Division","PBE",2,13,-11,"2 - 13",13,124,45,103,2025,15376,15,0.116372622263088,2,13,"2 - 13","#AC0000",5,10,"2030"
27,100,87,2030-06-07,1905,12,4,12,"NSH","Nashville Stars","away",1,0,"Western Division","PBE",3,13,-10,"3 - 13",2,126,49,115,2401,15876,16,0.131367292225201,2,14,"2 - 14","#AC0000",5,10,"2030"
27,100,92,2030-06-08,1905,9,0,1,"NSH","Nashville Stars","away",0,1,"Western Division","PBE",3,14,-11,"3 - 14",3,129,49,116,2401,16641,17,0.126089696460456,2,15,"2 - 15","#AC0000",5,10,"2030"
27,100,96,2030-06-09,1905,9,2,4,"NSH","Nashville Stars","away",0,1,"Western Division","PBE",3,15,-12,"3 - 15",5,134,51,120,2601,17956,18,0.126526244101766,2,16,"2 - 16","#AC0000",5,10,"2030"
27,100,98,2030-06-11,1905,9,0,5,"NSH","Nashville Stars","home",0,1,"Western Division","PBE",3,16,-13,"3 - 16",6,140,51,125,2601,19600,19,0.117156884825008,2,17,"2 - 17","#AC0000",5,10,"2030"
27,100,103,2030-06-12,1905,9,1,4,"NSH","Nashville Stars","home",0,1,"Western Division","PBE",3,17,-14,"3 - 17",9,149,52,129,2704,22201,20,0.108572575787994,2,18,"2 - 18","#AC0000",5,10,"2030"
27,100,108,2030-06-13,1905,9,2,5,"NSH","Nashville Stars","home",0,1,"Western Division","PBE",3,18,-15,"3 - 18",8,157,54,134,2916,24649,21,0.105786323235988,2,19,"2 - 19","#AC0000",5,10,"2030"
27,100,112,2030-06-14,1905,9,3,6,"NSH","Nashville Stars","home",0,1,"Western Division","PBE",3,19,-16,"3 - 19",4,161,57,140,3249,25921,22,0.111381556393555,2,20,"2 - 20","#AC0000",5,10,"2030"
27,100,118,2030-06-16,1905,9,5,10,"NSH","Nashville Stars","home",1,0,"Western Division","PBE",4,19,-15,"4 - 19",4,165,62,150,3844,27225,23,0.123724612958254,3,20,"3 - 20","#AC0000",5,10,"2030"
27,100,123,2030-06-17,1905,10,3,6,"NSH","Nashville Stars","home",0,1,"Western Division","PBE",4,20,-16,"4 - 20",5,170,65,156,4225,28900,24,0.127547169811321,3,21,"3 - 21","#AC0000",5,10,"2030"
27,100,128,2030-06-18,1905,9,3,5,"NSH","Nashville Stars","home",0,1,"Western Division","PBE",4,21,-17,"4 - 21",4,174,68,161,4624,30276,25,0.132492836676218,3,22,"3 - 22","#AC0000",5,10,"2030"
27,100,133,2030-06-19,1905,9,1,4,"NSH","Nashville Stars","home",0,1,"Western Division","PBE",4,22,-18,"4 - 22",2,176,69,165,4761,30976,26,0.13322327000028,3,23,"3 - 23","#AC0000",5,10,"2030"
27,100,138,2030-06-22,1905,9,9,13,"NSH","Nashville Stars","away",1,0,"Western Division","PBE",5,22,-17,"5 - 22",3,179,78,178,6084,32041,27,0.159580327868852,4,23,"4 - 23","#AC0000",5,10,"2030"
27,100,143,2030-06-23,1905,9,0,3,"NSH","Nashville Stars","away",0,1,"Western Division","PBE",5,23,-18,"5 - 23",2,181,78,181,6084,32761,28,0.156622473934869,4,24,"4 - 24","#AC0000",5,10,"2030"
27,100,148,2030-06-24,1905,9,0,9,"NSH","Nashville Stars","away",0,1,"Western Division","PBE",5,24,-19,"5 - 24",10,191,78,190,6084,36481,29,0.142934335721837,4,25,"4 - 25","#AC0000",5,10,"2030"
27,100,153,2030-06-25,1905,9,0,4,"NSH","Nashville Stars","away",0,1,"Western Division","PBE",5,25,-20,"5 - 25",1,192,78,194,6084,36864,30,0.141659681475272,4,26,"4 - 26","#AC0000",5,10,"2030"
27,100,157,2030-06-27,1905,9,1,4,"NSH","Nashville Stars","home",0,1,"Western Division","PBE",5,26,-21,"5 - 26",11,203,79,198,6241,41209,31,0.131527924130664,4,27,"4 - 27","#AC0000",5,10,"2030"
27,100,162,2030-06-28,1905,9,0,2,"NSH","Nashville Stars","home",0,1,"Western Division","PBE",5,27,-22,"5 - 27",8,211,79,200,6241,44521,32,0.122946298412198,4,28,"4 - 28","#AC0000",5,10,"2030"
27,100,167,2030-06-29,1905,9,6,7,"NSH","Nashville Stars","home",0,1,"Western Division","PBE",5,28,-23,"5 - 28",10,221,85,207,7225,48841,33,0.128865979381443,4,29,"4 - 29","#AC0000",5,10,"2030"
27,100,172,2030-06-30,1905,9,3,5,"NSH","Nashville Stars","home",1,0,"Western Division","PBE",6,28,-22,"6 - 28",2,223,88,212,7744,49729,34,0.13474153080577,5,29,"5 - 29","#AC0000",5,10,"2030"
27,100,178,2030-07-03,1905,9,0,3,"NSH","Nashville Stars","away",0,1,"Western Division","PBE",6,29,-23,"6 - 29",11,234,88,215,7744,54756,35,0.123904,4,31,"4 - 31","#AC0000",5,10,"2030"
27,100,183,2030-07-04,1905,9,2,4,"NSH","Nashville Stars","away",0,1,"Western Division","PBE",6,30,-24,"6 - 30",7,241,90,219,8100,58081,36,0.122391622973361,4,32,"4 - 32","#AC0000",5,10,"2030"
27,100,188,2030-07-05,1905,9,1,2,"NSH","Nashville Stars","away",0,1,"Western Division","PBE",6,31,-25,"6 - 31",9,250,91,221,8281,62500,37,0.116994673711872,4,33,"4 - 33","#AC0000",5,10,"2030"
27,100,193,2030-07-06,1905,9,1,6,"NSH","Nashville Stars","away",0,1,"Western Division","PBE",6,32,-26,"6 - 32",7,257,92,227,8464,66049,38,0.113590917021191,4,34,"4 - 34","#AC0000",5,10,"2030"
27,100,196,2030-07-09,1905,9,2,7,"NSH","Nashville Stars","away",0,1,"Western Division","PBE",6,33,-27,"6 - 33",5,262,94,234,8836,68644,39,0.114042333505421,4,35,"4 - 35","#AC0000",5,10,"2030"
27,100,201,2030-07-10,1905,9,2,4,"NSH","Nashville Stars","away",1,0,"Western Division","PBE",7,33,-26,"7 - 33",1,263,96,238,9216,69169,40,0.117573515340945,5,35,"5 - 35","#AC0000",5,10,"2030"
27,100,206,2030-07-11,1905,9,3,4,"NSH","Nashville Stars","away",0,1,"Western Division","PBE",7,34,-27,"7 - 34",5,268,99,242,9801,71824,41,0.120073506891271,5,36,"5 - 36","#AC0000",5,10,"2030"
27,100,211,2030-07-12,1905,9,2,7,"NSH","Nashville Stars","away",0,1,"Western Division","PBE",7,35,-28,"7 - 35",5,273,101,249,10201,74529,42,0.120394193319958,5,37,"5 - 37","#AC0000",5,10,"2030"
27,100,216,2030-07-15,1905,9,5,11,"NSH","Nashville Stars","home",0,1,"Western Division","PBE",7,36,-29,"7 - 36",7,280,106,260,11236,78400,43,0.12535142130394,5,38,"5 - 38","#AC0000",5,10,"2030"
27,100,221,2030-07-16,1905,9,2,5,"NSH","Nashville Stars","home",1,0,"Western Division","PBE",8,36,-28,"8 - 36",0,280,108,265,11664,78400,44,0.12950790548943,6,38,"6 - 38","#AC0000",5,10,"2030"
27,100,226,2030-07-17,1905,10,1,8,"NSH","Nashville Stars","home",0,1,"Western Division","PBE",8,37,-29,"8 - 37",2,282,109,273,11881,79524,45,0.12998194847109,6,39,"6 - 39","#AC0000",5,10,"2030"
27,100,231,2030-07-18,1905,9,7,13,"NSH","Nashville Stars","home",1,0,"Western Division","PBE",9,37,-28,"9 - 37",1,283,116,286,13456,80089,46,0.143845208188572,7,39,"7 - 39","#AC0000",5,10,"2030"
27,100,235,2030-07-21,1905,9,3,7,"NSH","Nashville Stars","away",0,1,"Western Division","PBE",9,38,-29,"9 - 38",12,295,119,293,14161,87025,47,0.139950190737849,7,40,"7 - 40","#AC0000",5,10,"2030"
27,100,240,2030-07-22,1905,11,5,14,"NSH","Nashville Stars","away",1,0,"Western Division","PBE",10,38,-28,"10 - 38",4,299,124,307,15376,89401,48,0.146749763784037,7,41,"7 - 41","#AC0000",5,10,"2030"
27,100,245,2030-07-23,1905,9,0,4,"NSH","Nashville Stars","away",0,1,"Western Division","PBE",10,39,-29,"10 - 39",4,303,124,311,15376,91809,49,0.143452908522648,7,42,"7 - 42","#AC0000",5,10,"2030"
27,100,250,2030-07-24,1905,9,0,1,"NSH","Nashville Stars","away",0,1,"Western Division","PBE",10,40,-30,"10 - 40",2,305,124,312,15376,93025,50,0.141843709928875,7,43,"7 - 43","#AC0000",5,10,"2030"
27,100,258,2030-08-12,1905,9,3,8,"NSH","Nashville Stars","away",0,1,"Western Division","PBE",10,41,-31,"10 - 41",5,310,127,320,16129,96100,51,0.14371508255442,7,44,"7 - 44","#AC0000",5,10,"2030"
27,100,263,2030-08-13,1905,9,3,7,"NSH","Nashville Stars","away",0,1,"Western Division","PBE",10,42,-32,"10 - 42",8,318,130,327,16900,101124,52,0.143191215346031,7,45,"7 - 45","#AC0000",5,10,"2030"
27,100,268,2030-08-14,1905,9,6,10,"NSH","Nashville Stars","away",1,0,"Western Division","PBE",11,42,-31,"11 - 42",5,323,136,337,18496,104329,53,0.150588235294118,8,45,"8 - 45","#AC0000",5,10,"2030"
27,100,276,2030-08-17,1905,12,1,7,"NSH","Nashville Stars","home",0,1,"Western Division","PBE",11,43,-32,"11 - 43",2,325,137,344,18769,105625,54,0.150883483126196,8,46,"8 - 46","#AC0000",5,10,"2030"
27,100,280,2030-08-18,1905,9,1,6,"NSH","Nashville Stars","home",0,1,"Western Division","PBE",11,44,-33,"11 - 44",11,336,138,350,19044,112896,55,0.144338335607094,8,47,"8 - 47","#AC0000",5,10,"2030"
27,100,285,2030-08-19,1905,12,5,10,"NSH","Nashville Stars","home",0,1,"Western Division","PBE",11,45,-34,"11 - 45",9,345,143,360,20449,119025,56,0.146615139739306,8,48,"8 - 48","#AC0000",5,10,"2030"
27,100,290,2030-08-20,1905,15,2,12,"NSH","Nashville Stars","home",0,1,"Western Division","PBE",11,46,-35,"11 - 46",3,348,145,372,21025,121104,57,0.14792899408284,8,49,"8 - 49","#AC0000",5,10,"2030"
27,100,293,2030-08-22,1905,10,6,9,"NSH","Nashville Stars","home",0,1,"Western Division","PBE",11,47,-36,"11 - 47",10,358,151,381,22801,128164,58,0.151035008114464,9,49,"9 - 49","#AC0000",5,10,"2030"
27,100,297,2030-08-23,1905,9,4,5,"NSH","Nashville Stars","home",0,1,"Western Division","PBE",11,48,-37,"11 - 48",8,366,155,386,24025,133956,59,0.152075249555326,9,50,"9 - 50","#AC0000",5,10,"2030"
27,100,628,2030-08-24,1905,9,2,4,"NSH","Nashville Stars","home",0,1,"Western Division","PBE",11,49,-38,"11 - 49",5,371,157,390,24649,137641,60,0.151882432682236,9,51,"9 - 51","#AC0000",5,10,"2030"
27,100,632,2030-08-25,1905,9,0,4,"NSH","Nashville Stars","home",0,1,"Western Division","PBE",11,50,-39,"11 - 50",6,377,157,394,24649,142129,61,0.147795272757798,9,52,"9 - 52","#AC0000",5,10,"2030"
27,100,637,2030-08-27,1905,9,0,7,"NSH","Nashville Stars","away",0,1,"Western Division","PBE",11,51,-40,"11 - 51",13,390,157,401,24649,152100,62,0.139457648982455,9,53,"9 - 53","#AC0000",5,10,"2030"
27,100,642,2030-08-28,1905,9,0,6,"NSH","Nashville Stars","away",0,1,"Western Division","PBE",11,52,-41,"11 - 52",1,391,157,407,24649,152881,63,0.138844139018757,9,54,"9 - 54","#AC0000",5,10,"2030"
27,100,647,2030-08-29,1905,9,1,5,"NSH","Nashville Stars","away",0,1,"Western Division","PBE",11,53,-42,"11 - 53",4,395,158,412,24964,156025,64,0.137931034482759,9,55,"9 - 55","#AC0000",5,10,"2030"
27,100,652,2030-08-30,1905,9,0,4,"NSH","Nashville Stars","away",0,1,"Western Division","PBE",11,54,-43,"11 - 54",3,398,158,416,24964,158404,65,0.136141529601675,9,56,"9 - 56","#AC0000",5,10,"2030"
27,100,655,2030-09-02,1905,9,1,5,"NSH","Nashville Stars","home",1,0,"Western Division","PBE",12,54,-42,"12 - 54",0,398,159,421,25281,158404,66,0.137632359746305,9,57,"9 - 57","#AC0000",5,10,"2030"
27,100,660,2030-09-03,1905,9,4,7,"NSH","Nashville Stars","home",1,0,"Western Division","PBE",13,54,-41,"13 - 54",3,401,163,428,26569,160801,67,0.141799647755777,10,57,"10 - 57","#AC0000",5,10,"2030"
27,100,665,2030-09-04,1905,9,6,11,"NSH","Nashville Stars","home",0,1,"Western Division","PBE",13,55,-42,"13 - 55",8,409,169,439,28561,167281,68,0.145836950194545,10,58,"10 - 58","#AC0000",5,10,"2030"
27,100,670,2030-09-05,1905,9,1,2,"NSH","Nashville Stars","home",0,1,"Western Division","PBE",13,56,-43,"13 - 56",3,412,170,441,28900,169744,69,0.145486397776928,10,59,"10 - 59","#AC0000",5,10,"2030"
27,100,677,2030-09-08,1905,9,0,3,"NSH","Nashville Stars","home",0,1,"Western Division","PBE",13,57,-44,"13 - 57",11,423,170,444,28900,178929,70,0.139056628285754,10,60,"10 - 60","#AC0000",5,10,"2030"
27,100,682,2030-09-09,1905,9,1,4,"NSH","Nashville Stars","home",0,1,"Western Division","PBE",13,58,-45,"13 - 58",10,433,171,448,29241,187489,71,0.134919023670004,10,61,"10 - 61","#AC0000",5,10,"2030"
27,100,687,2030-09-10,1905,10,2,1,"NSH","Nashville Stars","home",0,1,"Western Division","PBE",13,59,-46,"13 - 59",3,436,173,449,29929,190096,72,0.136025451653221,10,62,"10 - 62","#AC0000",5,10,"2030"
27,100,692,2030-09-11,1905,9,1,7,"NSH","Nashville Stars","home",0,1,"Western Division","PBE",13,60,-47,"13 - 60",4,440,174,456,30276,193600,73,0.135235576837178,10,63,"10 - 63","#AC0000",5,10,"2030"
27,100,696,2030-09-14,1905,9,0,4,"NSH","Nashville Stars","away",0,1,"Western Division","PBE",13,61,-48,"13 - 61",8,448,174,460,30276,200704,74,0.131076283660923,10,64,"10 - 64","#AC0000",5,10,"2030"
27,100,701,2030-09-15,1905,9,0,4,"NSH","Nashville Stars","away",0,1,"Western Division","PBE",13,62,-49,"13 - 62",10,458,174,464,30276,209764,75,0.126128978503583,9,66,"9 - 66","#AC0000",5,10,"2030"
27,100,706,2030-09-16,1905,9,1,5,"NSH","Nashville Stars","away",0,1,"Western Division","PBE",13,63,-50,"13 - 63",8,466,175,469,30625,217156,76,0.123597047392657,9,67,"9 - 67","#AC0000",5,10,"2030"
27,100,711,2030-09-17,1905,9,3,9,"NSH","Nashville Stars","away",0,1,"Western Division","PBE",13,64,-51,"13 - 64",8,474,178,478,31684,224676,77,0.123591823997504,10,67,"10 - 67","#AC0000",5,10,"2030"
27,100,716,2030-09-20,1905,9,1,7,"NSH","Nashville Stars","home",0,1,"Western Division","PBE",13,65,-52,"13 - 65",6,480,179,485,32041,230400,78,0.122088393200757,10,68,"10 - 68","#AC0000",5,10,"2030"
27,100,721,2030-09-21,1905,9,2,5,"NSH","Nashville Stars","home",0,1,"Western Division","PBE",13,66,-53,"13 - 66",3,483,181,490,32761,233289,79,0.123138507799286,10,69,"10 - 69","#AC0000",5,10,"2030"
27,100,726,2030-09-22,1905,9,3,5,"NSH","Nashville Stars","home",1,0,"Western Division","PBE",14,66,-52,"14 - 66",2,485,184,495,33856,235225,80,0.125820849483984,10,70,"10 - 70","#AC0000",5,10,"2030"
27,100,730,2030-09-23,1905,9,3,6,"NSH","Nashville Stars","home",0,1,"Western Division","PBE",14,67,-53,"14 - 67",7,492,187,501,34969,242064,81,0.126226839401804,10,71,"10 - 71","#AC0000",5,10,"2030"
27,100,735,2030-09-25,1905,9,6,13,"NSH","Nashville Stars","away",1,0,"Western Division","PBE",15,67,-52,"15 - 67",4,496,193,514,37249,246016,82,0.131498773233545,11,71,"11 - 71","#AC0000",5,10,"2030"
27,100,740,2030-09-26,1905,9,2,7,"NSH","Nashville Stars","away",0,1,"Western Division","PBE",15,68,-53,"15 - 68",8,504,195,521,38025,254016,83,0.130204320626213,11,72,"11 - 72","#AC0000",5,10,"2030"
27,100,745,2030-09-27,1905,9,0,5,"NSH","Nashville Stars","away",0,1,"Western Division","PBE",15,69,-54,"15 - 69",20,524,195,526,38025,274576,84,0.121640685730372,10,74,"10 - 74","#AC0000",5,10,"2030"
27,100,749,2030-09-28,1905,9,2,11,"NSH","Nashville Stars","away",0,1,"Western Division","PBE",15,70,-55,"15 - 70",3,527,197,537,38809,277729,85,0.122604553007854,10,75,"10 - 75","#AC0000",5,10,"2030"
27,100,753,2030-09-30,1905,9,3,5,"NSH","Nashville Stars","home",0,1,"Western Division","PBE",15,71,-56,"15 - 71",5,532,200,542,40000,283024,86,0.123829808311457,11,75,"11 - 75","#AC0000",5,10,"2030"
27,100,758,2030-10-01,1905,9,0,7,"NSH","Nashville Stars","home",0,1,"Western Division","PBE",15,72,-57,"15 - 72",8,540,200,549,40000,291600,87,0.120627261761158,10,77,"10 - 77","#AC0000",5,10,"2030"
27,100,763,2030-10-02,1905,9,3,6,"NSH","Nashville Stars","home",0,1,"Western Division","PBE",15,73,-58,"15 - 73",6,546,203,555,41209,298116,88,0.1214440433213,11,77,"11 - 77","#AC0000",5,10,"2030"
27,100,768,2030-10-03,1905,9,0,0,"NSH","Nashville Stars","home",0,1,"Western Division","PBE",15,74,-59,"15 - 74",5,551,203,555,41209,303601,89,0.119512195121951,11,78,"11 - 78","#AC0000",5,10,"2030"
27,100,778,2030-10-06,1905,9,0,3,"NSH","Nashville Stars","home",0,1,"Western Division","PBE",15,75,-60,"15 - 75",5,556,203,558,41209,309136,90,0.117624056287374,11,79,"11 - 79","#AC0000",5,10,"2030"
28,101,303,2030-05-15,1905,9,5,6,"KC","Kansas City Hepcats","home",1,0,"West Division","MiLPBE",1,0,1,"1 - 0",4,4,5,6,25,16,1,0.609756097560976,1,0,"1 - 0","#6595E3",3,4,"2030"
28,101,306,2030-05-16,1905,9,0,3,"KC","Kansas City Hepcats","home",0,1,"West Division","MiLPBE",1,1,0,"1 - 1",13,17,5,9,25,289,2,0.0796178343949045,0,2,"0 - 2","#6595E3",3,4,"2030"
28,101,309,2030-05-17,1905,9,3,11,"KC","Kansas City Hepcats","home",0,1,"West Division","MiLPBE",1,2,-1,"1 - 2",4,21,8,20,64,441,3,0.126732673267327,0,3,"0 - 3","#6595E3",3,4,"2030"
28,101,312,2030-05-18,1905,12,5,12,"KC","Kansas City Hepcats","home",0,1,"West Division","MiLPBE",1,3,-2,"1 - 3",8,29,13,32,169,841,4,0.167326732673267,1,3,"1 - 3","#6595E3",3,4,"2030"
28,101,314,2030-05-20,1905,9,8,9,"KC","Kansas City Hepcats","home",1,0,"West Division","MiLPBE",2,3,-1,"2 - 3",1,30,21,41,441,900,5,0.328859060402685,2,3,"2 - 3","#6595E3",3,4,"2030"
28,101,317,2030-05-21,1905,9,6,11,"KC","Kansas City Hepcats","home",1,0,"West Division","MiLPBE",3,3,0,"3 - 3",3,33,27,52,729,1089,6,0.400990099009901,2,4,"2 - 4","#6595E3",3,4,"2030"
28,101,320,2030-05-22,1905,9,5,15,"KC","Kansas City Hepcats","home",0,1,"West Division","MiLPBE",3,4,-1,"3 - 4",9,42,32,67,1024,1764,7,0.367288378766141,3,4,"3 - 4","#6595E3",3,4,"2030"
28,101,323,2030-05-23,1905,9,4,9,"KC","Kansas City Hepcats","home",0,1,"West Division","MiLPBE",3,5,-2,"3 - 5",11,53,36,76,1296,2809,8,0.315712545676005,3,5,"3 - 5","#6595E3",3,4,"2030"
28,101,327,2030-05-26,1905,9,2,9,"KC","Kansas City Hepcats","home",0,1,"West Division","MiLPBE",3,6,-3,"3 - 6",6,59,38,85,1444,3481,9,0.293197969543147,3,6,"3 - 6","#6595E3",3,4,"2030"
28,101,330,2030-05-27,1905,9,3,7,"KC","Kansas City Hepcats","home",1,0,"West Division","MiLPBE",4,6,-2,"4 - 6",1,60,41,92,1681,3600,10,0.318310925960992,3,7,"3 - 7","#6595E3",3,4,"2030"
28,101,333,2030-05-28,1905,9,6,9,"KC","Kansas City Hepcats","home",1,0,"West Division","MiLPBE",5,6,-1,"5 - 6",2,62,47,101,2209,3844,11,0.364943003469354,4,7,"4 - 7","#6595E3",3,4,"2030"
28,101,336,2030-05-29,1905,9,7,12,"KC","Kansas City Hepcats","home",0,1,"West Division","MiLPBE",5,7,-2,"5 - 7",8,70,54,113,2916,4900,12,0.373080859774821,4,8,"4 - 8","#6595E3",3,4,"2030"
28,101,340,2030-06-01,1905,9,10,14,"KC","Kansas City Hepcats","away",1,0,"West Division","MiLPBE",6,7,-1,"6 - 7",3,73,64,127,4096,5329,13,0.434588859416446,6,7,"6 - 7","#6595E3",3,4,"2030"
28,101,343,2030-06-02,1905,10,6,8,"KC","Kansas City Hepcats","away",1,0,"West Division","MiLPBE",7,7,0,"7 - 7",3,76,70,135,4900,5776,14,0.458973398276508,6,8,"6 - 8","#6595E3",3,4,"2030"
28,101,346,2030-06-03,1905,9,6,11,"KC","Kansas City Hepcats","away",1,0,"West Division","MiLPBE",8,7,1,"8 - 7",0,76,76,146,5776,5776,15,0.5,8,7,"8 - 7","#6595E3",3,4,"2030"
28,101,349,2030-06-04,1905,9,1,5,"KC","Kansas City Hepcats","away",0,1,"West Division","MiLPBE",8,8,0,"8 - 8",3,79,77,151,5929,6241,16,0.487181594083813,8,8,"8 - 8","#6595E3",3,4,"2030"
28,101,352,2030-06-07,1905,12,3,12,"KC","Kansas City Hepcats","home",1,0,"West Division","MiLPBE",9,8,1,"9 - 8",2,81,80,163,6400,6561,17,0.493789059486151,8,9,"8 - 9","#6595E3",3,4,"2030"
28,101,355,2030-06-08,1905,9,6,9,"KC","Kansas City Hepcats","home",0,1,"West Division","MiLPBE",9,9,0,"9 - 9",10,91,86,172,7396,8281,18,0.471773936339861,8,10,"8 - 10","#6595E3",3,4,"2030"
28,101,358,2030-06-09,1905,9,4,5,"KC","Kansas City Hepcats","home",0,1,"West Division","MiLPBE",9,10,-1,"9 - 10",11,102,90,177,8100,10404,19,0.437743190661479,8,11,"8 - 11","#6595E3",3,4,"2030"
28,101,361,2030-06-10,1905,9,3,6,"KC","Kansas City Hepcats","home",1,0,"West Division","MiLPBE",10,10,0,"10 - 10",1,103,93,183,8649,10609,20,0.449112057326825,9,11,"9 - 11","#6595E3",3,4,"2030"
28,101,363,2030-06-13,1905,9,13,12,"KC","Kansas City Hepcats","away",1,0,"West Division","MiLPBE",11,10,1,"11 - 10",4,107,106,195,11236,11449,21,0.495305267798104,10,11,"10 - 11","#6595E3",3,4,"2030"
28,101,366,2030-06-14,1905,9,9,12,"KC","Kansas City Hepcats","away",1,0,"West Division","MiLPBE",12,10,2,"12 - 10",8,115,115,207,13225,13225,22,0.5,11,11,"11 - 11","#6595E3",3,4,"2030"
28,101,369,2030-06-15,1905,9,9,12,"KC","Kansas City Hepcats","away",1,0,"West Division","MiLPBE",13,10,3,"13 - 10",8,123,124,219,15376,15129,23,0.504048516636617,12,11,"12 - 11","#6595E3",3,4,"2030"
28,101,372,2030-06-16,1905,9,6,8,"KC","Kansas City Hepcats","away",1,0,"West Division","MiLPBE",14,10,4,"14 - 10",2,125,130,227,16900,15625,24,0.519600307455803,12,12,"12 - 12","#6595E3",3,4,"2030"
28,101,374,2030-06-19,1905,9,2,7,"KC","Kansas City Hepcats","away",0,1,"West Division","MiLPBE",14,11,3,"14 - 11",5,130,132,234,17424,16900,25,0.507633142990327,13,12,"13 - 12","#6595E3",3,4,"2030"
28,101,377,2030-06-20,1905,9,9,14,"KC","Kansas City Hepcats","away",0,1,"West Division","MiLPBE",14,12,2,"14 - 12",12,142,141,248,19881,20164,26,0.496466475215383,13,13,"13 - 13","#6595E3",3,4,"2030"
28,101,380,2030-06-21,1905,9,1,9,"KC","Kansas City Hepcats","away",0,1,"West Division","MiLPBE",14,13,1,"14 - 13",5,147,142,257,20164,21609,27,0.482704139037177,13,14,"13 - 14","#6595E3",3,4,"2030"
28,101,509,2030-06-22,1905,9,5,11,"KC","Kansas City Hepcats","away",1,0,"West Division","MiLPBE",15,13,2,"15 - 13",4,151,147,268,21609,22801,28,0.486579599189372,14,14,"14 - 14","#6595E3",3,4,"2030"
28,101,513,2030-07-14,1905,9,11,17,"KC","Kansas City Hepcats","home",1,0,"West Division","MiLPBE",16,13,3,"16 - 13",5,156,158,285,24964,24336,29,0.506369168356998,15,14,"15 - 14","#6595E3",3,4,"2030"
28,101,516,2030-06-24,1905,9,1,7,"KC","Kansas City Hepcats","away",0,1,"West Division","MiLPBE",16,14,2,"16 - 14",6,162,159,292,25281,26244,30,0.490655021834061,15,15,"15 - 15","#6595E3",3,4,"2030"
28,101,519,2030-06-25,1905,9,0,9,"KC","Kansas City Hepcats","away",0,1,"West Division","MiLPBE",16,15,1,"16 - 15",11,173,159,301,25281,29929,31,0.457906176417316,14,17,"14 - 17","#6595E3",3,4,"2030"
28,101,522,2030-06-26,1905,9,8,13,"KC","Kansas City Hepcats","away",1,0,"West Division","MiLPBE",17,15,2,"17 - 15",1,174,167,314,27889,30276,32,0.479480787415112,15,17,"15 - 17","#6595E3",3,4,"2030"
28,101,525,2030-06-27,1905,9,2,8,"KC","Kansas City Hepcats","away",0,1,"West Division","MiLPBE",17,16,1,"17 - 16",6,180,169,322,28561,32400,33,0.468512655632289,15,18,"15 - 18","#6595E3",3,4,"2030"
28,101,529,2030-06-30,1905,9,1,7,"KC","Kansas City Hepcats","home",0,1,"West Division","MiLPBE",17,17,0,"17 - 17",7,187,170,329,28900,34969,34,0.452488687782805,15,19,"15 - 19","#6595E3",3,4,"2030"
28,101,532,2030-07-01,1905,9,2,9,"KC","Kansas City Hepcats","home",0,1,"West Division","MiLPBE",17,18,-1,"17 - 18",5,192,172,338,29584,36864,35,0.445220322658319,16,19,"16 - 19","#6595E3",3,4,"2030"
28,101,535,2030-07-02,1905,9,7,11,"KC","Kansas City Hepcats","home",1,0,"West Division","MiLPBE",18,18,0,"18 - 18",2,194,179,349,32041,37636,36,0.459850452803651,17,19,"17 - 19","#6595E3",3,4,"2030"
28,101,538,2030-07-03,1905,9,5,17,"KC","Kansas City Hepcats","home",0,1,"West Division","MiLPBE",18,19,-1,"18 - 19",8,202,184,366,33856,40804,37,0.453469059737477,17,20,"17 - 20","#6595E3",3,4,"2030"
28,101,541,2030-07-06,1905,9,8,13,"KC","Kansas City Hepcats","away",1,0,"West Division","MiLPBE",19,19,0,"19 - 19",5,207,192,379,36864,42849,38,0.462459071920515,18,20,"18 - 20","#6595E3",3,4,"2030"
28,101,544,2030-07-07,1905,9,2,4,"KC","Kansas City Hepcats","away",0,1,"West Division","MiLPBE",19,20,-1,"19 - 20",3,210,194,383,37636,44100,39,0.460458060095919,18,21,"18 - 21","#6595E3",3,4,"2030"
28,101,547,2030-07-08,1905,9,7,14,"KC","Kansas City Hepcats","away",0,1,"West Division","MiLPBE",19,21,-2,"19 - 21",9,219,201,397,40401,47961,40,0.457221430026482,18,22,"18 - 22","#6595E3",3,4,"2030"
28,101,550,2030-07-09,1905,9,6,13,"KC","Kansas City Hepcats","away",0,1,"West Division","MiLPBE",19,22,-3,"19 - 22",15,234,207,410,42849,54756,41,0.439004149377593,18,23,"18 - 23","#6595E3",3,4,"2030"
28,101,552,2030-07-11,1905,10,3,7,"KC","Kansas City Hepcats","home",0,1,"West Division","MiLPBE",19,23,-4,"19 - 23",5,239,210,417,44100,57121,42,0.435680343011826,18,24,"18 - 24","#6595E3",3,4,"2030"
28,101,555,2030-07-12,1905,9,2,10,"KC","Kansas City Hepcats","home",0,1,"West Division","MiLPBE",19,24,-5,"19 - 24",14,253,212,427,44944,64009,43,0.412508145714207,18,25,"18 - 25","#6595E3",3,4,"2030"
28,101,558,2030-07-13,1905,9,6,12,"KC","Kansas City Hepcats","home",1,0,"West Division","MiLPBE",20,24,-4,"20 - 24",4,257,218,439,47524,66049,44,0.418444524666954,18,26,"18 - 26","#6595E3",3,4,"2030"
28,101,560,2030-07-17,1905,9,6,11,"KC","Kansas City Hepcats","home",1,0,"West Division","MiLPBE",21,24,-3,"21 - 24",1,258,224,450,50176,66564,45,0.429809833818742,19,26,"19 - 26","#6595E3",3,4,"2030"
28,101,563,2030-07-18,1905,9,3,14,"KC","Kansas City Hepcats","home",0,1,"West Division","MiLPBE",21,25,-4,"21 - 25",8,266,227,464,51529,70756,46,0.421384470703684,19,27,"19 - 27","#6595E3",3,4,"2030"
28,101,566,2030-07-19,1905,9,6,13,"KC","Kansas City Hepcats","home",1,0,"West Division","MiLPBE",22,25,-3,"22 - 25",1,267,233,477,54289,71289,47,0.432312984758477,20,27,"20 - 27","#6595E3",3,4,"2030"
28,101,569,2030-07-20,1905,9,3,10,"KC","Kansas City Hepcats","home",0,1,"West Division","MiLPBE",22,26,-4,"22 - 26",5,272,236,487,55696,73984,48,0.429487970388649,21,27,"21 - 27","#6595E3",3,4,"2030"
28,101,574,2030-07-23,1905,9,5,10,"KC","Kansas City Hepcats","away",1,0,"West Division","MiLPBE",23,26,-3,"23 - 26",4,276,241,497,58081,76176,49,0.432610590136827,21,28,"21 - 28","#6595E3",3,4,"2030"
28,101,577,2030-07-24,1905,9,2,5,"KC","Kansas City Hepcats","away",0,1,"West Division","MiLPBE",23,27,-4,"23 - 27",3,279,243,502,59049,77841,50,0.431360946745562,22,28,"22 - 28","#6595E3",3,4,"2030"
28,101,580,2030-07-25,1905,9,4,11,"KC","Kansas City Hepcats","away",0,1,"West Division","MiLPBE",23,28,-5,"23 - 28",7,286,247,513,61009,81796,51,0.427218934911243,22,29,"22 - 29","#6595E3",3,4,"2030"
28,101,583,2030-07-26,1905,9,6,12,"KC","Kansas City Hepcats","away",1,0,"West Division","MiLPBE",24,28,-4,"24 - 28",4,290,253,525,64009,84100,52,0.432174952231127,22,30,"22 - 30","#6595E3",3,4,"2030"
28,101,585,2030-08-12,1905,9,3,11,"KC","Kansas City Hepcats","home",0,1,"West Division","MiLPBE",24,29,-5,"24 - 29",6,296,256,536,65536,87616,53,0.427914751358128,23,30,"23 - 30","#6595E3",3,4,"2030"
28,101,588,2030-08-13,1905,9,9,13,"KC","Kansas City Hepcats","home",1,0,"West Division","MiLPBE",25,29,-4,"25 - 29",2,298,265,549,70225,88804,54,0.441586125800955,24,30,"24 - 30","#6595E3",3,4,"2030"
28,101,591,2030-08-14,1905,9,4,8,"KC","Kansas City Hepcats","home",0,1,"West Division","MiLPBE",25,30,-5,"25 - 30",6,304,269,557,72361,92416,55,0.439145026308283,24,31,"24 - 31","#6595E3",3,4,"2030"
28,101,594,2030-08-15,1905,10,8,14,"KC","Kansas City Hepcats","home",1,0,"West Division","MiLPBE",26,30,-4,"26 - 30",7,311,277,571,76729,96721,56,0.442369558950706,25,31,"25 - 31","#6595E3",3,4,"2030"
28,101,598,2030-08-18,1905,9,3,7,"KC","Kansas City Hepcats","away",0,1,"West Division","MiLPBE",26,31,-5,"26 - 31",4,315,280,578,78400,99225,57,0.441379310344828,25,32,"25 - 32","#6595E3",3,4,"2030"
28,101,601,2030-08-19,1905,9,8,11,"KC","Kansas City Hepcats","away",1,0,"West Division","MiLPBE",27,31,-4,"27 - 31",6,321,288,589,82944,103041,58,0.445971449310428,26,32,"26 - 32","#6595E3",3,4,"2030"
28,101,604,2030-08-20,1905,9,1,7,"KC","Kansas City Hepcats","away",0,1,"West Division","MiLPBE",27,32,-5,"27 - 32",2,323,289,596,83521,104329,59,0.444615384615385,26,33,"26 - 33","#6595E3",3,4,"2030"
28,101,607,2030-08-21,1905,9,4,8,"KC","Kansas City Hepcats","away",0,1,"West Division","MiLPBE",27,33,-6,"27 - 33",9,332,293,604,85849,110224,60,0.437842028224182,26,34,"26 - 34","#6595E3",3,4,"2030"
28,101,610,2030-08-24,1905,9,4,11,"KC","Kansas City Hepcats","home",1,0,"West Division","MiLPBE",28,33,-5,"28 - 33",1,333,297,615,88209,110889,61,0.443043124491456,27,34,"27 - 34","#6595E3",3,4,"2030"
28,101,613,2030-08-25,1905,9,0,4,"KC","Kansas City Hepcats","home",0,1,"West Division","MiLPBE",28,34,-6,"28 - 34",1,334,297,619,88209,111556,62,0.441563837509073,27,35,"27 - 35","#6595E3",3,4,"2030"
28,101,616,2030-08-26,1905,9,5,7,"KC","Kansas City Hepcats","home",1,0,"West Division","MiLPBE",29,34,-5,"29 - 34",4,338,302,626,91204,114244,63,0.443927417156653,28,35,"28 - 35","#6595E3",3,4,"2030"
28,101,619,2030-08-27,1905,9,10,12,"KC","Kansas City Hepcats","home",1,0,"West Division","MiLPBE",30,34,-4,"30 - 34",3,341,312,638,97344,116281,64,0.455677004095963,29,35,"29 - 35","#6595E3",3,4,"2030"
28,101,621,2030-08-30,1905,9,7,16,"KC","Kansas City Hepcats","away",1,0,"West Division","MiLPBE",31,34,-3,"31 - 34",1,342,319,654,101761,116964,65,0.465246313864442,30,35,"30 - 35","#6595E3",3,4,"2030"
28,101,624,2030-08-31,1905,9,1,7,"KC","Kansas City Hepcats","away",0,1,"West Division","MiLPBE",31,35,-4,"31 - 35",6,348,320,661,102400,121104,66,0.458157348414346,30,36,"30 - 36","#6595E3",3,4,"2030"
28,101,627,2030-09-01,1905,9,2,8,"KC","Kansas City Hepcats","away",0,1,"West Division","MiLPBE",31,36,-5,"31 - 36",9,357,322,669,103684,127449,67,0.448590205639177,30,37,"30 - 37","#6595E3",3,4,"2030"
28,101,830,2030-09-02,1905,11,2,9,"KC","Kansas City Hepcats","away",1,0,"West Division","MiLPBE",32,36,-4,"32 - 36",1,358,324,678,104976,128164,68,0.450270223899803,31,37,"31 - 37","#6595E3",3,4,"2030"
28,101,832,2030-09-05,1905,9,8,10,"KC","Kansas City Hepcats","away",1,0,"West Division","MiLPBE",33,36,-3,"33 - 36",7,365,332,688,110224,133225,69,0.452760126350899,31,38,"31 - 38","#6595E3",3,4,"2030"
28,101,835,2030-09-06,1905,9,2,8,"KC","Kansas City Hepcats","away",1,0,"West Division","MiLPBE",34,36,-2,"34 - 36",0,365,334,696,111556,133225,70,0.455737986199909,32,38,"32 - 38","#6595E3",3,4,"2030"
28,101,838,2030-09-07,1905,9,5,13,"KC","Kansas City Hepcats","away",0,1,"West Division","MiLPBE",34,37,-3,"34 - 37",6,371,339,709,114921,137641,71,0.455020945352032,32,39,"32 - 39","#6595E3",3,4,"2030"
28,101,841,2030-09-08,1905,9,1,7,"KC","Kansas City Hepcats","away",0,1,"West Division","MiLPBE",34,38,-4,"34 - 38",2,373,340,716,115600,139129,72,0.453815623662795,33,39,"33 - 39","#6595E3",3,4,"2030"
28,101,845,2030-09-11,1905,11,5,15,"KC","Kansas City Hepcats","away",1,0,"West Division","MiLPBE",35,38,-3,"35 - 38",3,376,345,731,119025,141376,73,0.457083498143248,33,40,"33 - 40","#6595E3",3,4,"2030"
28,101,848,2030-09-12,1905,9,6,9,"KC","Kansas City Hepcats","away",1,0,"West Division","MiLPBE",36,38,-2,"36 - 38",1,377,351,740,123201,142129,74,0.464331210191083,34,40,"34 - 40","#6595E3",3,4,"2030"
28,101,851,2030-09-13,1905,9,4,10,"KC","Kansas City Hepcats","away",0,1,"West Division","MiLPBE",36,39,-3,"36 - 39",5,382,355,750,126025,145924,75,0.463414096025358,35,40,"35 - 40","#6595E3",3,4,"2030"
28,101,854,2030-09-14,1905,10,3,7,"KC","Kansas City Hepcats","away",0,1,"West Division","MiLPBE",36,40,-4,"36 - 40",4,386,358,757,128164,148996,76,0.462418819454467,35,41,"35 - 41","#6595E3",3,4,"2030"
28,101,858,2030-09-17,1905,9,3,5,"KC","Kansas City Hepcats","home",1,0,"West Division","MiLPBE",37,40,-3,"37 - 40",0,386,361,762,130321,148996,77,0.466570240980678,36,41,"36 - 41","#6595E3",3,4,"2030"
28,101,861,2030-09-18,1905,9,5,13,"KC","Kansas City Hepcats","home",1,0,"West Division","MiLPBE",38,40,-2,"38 - 40",3,389,366,775,133956,151321,78,0.469564668725484,37,41,"37 - 41","#6595E3",3,4,"2030"
28,101,864,2030-09-19,1905,9,1,4,"KC","Kansas City Hepcats","away",0,1,"West Division","MiLPBE",38,41,-3,"38 - 41",4,393,367,779,134689,154449,79,0.465829465514737,37,42,"37 - 42","#6595E3",3,4,"2030"
28,101,867,2030-09-20,1905,9,3,7,"KC","Kansas City Hepcats","away",0,1,"West Division","MiLPBE",38,42,-4,"38 - 42",6,399,370,786,136900,159201,80,0.462342241329816,37,43,"37 - 43","#6595E3",3,4,"2030"
28,101,870,2030-09-22,1905,9,6,11,"KC","Kansas City Hepcats","away",0,1,"West Division","MiLPBE",38,43,-5,"38 - 43",9,408,376,797,141376,166464,81,0.459251559251559,37,44,"37 - 44","#6595E3",3,4,"2030"
28,101,873,2030-09-23,1905,9,7,13,"KC","Kansas City Hepcats","away",1,0,"West Division","MiLPBE",39,43,-4,"39 - 43",1,409,383,810,146689,167281,82,0.467207057999172,38,44,"38 - 44","#6595E3",3,4,"2030"
28,101,876,2030-09-24,1905,9,11,17,"KC","Kansas City Hepcats","home",1,0,"West Division","MiLPBE",40,43,-3,"40 - 43",6,415,394,827,155236,172225,83,0.47405950632289,39,44,"39 - 44","#6595E3",3,4,"2030"
28,101,879,2030-09-25,1905,12,6,13,"KC","Kansas City Hepcats","home",1,0,"West Division","MiLPBE",41,43,-2,"41 - 43",5,420,400,840,160000,176400,84,0.475624256837099,40,44,"40 - 44","#6595E3",3,4,"2030"
28,101,881,2030-09-28,1905,9,1,6,"KC","Kansas City Hepcats","home",0,1,"West Division","MiLPBE",41,44,-3,"41 - 44",4,424,401,846,160801,179776,85,0.472142863434701,40,45,"40 - 45","#6595E3",3,4,"2030"
28,101,884,2030-09-29,1905,10,4,13,"KC","Kansas City Hepcats","home",1,0,"West Division","MiLPBE",42,44,-2,"42 - 44",3,427,405,859,164025,182329,86,0.4735761677359,41,45,"41 - 45","#6595E3",3,4,"2030"
28,101,887,2030-09-30,1905,9,10,14,"KC","Kansas City Hepcats","away",1,0,"West Division","MiLPBE",43,44,-1,"43 - 44",5,432,415,873,172225,186624,87,0.479937243798924,42,45,"42 - 45","#6595E3",3,4,"2030"
28,101,890,2030-10-01,1905,9,7,11,"KC","Kansas City Hepcats","away",0,1,"West Division","MiLPBE",43,45,-2,"43 - 45",8,440,422,884,178084,193600,88,0.479127430828338,42,46,"42 - 46","#6595E3",3,4,"2030"
28,101,892,2030-10-04,1905,9,8,9,"KC","Kansas City Hepcats","home",1,0,"West Division","MiLPBE",44,45,-1,"44 - 45",6,446,430,893,184900,198916,89,0.481741251016112,43,46,"43 - 46","#6595E3",3,4,"2030"
28,101,895,2030-10-05,1905,9,4,13,"KC","Kansas City Hepcats","home",1,0,"West Division","MiLPBE",45,45,0,"45 - 45",2,448,434,906,188356,200704,90,0.484130982367758,44,46,"44 - 46","#6595E3",3,4,"2030"
28,101,898,2030-10-06,1905,9,2,8,"KC","Kansas City Hepcats","away",1,0,"West Division","MiLPBE",46,45,1,"46 - 45",1,449,436,914,190096,201601,91,0.485313903348762,44,47,"44 - 47","#6595E3",3,4,"2030"
29,101,304,2030-05-15,1905,9,2,7,"DAL","Dallas Dynamos","home",0,1,"East Division","MiLPBE",0,1,-1,"0 - 1",7,7,2,7,4,49,1,0.0754716981132075,0,1,"0 - 1","#00FFFF",3,6,"2030"
29,101,307,2030-05-16,1905,9,5,9,"DAL","Dallas Dynamos","home",1,0,"East Division","MiLPBE",1,1,0,"1 - 1",0,7,7,16,49,49,2,0.5,1,1,"1 - 1","#00FFFF",3,6,"2030"
29,101,310,2030-05-17,1905,9,6,10,"DAL","Dallas Dynamos","home",1,0,"East Division","MiLPBE",2,1,1,"2 - 1",4,11,13,26,169,121,3,0.582758620689655,2,1,"2 - 1","#00FFFF",3,6,"2030"
29,101,313,2030-05-18,1905,9,5,14,"DAL","Dallas Dynamos","home",0,1,"East Division","MiLPBE",2,2,0,"2 - 2",6,17,18,40,324,289,4,0.528548123980424,2,2,"2 - 2","#00FFFF",3,6,"2030"
29,101,315,2030-05-20,1905,11,3,11,"DAL","Dallas Dynamos","away",0,1,"East Division","MiLPBE",2,3,-1,"2 - 3",5,22,21,51,441,484,5,0.476756756756757,2,3,"2 - 3","#00FFFF",3,6,"2030"
29,101,318,2030-05-21,1905,9,3,8,"DAL","Dallas Dynamos","away",0,1,"East Division","MiLPBE",2,4,-2,"2 - 4",8,30,24,59,576,900,6,0.390243902439024,2,4,"2 - 4","#00FFFF",3,6,"2030"
29,101,321,2030-05-22,1905,9,2,11,"DAL","Dallas Dynamos","away",0,1,"East Division","MiLPBE",2,5,-3,"2 - 5",12,42,26,70,676,1764,7,0.277049180327869,2,5,"2 - 5","#00FFFF",3,6,"2030"
29,101,324,2030-05-23,1905,9,6,13,"DAL","Dallas Dynamos","away",0,1,"East Division","MiLPBE",2,6,-4,"2 - 6",11,53,32,83,1024,2809,8,0.267153665536134,2,6,"2 - 6","#00FFFF",3,6,"2030"
29,101,326,2030-05-26,1905,9,1,6,"DAL","Dallas Dynamos","away",0,1,"East Division","MiLPBE",2,7,-5,"2 - 7",2,55,33,89,1089,3025,9,0.264705882352941,2,7,"2 - 7","#00FFFF",3,6,"2030"
29,101,329,2030-05-27,1905,9,12,11,"DAL","Dallas Dynamos","away",1,0,"East Division","MiLPBE",3,7,-4,"3 - 7",1,56,45,100,2025,3136,10,0.392365820577407,4,6,"4 - 6","#00FFFF",3,6,"2030"
29,101,332,2030-05-28,1905,9,5,7,"DAL","Dallas Dynamos","away",1,0,"East Division","MiLPBE",4,7,-3,"4 - 7",0,56,50,107,2500,3136,11,0.443577004968062,5,6,"5 - 6","#00FFFF",3,6,"2030"
29,101,335,2030-05-29,1905,9,9,10,"DAL","Dallas Dynamos","away",0,1,"East Division","MiLPBE",4,8,-4,"4 - 8",10,66,59,117,3481,4356,12,0.44417506698992,5,7,"5 - 7","#00FFFF",3,6,"2030"
29,101,339,2030-06-01,1905,9,3,7,"DAL","Dallas Dynamos","home",1,0,"East Division","MiLPBE",5,8,-3,"5 - 8",1,67,62,124,3844,4489,13,0.461298451938078,6,7,"6 - 7","#00FFFF",3,6,"2030"
29,101,342,2030-06-02,1905,9,7,11,"DAL","Dallas Dynamos","home",1,0,"East Division","MiLPBE",6,8,-2,"6 - 8",5,72,69,135,4761,5184,14,0.478733031674208,7,7,"7 - 7","#00FFFF",3,6,"2030"
29,101,345,2030-06-03,1905,9,3,8,"DAL","Dallas Dynamos","home",1,0,"East Division","MiLPBE",7,8,-1,"7 - 8",1,73,72,143,5184,5329,15,0.49310377627699,7,8,"7 - 8","#00FFFF",3,6,"2030"
29,101,348,2030-06-04,1905,9,6,10,"DAL","Dallas Dynamos","home",0,1,"East Division","MiLPBE",7,9,-2,"7 - 9",9,82,78,153,6084,6724,16,0.475015615240475,8,8,"8 - 8","#00FFFF",3,6,"2030"
29,101,352,2030-06-07,1905,12,2,9,"DAL","Dallas Dynamos","away",0,1,"East Division","MiLPBE",7,10,-3,"7 - 10",3,85,80,162,6400,7225,17,0.469724770642202,8,9,"8 - 9","#00FFFF",3,6,"2030"
29,101,355,2030-06-08,1905,9,10,14,"DAL","Dallas Dynamos","away",1,0,"East Division","MiLPBE",8,10,-2,"8 - 10",6,91,90,176,8100,8281,18,0.494475306757829,9,9,"9 - 9","#00FFFF",3,6,"2030"
29,101,358,2030-06-09,1905,9,11,13,"DAL","Dallas Dynamos","away",1,0,"East Division","MiLPBE",9,10,-1,"9 - 10",4,95,101,189,10201,9025,19,0.530583584729013,10,9,"10 - 9","#00FFFF",3,6,"2030"
29,101,361,2030-06-10,1905,9,1,6,"DAL","Dallas Dynamos","away",0,1,"East Division","MiLPBE",9,11,-2,"9 - 11",3,98,102,195,10404,9604,20,0.519992003198721,10,10,"10 - 10","#00FFFF",3,6,"2030"
29,101,364,2030-06-13,1905,9,5,6,"DAL","Dallas Dynamos","away",1,0,"East Division","MiLPBE",10,11,-1,"10 - 11",2,100,107,201,11449,10000,21,0.533777798498764,11,10,"11 - 10","#00FFFF",3,6,"2030"
29,101,367,2030-06-14,1905,9,7,15,"DAL","Dallas Dynamos","away",1,0,"East Division","MiLPBE",11,11,0,"11 - 11",6,106,114,216,12996,11236,22,0.536315615714757,12,10,"12 - 10","#00FFFF",3,6,"2030"
29,101,370,2030-06-15,1905,10,6,8,"DAL","Dallas Dynamos","away",1,0,"East Division","MiLPBE",12,11,1,"12 - 11",5,111,120,224,14400,12321,23,0.538901987201078,12,11,"12 - 11","#00FFFF",3,6,"2030"
29,101,373,2030-06-16,1905,9,6,7,"DAL","Dallas Dynamos","away",1,0,"East Division","MiLPBE",13,11,2,"13 - 11",5,116,126,231,15876,13456,24,0.541251875085231,13,11,"13 - 11","#00FFFF",3,6,"2030"
29,101,375,2030-06-19,1905,9,7,17,"DAL","Dallas Dynamos","home",1,0,"East Division","MiLPBE",14,11,3,"14 - 11",6,122,133,248,17689,14884,25,0.543057133208486,14,11,"14 - 11","#00FFFF",3,6,"2030"
29,101,378,2030-06-20,1905,9,10,18,"DAL","Dallas Dynamos","home",1,0,"East Division","MiLPBE",15,11,4,"15 - 11",3,125,143,266,20449,15625,26,0.566862560292732,15,11,"15 - 11","#00FFFF",3,6,"2030"
29,101,381,2030-06-21,1905,9,2,13,"DAL","Dallas Dynamos","home",0,1,"East Division","MiLPBE",15,12,3,"15 - 12",6,131,145,279,21025,17161,27,0.550594458702142,15,12,"15 - 12","#00FFFF",3,6,"2030"
29,101,510,2030-06-22,1905,9,6,12,"DAL","Dallas Dynamos","home",1,0,"East Division","MiLPBE",16,12,4,"16 - 12",5,136,151,291,22801,18496,28,0.552122430200741,15,13,"15 - 13","#00FFFF",3,6,"2030"
29,101,514,2030-07-14,1405,9,3,8,"DAL","Dallas Dynamos","home",0,1,"East Division","MiLPBE",16,13,3,"16 - 13",5,141,154,299,23716,19881,29,0.543982384108998,16,13,"16 - 13","#00FFFF",3,6,"2030"
29,101,515,2030-06-24,1905,9,3,7,"DAL","Dallas Dynamos","home",1,0,"East Division","MiLPBE",17,13,4,"17 - 13",1,142,157,306,24649,20164,30,0.550041282663513,17,13,"17 - 13","#00FFFF",3,6,"2030"
29,101,518,2030-06-25,1905,9,2,11,"DAL","Dallas Dynamos","home",1,0,"East Division","MiLPBE",18,13,5,"18 - 13",1,143,159,317,25281,20449,31,0.552831839055325,17,14,"17 - 14","#00FFFF",3,6,"2030"
29,101,521,2030-06-26,1905,9,11,15,"DAL","Dallas Dynamos","home",0,1,"East Division","MiLPBE",18,14,4,"18 - 14",17,160,170,332,28900,25600,32,0.530275229357798,17,15,"17 - 15","#00FFFF",3,6,"2030"
29,101,524,2030-06-27,1905,9,13,17,"DAL","Dallas Dynamos","home",1,0,"East Division","MiLPBE",19,14,5,"19 - 14",4,164,183,349,33489,26896,33,0.554591372029478,18,15,"18 - 15","#00FFFF",3,6,"2030"
29,101,528,2030-06-30,1905,9,2,4,"DAL","Dallas Dynamos","away",0,1,"East Division","MiLPBE",19,15,4,"19 - 15",14,178,185,353,34225,31684,34,0.519276578312522,18,16,"18 - 16","#00FFFF",3,6,"2030"
29,101,531,2030-07-01,1905,9,7,13,"DAL","Dallas Dynamos","away",1,0,"East Division","MiLPBE",20,15,5,"20 - 15",2,180,192,366,36864,32400,35,0.532224532224532,19,16,"19 - 16","#00FFFF",3,6,"2030"
29,101,534,2030-07-02,1905,9,7,7,"DAL","Dallas Dynamos","away",1,0,"East Division","MiLPBE",21,15,6,"21 - 15",2,182,199,373,39601,33124,36,0.544530766586456,20,16,"20 - 16","#00FFFF",3,6,"2030"
29,101,537,2030-07-03,1905,9,11,15,"DAL","Dallas Dynamos","away",1,0,"East Division","MiLPBE",22,15,7,"22 - 15",3,185,210,388,44100,34225,37,0.563038621129907,21,16,"21 - 16","#00FFFF",3,6,"2030"
29,101,541,2030-07-06,1905,9,5,11,"DAL","Dallas Dynamos","home",0,1,"East Division","MiLPBE",22,16,6,"22 - 16",8,193,215,399,46225,37249,38,0.553765244267676,21,17,"21 - 17","#00FFFF",3,6,"2030"
29,101,544,2030-07-07,1905,9,3,8,"DAL","Dallas Dynamos","home",1,0,"East Division","MiLPBE",23,16,7,"23 - 16",2,195,218,407,47524,38025,39,0.555517890331857,22,17,"22 - 17","#00FFFF",3,6,"2030"
29,101,547,2030-07-08,1905,9,9,14,"DAL","Dallas Dynamos","home",1,0,"East Division","MiLPBE",24,16,8,"24 - 16",7,202,227,421,51529,40804,40,0.558077826995765,22,18,"22 - 18","#00FFFF",3,6,"2030"
29,101,550,2030-07-09,1905,9,15,20,"DAL","Dallas Dynamos","home",1,0,"East Division","MiLPBE",25,16,9,"25 - 16",6,208,242,441,58564,43264,41,0.575126684212594,24,17,"24 - 17","#00FFFF",3,6,"2030"
29,101,553,2030-07-11,1905,9,5,9,"DAL","Dallas Dynamos","home",1,0,"East Division","MiLPBE",26,16,10,"26 - 16",4,212,247,450,61009,44944,42,0.575811916604532,24,18,"24 - 18","#00FFFF",3,6,"2030"
29,101,556,2030-07-12,1905,9,1,4,"DAL","Dallas Dynamos","home",0,1,"East Division","MiLPBE",26,17,9,"26 - 17",6,218,248,454,61504,47524,43,0.564111971236747,24,19,"24 - 19","#00FFFF",3,6,"2030"
29,101,559,2030-07-13,1905,9,3,8,"DAL","Dallas Dynamos","home",0,1,"East Division","MiLPBE",26,18,8,"26 - 18",6,224,251,462,63001,50176,44,0.556659038497221,24,20,"24 - 20","#00FFFF",3,6,"2030"
29,101,561,2030-07-17,1905,9,2,5,"DAL","Dallas Dynamos","away",0,1,"East Division","MiLPBE",26,19,7,"26 - 19",5,229,253,467,64009,52441,45,0.549669386002576,25,20,"25 - 20","#00FFFF",3,6,"2030"
29,101,564,2030-07-18,1905,9,5,10,"DAL","Dallas Dynamos","away",0,1,"East Division","MiLPBE",26,20,6,"26 - 20",8,237,258,477,66564,56169,46,0.542348023758891,25,21,"25 - 21","#00FFFF",3,6,"2030"
29,101,567,2030-07-19,1905,9,7,11,"DAL","Dallas Dynamos","away",1,0,"East Division","MiLPBE",27,20,7,"27 - 20",6,243,265,488,70225,59049,47,0.543226016058914,26,21,"26 - 21","#00FFFF",3,6,"2030"
29,101,570,2030-07-20,1905,9,4,8,"DAL","Dallas Dynamos","away",0,1,"East Division","MiLPBE",27,21,6,"27 - 21",5,248,269,496,72361,61504,48,0.540552048705786,26,22,"26 - 22","#00FFFF",3,6,"2030"
29,101,574,2030-07-23,1905,9,4,12,"DAL","Dallas Dynamos","home",0,1,"East Division","MiLPBE",27,22,5,"27 - 22",5,253,273,508,74529,64009,49,0.537967922158541,26,23,"26 - 23","#00FFFF",3,6,"2030"
29,101,577,2030-07-24,1905,9,3,10,"DAL","Dallas Dynamos","home",1,0,"East Division","MiLPBE",28,22,6,"28 - 22",2,255,276,518,76176,65025,50,0.539486264261585,27,23,"27 - 23","#00FFFF",3,6,"2030"
29,101,580,2030-07-25,1905,9,7,15,"DAL","Dallas Dynamos","home",1,0,"East Division","MiLPBE",29,22,7,"29 - 22",4,259,283,533,80089,67081,51,0.544193789495142,28,23,"28 - 23","#00FFFF",3,6,"2030"
29,101,583,2030-07-26,1905,9,4,10,"DAL","Dallas Dynamos","home",0,1,"East Division","MiLPBE",29,23,6,"29 - 23",6,265,287,543,82369,70225,52,0.539791865997352,28,24,"28 - 24","#00FFFF",3,6,"2030"
29,101,584,2030-08-12,1905,9,5,9,"DAL","Dallas Dynamos","away",0,1,"East Division","MiLPBE",29,24,5,"29 - 24",7,272,292,552,85264,73984,53,0.535416457349543,28,25,"28 - 25","#00FFFF",3,6,"2030"
29,101,587,2030-08-13,1905,9,2,4,"DAL","Dallas Dynamos","away",0,1,"East Division","MiLPBE",29,25,4,"29 - 25",10,282,294,556,86436,79524,54,0.520824295010846,28,26,"28 - 26","#00FFFF",3,6,"2030"
29,101,590,2030-08-14,1905,9,7,7,"DAL","Dallas Dynamos","away",0,1,"East Division","MiLPBE",29,26,3,"29 - 26",8,290,301,563,90601,84100,55,0.518606075523323,29,26,"29 - 26","#00FFFF",3,6,"2030"
29,101,593,2030-08-15,1905,14,4,16,"DAL","Dallas Dynamos","away",1,0,"East Division","MiLPBE",30,26,4,"30 - 26",3,293,305,579,93025,85849,56,0.520058812348357,29,27,"29 - 27","#00FFFF",3,6,"2030"
29,101,597,2030-08-18,1905,9,5,11,"DAL","Dallas Dynamos","home",0,1,"East Division","MiLPBE",30,27,3,"30 - 27",8,301,310,590,96100,90601,57,0.514726755614592,29,28,"29 - 28","#00FFFF",3,6,"2030"
29,101,600,2030-08-19,1905,9,1,10,"DAL","Dallas Dynamos","home",0,1,"East Division","MiLPBE",30,28,2,"30 - 28",10,311,311,600,96721,96721,58,0.5,29,29,"29 - 29","#00FFFF",3,6,"2030"
29,101,603,2030-08-20,1905,9,5,9,"DAL","Dallas Dynamos","home",1,0,"East Division","MiLPBE",31,28,3,"31 - 28",4,315,316,609,99856,99225,59,0.501584782073628,30,29,"30 - 29","#00FFFF",3,6,"2030"
29,101,606,2030-08-21,1905,9,5,10,"DAL","Dallas Dynamos","home",0,1,"East Division","MiLPBE",31,29,2,"31 - 29",6,321,321,619,103041,103041,60,0.5,30,30,"30 - 30","#00FFFF",3,6,"2030"
29,101,610,2030-08-24,1905,9,1,6,"DAL","Dallas Dynamos","away",0,1,"East Division","MiLPBE",31,30,1,"31 - 30",4,325,322,625,103684,105625,61,0.495363314525415,30,31,"30 - 31","#00FFFF",3,6,"2030"
29,101,613,2030-08-25,1905,9,1,4,"DAL","Dallas Dynamos","away",1,0,"East Division","MiLPBE",32,30,2,"32 - 30",0,325,323,629,104329,105625,62,0.496913609647828,31,31,"31 - 31","#00FFFF",3,6,"2030"
29,101,616,2030-08-26,1905,9,4,11,"DAL","Dallas Dynamos","away",0,1,"East Division","MiLPBE",32,31,1,"32 - 31",5,330,327,640,106929,108900,63,0.495433885159084,31,32,"31 - 32","#00FFFF",3,6,"2030"
29,101,619,2030-08-27,1905,9,3,13,"DAL","Dallas Dynamos","away",0,1,"East Division","MiLPBE",32,32,0,"32 - 32",10,340,330,653,108900,115600,64,0.485077951002227,31,33,"31 - 33","#00FFFF",3,6,"2030"
29,101,622,2030-08-30,1905,9,3,11,"DAL","Dallas Dynamos","away",0,1,"East Division","MiLPBE",32,33,-1,"32 - 33",7,347,333,664,110889,120409,65,0.479420487855494,31,34,"31 - 34","#00FFFF",3,6,"2030"
29,101,625,2030-08-31,1905,9,8,8,"DAL","Dallas Dynamos","away",1,0,"East Division","MiLPBE",33,33,0,"33 - 33",6,353,341,672,116281,124609,66,0.482714101872224,32,34,"32 - 34","#00FFFF",3,6,"2030"
29,101,828,2030-09-01,1905,9,2,6,"DAL","Dallas Dynamos","away",1,0,"East Division","MiLPBE",34,33,1,"34 - 33",1,354,343,678,117649,125316,67,0.484222007285,32,35,"32 - 35","#00FFFF",3,6,"2030"
29,101,831,2030-09-02,1905,9,0,6,"DAL","Dallas Dynamos","away",0,1,"East Division","MiLPBE",34,34,0,"34 - 34",7,361,343,684,117649,130321,68,0.474448521998629,32,36,"32 - 36","#00FFFF",3,6,"2030"
29,101,833,2030-09-05,1905,9,15,17,"DAL","Dallas Dynamos","home",1,0,"East Division","MiLPBE",35,34,1,"35 - 34",0,361,358,701,128164,130321,69,0.495827610886512,34,35,"34 - 35","#00FFFF",3,6,"2030"
29,101,836,2030-09-06,1905,9,5,10,"DAL","Dallas Dynamos","home",0,1,"East Division","MiLPBE",35,35,0,"35 - 35",10,371,363,711,131769,137641,70,0.489102112022568,34,36,"34 - 36","#00FFFF",3,6,"2030"
29,101,839,2030-09-07,1905,9,11,17,"DAL","Dallas Dynamos","home",1,0,"East Division","MiLPBE",36,35,1,"36 - 35",5,376,374,728,139876,141376,71,0.497333352296161,35,36,"35 - 36","#00FFFF",3,6,"2030"
29,101,842,2030-09-08,1905,9,3,9,"DAL","Dallas Dynamos","home",0,1,"East Division","MiLPBE",36,36,0,"36 - 36",10,386,377,737,142129,148996,72,0.488206097037355,35,37,"35 - 37","#00FFFF",3,6,"2030"
29,101,844,2030-09-11,1905,9,6,8,"DAL","Dallas Dynamos","home",0,1,"East Division","MiLPBE",36,37,-1,"36 - 37",9,395,383,745,146689,156025,73,0.484579504086365,35,38,"35 - 38","#00FFFF",3,6,"2030"
29,101,847,2030-09-12,1905,9,0,7,"DAL","Dallas Dynamos","home",0,1,"East Division","MiLPBE",36,38,-2,"36 - 38",7,402,383,752,146689,161604,74,0.475810349245685,35,39,"35 - 39","#00FFFF",3,6,"2030"
29,101,850,2030-09-13,1905,9,3,7,"DAL","Dallas Dynamos","home",0,1,"East Division","MiLPBE",36,39,-3,"36 - 39",7,409,386,759,148996,167281,75,0.471093377008129,35,40,"35 - 40","#00FFFF",3,6,"2030"
29,101,853,2030-09-14,1905,9,6,16,"DAL","Dallas Dynamos","home",0,1,"East Division","MiLPBE",36,40,-4,"36 - 40",10,419,392,775,153664,175561,76,0.466744627534361,35,41,"35 - 41","#00FFFF",3,6,"2030"
29,101,857,2030-09-17,1905,9,1,7,"DAL","Dallas Dynamos","away",0,1,"East Division","MiLPBE",36,41,-5,"36 - 41",3,422,393,782,154449,178084,77,0.464462173679003,36,41,"36 - 41","#00FFFF",3,6,"2030"
29,101,860,2030-09-18,1905,9,4,9,"DAL","Dallas Dynamos","away",0,1,"East Division","MiLPBE",36,42,-6,"36 - 42",10,432,397,791,157609,186624,78,0.457855580377244,36,42,"36 - 42","#00FFFF",3,6,"2030"
29,101,863,2030-09-19,1905,9,3,9,"DAL","Dallas Dynamos","home",0,1,"East Division","MiLPBE",36,43,-7,"36 - 43",8,440,400,800,160000,193600,79,0.452488687782805,36,43,"36 - 43","#00FFFF",3,6,"2030"
29,101,866,2030-09-20,1905,9,10,10,"DAL","Dallas Dynamos","home",1,0,"East Division","MiLPBE",37,43,-6,"37 - 43",5,445,410,810,168100,198025,80,0.459132809832707,37,43,"37 - 43","#00FFFF",3,6,"2030"
29,101,870,2030-09-22,1905,9,9,17,"DAL","Dallas Dynamos","home",1,0,"East Division","MiLPBE",38,43,-5,"38 - 43",6,451,419,827,175561,203401,81,0.463268084926721,38,43,"38 - 43","#00FFFF",3,6,"2030"
29,101,873,2030-09-23,1905,9,1,10,"DAL","Dallas Dynamos","home",0,1,"East Division","MiLPBE",38,44,-6,"38 - 44",7,458,420,837,176400,209764,82,0.456800737510488,37,45,"37 - 45","#00FFFF",3,6,"2030"
29,101,876,2030-09-24,1905,9,6,15,"DAL","Dallas Dynamos","away",0,1,"East Division","MiLPBE",38,45,-7,"38 - 45",11,469,426,852,181476,219961,83,0.452065953063619,38,45,"38 - 45","#00FFFF",3,6,"2030"
29,101,879,2030-09-25,1905,12,5,13,"DAL","Dallas Dynamos","away",0,1,"East Division","MiLPBE",38,46,-8,"38 - 46",6,475,431,865,185761,225625,84,0.451549153349895,38,46,"38 - 46","#00FFFF",3,6,"2030"
29,101,882,2030-09-28,1905,9,5,13,"DAL","Dallas Dynamos","home",1,0,"East Division","MiLPBE",39,46,-7,"39 - 46",4,479,436,878,190096,229441,85,0.453109022565352,39,46,"39 - 46","#00FFFF",3,6,"2030"
29,101,885,2030-09-29,1905,9,8,13,"DAL","Dallas Dynamos","home",0,1,"East Division","MiLPBE",39,47,-8,"39 - 47",14,493,444,891,197136,243049,86,0.447848063882231,39,47,"39 - 47","#00FFFF",3,6,"2030"
29,101,888,2030-09-30,1905,9,10,9,"DAL","Dallas Dynamos","away",1,0,"East Division","MiLPBE",40,47,-7,"40 - 47",5,498,454,900,206116,248004,87,0.45388003170968,39,48,"39 - 48","#00FFFF",3,6,"2030"
29,101,891,2030-10-01,1905,9,3,8,"DAL","Dallas Dynamos","away",0,1,"East Division","MiLPBE",40,48,-8,"40 - 48",4,502,457,908,208849,252004,88,0.453179213328328,40,48,"40 - 48","#00FFFF",3,6,"2030"
29,101,893,2030-10-04,1905,10,5,7,"DAL","Dallas Dynamos","away",0,1,"East Division","MiLPBE",40,49,-9,"40 - 49",6,508,462,915,213444,258064,89,0.452683729650398,40,49,"40 - 49","#00FFFF",3,6,"2030"
29,101,896,2030-10-05,1905,9,1,10,"DAL","Dallas Dynamos","away",0,1,"East Division","MiLPBE",40,50,-10,"40 - 50",14,522,463,925,214369,272484,90,0.440315659963069,40,50,"40 - 50","#00FFFF",3,6,"2030"
29,101,899,2030-10-06,1905,9,2,12,"DAL","Dallas Dynamos","home",0,1,"East Division","MiLPBE",40,51,-11,"40 - 51",6,528,465,937,216225,278784,91,0.436810239813822,40,51,"40 - 51","#00FFFF",3,6,"2030"
